Title: Damon, oder die wahre Freundschaft
Number of all lemmas: 7385
Nummber of different lemmas: 1500

Lemma	POS	Frequency	Tokens
sein	VB, VBN, JJ, PRP$, RB	229	ist, war, sei, sind, wäre, sein, bin, waren, gewesen, wären
Sie	PRP, JJ	228	Sie
ich	PRP, JJ	206	ich
haben	VB, NN	143	hat, haben, habe, hätte, hätten, hatten, hatte, gehabt
mich	PRP	136	mich
Er	PRP, JJ	121	Er
ein	DT, RP	119	ein, einen, einem, eine, einer, eines
werden	VB, VBN	119	wird, wurden, werde, werden, würde, würden, geworden
es	PRP, JJ	107	es
zu	RP, TO, RB, IN	104	zu
nicht	RB	96	nicht
die	DT, WDT	89	die, dies
mir	PRP, JJ	88	mir
so	RB, RP, WRB, IN, JJ	78	so
Ich	PRP	75	Ich
dass	IN, RB	74	daß
und	CC	72	und
sie	PRP, JJ	72	sie
wollen	MD	66	will, wollten, wollen, wollte, wollt
der	DT, WDT	63	der, deren
wenn	RB, IN	62	wenn
das	DT, WDT	58	das
was	WDT, WP, DT	53	was
Ihnen	PRP, JJ	53	Ihnen
auch	RB, RP, IN, WRB	49	auch
versteh	NN	49	versteh
Leander	NN, NNP	47	Leander
Freund	NNS, NN, NNP	47	Freunde, Freund
von	IN	44	von
dem	DT, WDT	43	dem
mein	JJ, PRP$	43	meine, meiner, mein, meines
Damon	NN, NNP	42	Damon
können	VBN, VB	41	kann, können, könnten, könnte, könnt
mit	IN, TO	41	mit
sich	PRP	41	sich
als	IN	40	als
Und	CC, RB	40	Und
doch	RB, CC, RP, WRB, IN	37	doch
dies	DT, WDT	35	diesen, dieses, diesem, dieser, diese
wohl	RB, RP, IN	35	wohl
den	DT, WDT	34	den
auf	IN	33	auf
für	IN	33	für
er	PRP, JJ	33	er
in	IN, TO	31	in
Was	WP	31	Was
nur	WRB, RB, RP, IN	30	nur
all	DT, JJ	30	alles, allen, alle, allem, aller
Versteh	NN	30	Versteh
noch	RB, RP, IN, WRB	28	noch
sollen	MD	28	sollte, soll, sollen
bei	IN	28	bei
Freundschaft	NN, JJ	27	Freundschaft
ihn	PRP	26	ihn
ihm	PRP, JJ	26	ihm
man	DT, RB	24	man
Ihr	PRP$, JJ	24	Ihr, Ihren
Ja	NN	24	Ja
sagen	VB, RB, VBN, RP	24	sagen, sage, sagt, gesagt
an	IN, RP	23	an
aber	RB, WRB, RP, CC	22	aber
beid	DT, JJ	22	beide, beiden, beider
uns	PRP	21	uns
ja	RB, RP, WRB, IN	21	ja
ihr	PRP, JJ	21	ihr
Herr	NN, JJ	20	Herr
selbst	JJ	20	selbst
Ihre	PRP$	20	Ihre
Nun	UH	20	Nun
wie	IN	20	wie
Frau	NN	20	Frau
viel	IN, RP, RB	20	viel
Vetter	NN, NNP	19	Vetter
machen	VB, PRP$, VBN	19	machen, machten, macht, gemacht
weeissen	VB	19	weiß
Es	PRP	18	Es
nun	UH, RP, RB, IN	18	Nun, nun
Liebe	NN, JJ	18	Liebe
geben	VB, VBN, PRP$	17	geben, gegeben, gibt
tun	VB, VBN	17	getan, tun, tut, tat
meinen	VB, PRP$	17	meine, meinen
Aber	CC, RB	17	Aber
schon	IN, RB, RP	17	schon
nichts	DT, RB	16	nichts
gut	JJ	16	gut, guter, guten, gute
einmal	RP, RB, IN	16	einmal
denn	IN, RB, RP, WRB	16	denn
Wenn	IN, RB	15	Wenn
wieder	RB, IN, RP	15	wieder
mehr	RP, NNP, RB, IN	15	mehr
meine	PRP$	15	meine
mögen	VB	15	möchte, mögen, mag
O	NN	15	O
gleich	JJ	15	gleich, gleicher, gleichem, gleichen
gewiss	NN, JJ	14	gewiß, gewissen
andern	JJ, DT, RB	14	andern
da	IN, RB	14	da
soen	VBN, RB	14	so
oder	CC, RB	14	oder
So	RB, IN	14	So
Himmel	NN	14	Himmel
wir	JJ, PRP	14	wir
ha	NN	14	ha
Sein	VB, PRP$	13	Wäre, Ist, Sind, Sein
Ehre	NN	13	Ehre
Schiff	NN, NNS	13	Schiff, Schiffe
gehen	VB	13	geht, gehen, gegangen
mussen	VB	13	muß, mußtest
Wie	WRB, IN	12	Wie
ob	RB, IN	12	ob
Unglück	NN	12	Unglück
Nein	NN	12	Nein
seine	PRP$	12	seine
Ach	NN	12	Ach
aus	IN, RP	11	aus
wenig	RB, IN	11	wenig
Herz	NN, NNS	11	Herz, Herzen
Das	DT	11	Das
Vermögen	NN	11	Vermögen
durch	IN	11	durch
kein	JJ, DT	11	keine, keiner, keinen, kein
müssen	VB	11	müssen, müßte
also	RB	11	also
Gott	NN	11	Gott
ganz	RB, JJ, IN	11	ganz, ganze, ganzen
Doch	RP, RB, WRB, IN	11	Doch
genug	RB, RP	10	genug
wahr	RP, RB, JJ	10	wahr
Lisette	NN	10	Lisette
lieb	NN, JJ, VB	10	lieben, lieber, liebe
meinem	PRP$	10	meinem
über	IN	10	über
um	IN	10	um
eben	WRB, RB	10	eben
glauben	VB	10	glauben, glaube, geglaubt
kömmen	MD	9	kömmt
erst	RP, RB, JJ	9	erst, ersten
itzo	NN	9	itzo
Ihn	NN	9	Ihn
Ihm	PRP	9	Ihm
des	DT	9	des
Recht	NN	9	Recht
bekommen	VB, VBN	9	bekommen
nach	RP, IN	9	nach
Der	DT	9	Der
gegen	IN	8	gegen
ist	VB, RB, JJ	8	ist
sehen	VBN, VB	8	sehen, gesehen, sieht
Zeit	NN	8	Zeit
dazuen	VB	8	dazu
Leandern	NN	8	Leandern
alsdenn	RB, RP, IN	8	alsdenn
reden	VB, PRP$	8	redet, reden
vor	IN, RP	8	vor
Mein	NN, JJ	8	Mein, Meiner
erklären	VB, VBN	8	erklären, erklärten, erklärt, erkläret, erklärte
setzen	VB, RP	8	gesetzt, setzen
sehr	RB, WRB, IN	8	sehr
kommen	VB	8	kommen, käme, komme
bald	WRB, RB, RP	8	bald
Ein	DT	8	Einer, Ein, Eine
Nachricht	NN	8	Nachricht
Vergnügen	NN	7	Vergnügen
wo	WRB	7	wo
unglücklich	JJ	7	unglücklich
Ha	NN	7	Ha
dir	PRP	7	dir
Ihrem	NN	7	Ihrem
glücklich	JJ	7	glücklich
Wer	WP	7	Wer
bringen	VB, RP	7	bringen, gebracht, brachte, bringt
liebster	NN	7	liebster
verzeihen	VB	7	verzeihen
Neigung	NN, NNS	7	Neigung, Neigungen
Reden	NN, NNP	7	Reden
Witwe	NN	7	Witwe
gar	RB	7	gar
lassen	VB, VBN	7	lasse, lassen, ließ
bleiben	VB, RP, PRP$	7	blieben, geblieben, bleiben, bleibt
gern	VBN, RB, IN, RP	7	gern
eher	RB, RP	7	eher
suchen	VB	7	suchen, sucht, suchten
zwei	CD	7	zwei
Gedanke	NNS	6	Gedanken
klein	JJ	6	kleiner, klein, kleines, kleine
im	IN	6	im
Art	NN	6	Art
vielleicht	RB	6	vielleicht
verstehen	VB	6	verstehen, verstehe
ihre	PRP$	6	ihre
hören	VB	6	hören, höre
fein	JJ	6	fein
etwas	DT	6	etwas
Freundes	NN	6	Freundes
ohne	IN	6	ohne
verlieren	VB	6	verliert, verlieren, verlöre
Handel	NN	6	Handel
Absichten	NN	6	Absichten
Die	DT	6	Die
seinem	PRP$	6	seinem
Euch	NN	6	Euch
dess	WDT, DT	6	dessen
beleidiget	NN	5	beleidiget
glücklichsten	NN	5	glücklichsten
Wort	NN	5	Wort
scheinen	VB	5	scheint, schien, scheinen
bitten	VB	5	bitten, bitte
Lassen	MD	5	Lassen
Werden	NN, VB	5	Werden, Wird
unter	IN	5	unter
Ihren	NN	5	Ihren
folgen	VB, RB	5	folgten, folgen, folgt
denken	VB	5	denkt, denken
kann	VB, RB, JJ	5	kann
wegen	IN, TO	5	wegen
nehmen	VB	5	nahm, nehmen
helfen	VB	5	hilft, helfen
kennen	VB	5	kenne, kennen
meines	JJ, NN	5	meines
heiraten	VB	5	heiraten
Nur	RB, IN	5	Nur
Ursache	NN	5	Ursache
selb	DT	5	selber
sonst	RB	5	sonst
Ihrer	PRP$	5	Ihrer
beleidigen	VB, RP	5	beleidigen, beleidigt
finden	VB, VBN	5	finden, gefunden
leicht	JJ	5	leicht, leichter
Leben	NN	5	Leben
Madam	JJ	5	Madam
verlor	JJ	5	verloren
Glück	NN	5	Glück
rechen	VB	5	recht, rechten
wer	WP	5	wer
hier	RB, IN	5	hier
einig	JJ, DT	5	einig, einige
Welt	NN	5	Welt
jung	JJ	5	jungen, junge
dazu	RB	4	dazu
niederträchtig	JJ	4	niederträchtig
Person	NN	4	Person
niemand	DT	4	niemand
solch	DT	4	solchen, solche
gehabt	NN	4	gehabt
angenehm	JJ	4	angenehme, angenehm
du	PRP	4	du
schwach	JJ	4	schwach
desto	CC, RB	4	desto
Schande	NN	4	Schande
Reichtum	NN	4	Reichtum
nie	RB	4	nie
dächte	NN	4	dächte
dürfen	VB	4	darf
lieben	VB	4	lieben, liebe
Hand	NN	4	Hand
hübsch	JJ	4	hübsch, hübsche, hübschen
Tonne	NN, NNS	4	Tonne, Tonnen
Goldes	NN	4	Goldes
Wir	PRP	4	Wir
Beleidigungen	NN	4	Beleidigungen
Da	IN, RB	4	Da
Du	NN	4	Du
Nebenbuhler	NN	4	Nebenbuhler
ach	UH	4	ach
einander	PRP	4	einander
am	IN	4	am
Herrn	NN	4	Herrn
aufs	NN	4	aufs
grösst	JJ	4	größte, größten
mirs	NN	4	mirs
Leanders	NN	4	Leanders
untergehen	VBN, RP, VB	4	untergegangen
antworen	VB	4	antworten
Je	IN	4	Je
verlassen	VB	4	verlassen
andermal	RB, NNP, RP	4	andermal
sorgen	VB	4	sorgen
verziehen	VB	4	verziehen
allerdings	RB, IN	4	allerdings
grossmütig	JJ	4	großmütig, großmütigen
Pflicht	NN	4	Pflicht
Freier	NN	4	Freier
danken	VB	4	danken
halten	VB	4	halten
warten	VB, VBN	4	warten
damit	IN, RB	4	damit
zärtlich	JJ	4	zärtlichen, zärtlich
verdriesslich	JJ	4	verdrießlich
zeigen	VB, VBN	4	zeigen
Nicht	RB	4	Nicht
sehe	PRP$	4	sehe
sehn	NN	4	sehn
Geld	NN	4	Geld
davon	RB	4	davon
andre	NN	3	andre
neu	JJ	3	neue
vorher	RB	3	vorher
Unglücke	NN	3	Unglücke
zuwider	NN	3	zuwider
Himmels	NN	3	Himmels
Scham	NN	3	Scham
All	JJ	3	Alle
Augenblick	NN	3	Augenblick
Frage	NN	3	Frage
unterscheiden	VBN, VB	3	unterschieden, unterscheiden
ihrem	PRP$	3	ihrem
fällen	VB	3	fällt, gefällt
anfangen	VB	3	anfangen
erhalten	VBN, VB	3	erhalten
wider	RP, IN	3	wider
Hälfte	NN	3	Hälfte
auszuüben	NN	3	auszuüben
wissen	VB	3	wissen
zur	IN	3	zur
zum	IN	3	zum
vorkommen	VB	3	vorkommen
deswegen	RB	3	deswegen
ihnen	PRP	3	ihnen
Ihres	NN	3	Ihres
Dies	DT	3	Dieses, Diese
Probe	NN	3	Probe
halb	JJ, CD	3	halbe, halb
Sachen	NN	3	Sachen
behalten	VBN, RP	3	behalten
Entschluss	JJ, NN	3	Entschluß
verliere	NN	3	verliere
süsse	NN	3	süße
empfindlichen	VBN	3	empfindlich
Kann	NNP	3	Kann
Hätte	NN	3	Hätte
gleichviel	NN	3	gleichviel
Madame	NN	3	Madame
Glücke	NN	3	Glücke
bereden	NN	3	bereden
verstehn	NN	3	verstehn
gross	JJ	3	groß, große
schicken	VB	3	geschickt, schicken
Vermögens	NN	3	Vermögens
etwan	NN	3	etwan
Verdruss	NN	3	Verdruß
notwendig	JJ	3	notwendig
glücklichste	NN	3	glücklichste
übel	JJ	3	übel
Liebhaber	NN	3	Liebhaber
Verzeihung	NN	3	Verzeihung
Auf	IN	3	Auf
St	PRP$	3	St
Oder	NN	3	Oder
entreissen	NN	3	entreißen
Vorschlag	NN	3	Vorschlag
bloss	JJ, IN	3	bloßer, bloß, bloße
endlich	RB	3	endlich
vollkomm	JJ	3	vollkommen
heuen	VB	3	heute
Aufführung	NN	3	Aufführung
Dank	IN, RP	3	Dank
dadurch	RB	3	dadurch
Verstehn	NN	3	Verstehn
Gelegenheit	NN	3	Gelegenheit
Ob	IN	3	Ob
Erbe	NNS	3	Erben
allzu	RB, IN	3	allzu
darauf	RB	3	darauf
Zum	IN	3	Zum
Augen	NN	3	Augen
gestehen	VB	3	gestehen
sind	VB, JJ	3	sind
Seele	NN	3	Seele
Wohl	RP, RB	3	Wohl
Hui	NN	3	Hui
verlangen	VB, VBN, RP	3	verlangen, verlangt
einerlei	IN, RB	3	einerlei
Paar	NN, JJ	3	Paar
dasjenig	DT	3	dasjenige
umsonst	RB	3	umsonst
verbinden	RP, VBN	3	verbunden
Rede	NN	3	Rede
aufrichtig	JJ	3	aufrichtig
ichs	NN, NNP	3	ichs
Überlegen	NN	3	Überlegen
Vielleicht	RB	3	Vielleicht
ganzes	NN	3	ganzes
Gesetzt	NN	3	Gesetzt
allezeit	NN	3	allezeit
Untreue	NN	3	Untreue
welche	WDT	3	welche
Zweifeln	NN	3	Zweifeln
weg	RB, RP	3	weg
wünschen	VB	3	wünschen, wünschte
daran	RB	3	daran
zweifeln	VB	3	zweifeln
gesteh	NN	2	gesteh
Sprache	NN	2	Sprache
Eure	NN	2	Eure
voraus	JJ	2	voraus
vergessen	RP	2	vergessen
vertraue	NN	2	vertraue
annehmen	VB	2	annehmen
gewissenhaft	JJ	2	gewissenhaft
wertester	NN, JJ	2	wertester
muss	VB, JJ	2	muß
wussten	NN	2	wußten
Ausschlag	NN	2	Ausschlag
anstehen	VB, NN	2	ansteht, anstehen
Gegenstand	NN	2	Gegenstand
Als	IN	2	Als
eigen	JJ	2	eigenen
Fünfmalten	VBN	2	Fünfmal
geweissen	VB	2	gewiß
daraufen	RB, VB	2	darauf
weniger	RB	2	weniger
Seines	PRP$	2	Seines
raten	VB	2	raten
Närrin	NN	2	Närrin
bewussten	NN	2	bewußten
leugnen	VB	2	leugnen
Liebsten	NN	2	Liebsten
Eidschwur	NN	2	Eidschwur
Mache	NN	2	Mache
schenken	VBN, VB	2	geschenkt, schenken
weswegen	WRB	2	weswegen
Sanftmut	NN	2	Sanftmut
Wasser	NN	2	Wasser
schreiben	VBN	2	geschrieben
best	JJ	2	besten
weiter	RP	2	weiter
Reichtümer	NN	2	Reichtümer
Geschenk	NN	2	Geschenk
Handlung	NN	2	Handlung
Zweifel	NN	2	Zweifel
erzählen	VB	2	erzähle, erzählen
angekommen	NN	2	angekommen
ihrer	PRP$	2	ihrer
grossmütigen	NN	2	großmütigen
sprechen	VB, VBN	2	spricht, gesprochen
just	JJ	2	just
Wollte	NN	2	Wollte
anders	RP, RB	2	anders
hab	NN	2	hab
läng	JJ	2	länger
Klugheit	NN	2	Klugheit
Mannspersonen	NN	2	Mannspersonen
o	DT	2	o
bös	JJ	2	böse
liesse	NN	2	ließe
schweigen	RB, VB	2	schweigt, schweigen
bestürzt	NN	2	bestürzt
trennen	VB	2	trennen
reizender	NN	2	reizender
Schade	NN	2	Schade
Grossmut	NN	2	Großmut
Wahl	NN	2	Wahl
fehlen	VB	2	fehlt
trotz	IN	2	trotz
versuchen	VB	2	versuchen
Gütigkeit	NN	2	Gütigkeit
liebte	NN, NNP	2	liebte
Soen	RB	2	So
Pflichten	NN	2	Pflichten
Händen	NN	2	Händen
zweifle	NN	2	zweifle
unbekannen	VBN	2	unbekannt
unmöglich	JJ	2	unmöglich
hoffen	VB	2	hoffe
Verdacht	NN	2	Verdacht
mal	IN	2	mal
lässt	VB	2	läßt
betrügen	VB	2	betrügen
versichre	NN	2	versichre
itzt	DT	2	itzt
blind	JJ	2	blinden, blind
Eur	JJ	2	Eure
Ihrige	NN	2	Ihrige
alles	RB	2	alles
Erklären	NN	2	Erklären
Beid	JJ, DT	2	Beide
Einfall	NN	2	Einfall
verunglückt	NN	2	verunglückt
verdienen	VB	2	verdient
Weg	NN	2	Weg
ungegründeten	NN, NNP	2	ungegründeten
bekümmert	NN	2	bekümmert
munt	JJ	2	munter
sollten	NN	2	sollten
unsre	PRP$	2	unsre
je	RB	2	je
tue	NN	2	tue
besorge	NN	2	besorge
einzig	VB	2	einzige
Testamente	NN	2	Testamente
redlich	JJ	2	redliche, redlich
zugleich	RB	2	zugleich
möglich	JJ	2	möglich, mögliche
dabei	RB	2	dabei
zittere	NN	2	zittere
In	IN	2	In
meinigen	NN	2	meinigen
anwenden	VB	2	anwenden
besser	RB	2	besser
Eurer	NN	2	Eurer
hieher	NN	2	hieher
besondre	NN	2	besondre
fragen	VB	2	fragen
habe	RB	2	habe
Ostindien	NN	2	Ostindien
empfinden	VB	2	empfinden
zürnen	VB	2	zürnen
welches	WDT	2	welches
ehe	CC	2	ehe
ab	RP	2	ab
Wissen	NN	2	Wissen
Lebens	JJ, NN	2	Lebens
Exempel	NN	2	Exempel
unser	PRP$	2	unser
unsrer	PRP$	2	unsrer
erfahren	VBN, RP	2	erfahren
Traum	NNS	2	Träume
dienen	VB	2	dienen, dient
empfindlich	JJ	2	empfindlich
Habe	NN	2	Habe
betrübt	NN, JJ	2	betrübt, betrübte
wohin	WRB, RB	2	wohin
billig	JJ, RB	2	billig
Kommen	NN	2	Kommen
worden	VBN	2	worden
Gesichte	NN	2	Gesichte
lustig	JJ	2	lustig
besitzen	VB	2	besitzen
Grillenfänger	NN	2	Grillenfänger
edel	JJ	2	edel
deutlich	JJ	2	deutlich
teils	NN	2	teils
Tausch	NN	2	Tausch
Sturme	NN	2	Sturme
Welchen	JJ	2	Welchen
Ers	NNP	2	Ers
fünf	CD	2	fünf
Rat	NN	2	Rat
nötigen	VB, VBN	2	nötigen, nötig
nein	WRB, RB	2	nein
schimpfen	VB, RP	2	schimpfen, geschimpft
hart	JJ	2	harte, harten
manch	DT	2	mancher, manchem
Irrung	NN	2	Irrung
Ei	NN	2	Ei
Henker	NN	2	Henker
wagen	VB	2	wagt, gewagt
nennen	VB	2	nennen, nennt
jen	DT	2	jener, jenen
angetroffen	NN	2	angetroffen
euch	PRP	2	euch
Mutter	NN	2	Mutter
gerühret	NN	2	gerühret
meinig	DT	2	meinige
redet	VB, JJ	2	redet
überlassen	VB	2	überlassen
empfinde	NN	2	empfinde
Kapital	NN, NNS	2	Kapital, Kapitale
edler	NN	2	edler
Weder	NN	2	Weder
vergnügt	JJ	2	vergnügt
ersen	VB	2	erste, ersten
Denkt	NN	2	Denkt
stumm	JJ	2	stumme
seh	VB, PRP$	2	sehen, seh
niemanden	NN	2	niemanden
Schaden	NN	2	Schaden
schwören	VB	2	schwören, geschworen
Tage	NN	2	Tage
banqueroute	NN	2	banqueroute
abern	VBN, VB	2	aber
Heirat	NNS, NN	2	Heiraten, Heirat
scheinbar	JJ	2	scheinbare, scheinbar
denjenig	DT	2	denjenigen
zwar	RB	2	zwar
neuen	VB	2	neue
stellen	VB, RP	2	stellt, gestellt
erwarten	VB	2	erwarten
bis	IN	2	bis
vom	IN	2	vom
weil	IN	2	weil
daraus	RB	2	daraus
vergelte	NN	2	vergelte
handeln	VB	2	handeln
besorgen	VB	2	besorgte
lang	JJ	2	lang
ausschlagen	NN	2	ausschlagen
Hören	NN	2	Hören
bestreben	VB	2	bestrebte, bestreben
wenigstens	RB, RP	2	wenigstens
entschloss	JJ	2	entschlossen
möglichstes	NN	2	möglichstes
sachte	PRP$	2	sachte
Gut	NN	2	Gut
Güter	NN	2	Güter
schmeicheln	VB	2	schmeicheln
Verstand	NN	2	Verstand
verlasse	NNP	2	verlasse
nochen	VB	2	noch
schändlich	JJ	2	schändlichen, schändlich
befürchte	NN	2	befürchte
liegen	VB	2	liegen, liegt
gedenken	VB	2	gedenken
Banqueroute	NN	2	Banqueroute
seinen	PRP$	2	seinen
einbilden	NN	2	einbilden
aufrichtige	NN, JJ	2	aufrichtige
desgleich	VB	2	desgleichen
anzufangen	VB	2	anzufangen
Mode	NN	2	Mode
vorstellen	VB, VBN	2	vorstellen, vorgestellt
Pöbel	NN	2	Pöbel
begehen	VB, RP	2	begangen
deine	PRP$	2	deine
etwa	IN	2	etwa
gefallen	VB, RP	2	gefallen
trauen	VB	2	trauen
bessern	VBN, RP	2	besser
Höre	NN	2	Höre
Wahrheit	NN	2	Wahrheit
eitle	NN	2	eitle
alleine	NN	2	alleine
derohalben	NN	2	derohalben
Haus	NN	2	Haus
lese	NN	2	lese
Drum	NN	2	Drum
Umständen	NN	2	Umständen
Spöttereien	NN	2	Spöttereien
Ihrigen	NN	2	Ihrigen
gestünde	NN	2	gestünde
Würde	NN	2	Würde
wär	JJ, NN	2	wäre, wär
Schimpf	NN	2	Schimpf
Mensch	NN	2	Mensch
Lust	NN	2	Lust
Leichtsinnigkeit	NN	2	Leichtsinnigkeit
wären	VB	1	wären
verhungern	NN	1	verhungern
würde	RB	1	würde
Verlust	NN	1	Verlust
Ehe	NN	1	Ehe
Liebste	NN	1	Liebste
bissgen	NN	1	bißgen
besässe	NN	1	besäße
ohngeachtet	NN	1	ohngeachtet
philosophisch	JJ	1	philosophisch
Hier	RB	1	Hier
Misstrauen	NN	1	Mißtrauen
täte	NN	1	täte
reichlich	JJ	1	reichlicher
Frisch	JJ	1	Frisch
gottesvergessen	NN	1	gottesvergessen
Gegenwart	NN	1	Gegenwart
vorstelle	NN	1	vorstelle
Galimathias	NNP	1	Galimathias
seinig	DT	1	seinige
Rückkunft	NN	1	Rückkunft
edlere	NN	1	edlere
Liebeserklärung	NN	1	Liebeserklärung
schänden	VB	1	schänden
überzeugen	VB	1	überzeugt
liebenswürdige	NN	1	liebenswürdige
Darnach	RB	1	Darnach
Zu	IN	1	Zu
drauf	RB	1	drauf
vermögen	VB	1	vermöge
hieren	VBN	1	hier
untreu	JJ	1	untreu
Gewinst	NN	1	Gewinst
Rache	NN	1	Rache
hintergehen	NN	1	hintergehen
Dazu	RB	1	Dazu
Schwärmereien	NN	1	Schwärmereien
Ansehen	NN	1	Ansehen
Gasthof	NN	1	Gasthof
sterben	VB	1	sterbe
wirklich	JJ	1	wirklich
Beinahe	NN	1	Beinahe
satt	JJ	1	satt
höre	VB	1	höre
Legen	NN	1	Legen
zugegriffen	NN	1	zugegriffen
unterdrückt	JJ	1	unterdrückt
verschwiegen	NN	1	verschwiegen
vermögend	JJ	1	vermögend
Verlassenschaft	NN	1	Verlassenschaft
jemals	IN	1	jemals
Taten	NN	1	Taten
Erleichterung	NN	1	Erleichterung
Aufrichtigkeit	NN	1	Aufrichtigkeit
Empfindlichkeit	NN	1	Empfindlichkeit
Übereilung	NN	1	Übereilung
bösen	NN	1	bösen
Gleichgewichte	NN	1	Gleichgewichte
schade	NN	1	schade
gescheh	JJ	1	geschehen
Antwort	NN	1	Antwort
aufrichtiger	NN	1	aufrichtiger
tragen	VB	1	tragen
aufrichtigen	NN	1	aufrichtigen
falsch	JJ	1	falsche
ungetreuer	NN	1	ungetreuer
Antrag	NN	1	Antrag
traurige	NN	1	traurige
übereinstimmen	VB	1	übereinstimmen
aufzuhelfen	NN	1	aufzuhelfen
Rechts	NN	1	Rechts
Seite	NN	1	Seite
verborgen	VBN	1	verborgen
verblendenden	NN	1	verblendenden
entzückt	NN	1	entzückt
Seits	NN	1	Seits
unwahrscheinlich	JJ	1	unwahrscheinlich
vernehmen	RP	1	vernommen
Mühle	NN	1	Mühle
werde	RB	1	werde
Muss	NN	1	Muß
Verzeihen	NN	1	Verzeihen
frei	JJ	1	frei
geliebt	NN	1	geliebt
Seinem	PRP$	1	Seinem
Seinen	PRP$	1	Seinen
Lasst	NN	1	Laßt
12000	CD	1	12000
gesunden	PRP$	1	gesunden
Seiner	PRP$	1	Seiner
unnötig	JJ	1	unnötig
Erschrecken	NN	1	Erschrecken
tot	JJ	1	tot
Herzens	NN	1	Herzens
bittet	VB	1	bittet
verbieten	VBN	1	verboten
Gegenliebe	NN	1	Gegenliebe
albern	JJ	1	albern
nahe	RP	1	nahe
ihren	PRP$	1	ihren
Geschlechts	NN	1	Geschlechts
umschreiben	VB	1	umschreiben
Liebeserklärungen	NN	1	Liebeserklärungen
Sei	NN	1	Sei
Verflucht	NN	1	Verflucht
kaltsinnig	RB	1	kaltsinnig
Eigennutz	NN	1	Eigennutz
durchaus	RB	1	durchaus
zaudern	NN	1	zaudern
entschuldigen	VB	1	entschuldigen
Streich	JJ	1	Streich
Häusern	NN	1	Häusern
balden	VBN	1	bald
genennt	NN	1	genennt
Vernunft	NN	1	Vernunft
Vollkommen	NN	1	Vollkommen
Seit	IN	1	Seit
dafür	RB	1	dafür
geizig	JJ	1	geizig
menschlich	JJ	1	menschlichen
beschämt	JJ	1	beschämt
Glücksgüter	NN	1	Glücksgüter
Leibesbeschaffenheit	NN	1	Leibesbeschaffenheit
Dienste	NN	1	Dienste
Jahre	NN	1	Jahre
sagt	VB	1	sagt
wirst	WRB	1	wirst
güldne	NN	1	güldne
verinteressiert	NN	1	verinteressiert
Königin	NN	1	Königin
Gemüter	NN	1	Gemüter
Bestreben	NN	1	Bestreben
nichte	NN	1	nichte
Freunden	NN	1	Freunden
schämen	VB	1	schämen
Zeug	NNS	1	Zeuge
blindlings	IN	1	blindlings
beschimpfen	VB	1	beschimpfet
Wolfe	NN	1	Wolfe
schimpft	NN	1	schimpft
beisteh	DT	1	beistehen
irr	JJ	1	irre
Wählen	NN	1	Wählen
Philosophin	NN	1	Philosophin
Schale	NN	1	Schale
ostindisch	JJ	1	ostindische
Gerechter	NN	1	Gerechter
Neugierigkeit	NN	1	Neugierigkeit
Behüte	NN	1	Behüte
zufried	JJ	1	zufrieden
edle	NN	1	edle
Regel	NN	1	Regel
Schweig	JJ	1	Schweig
Unter	IN	1	Unter
betrifft	VB	1	betrifft
Halten	NN	1	Halten
selig	JJ	1	selig
Rechenschaft	NN	1	Rechenschaft
stehlen	VB	1	gestohlen
fest	RB	1	fest
Floh	NN	1	Floh
Vorurteil	NN	1	Vorurteil
vorzubringen	VB	1	vorzubringen
Reizungen	NN	1	Reizungen
lahm	JJ	1	lahm
Kapitalten	VB	1	Kapitalen
verlören	NN	1	verlören
vernünftig	JJ	1	vernünftig
geirret	NN	1	geirret
meinern	VB	1	meiner
wüsste	NN	1	wüßte
hierinne	NN	1	hierinne
ankommen	VB	1	ankommen
Narren	NN	1	Narren
Vereinigung	NN	1	Vereinigung
lasst	WRB	1	laßt
besen	NN	1	beste
schäme	NN	1	schäme
sagten	NN	1	sagten
Glücklichste	NN	1	Glücklichste
gewinnen	VB	1	gewinnen
solle	NN	1	solle
weiss	VB	1	weiß
abzulaufen	VB	1	abzulaufen
niemals	RB	1	niemals
Tugend	NN	1	Tugend
hat	RB	1	hat
beunruhigen	VB	1	beunruhigen
beunruhiget	NN	1	beunruhiget
Geier	NN	1	Geier
Kohle	NNS	1	Kohlen
trockne	NN	1	trockne
Aus	IN	1	Aus
jaten	RP	1	ja
Lisett	NN	1	Lisette
widerfahren	NN	1	widerfahren
weichet	NN	1	weichet
Beifall	NN	1	Beifall
vorgesucht	NN	1	vorgesucht
Beschäftigung	NN	1	Beschäftigung
Leb	NN	1	Leb
ums	IN	1	ums
Punkt	NN	1	Punkt
He	NN	1	He
binden	VB	1	binden
anfängt	VBN	1	anfängt
Bräutigam	NN	1	Bräutigam
Grab	NN	1	Grab
verschweigen	VB	1	verschweigen
Setzen	NN	1	Setzen
gründen	VB	1	gegründet
Antrage	NN	1	Antrage
ausfündig	JJ	1	ausfündig
Feindschaft	NN	1	Feindschaft
fern	JJ	1	fern
naseweis	JJ	1	naseweis
dürfte	VB	1	dürfte
verargen	NN	1	verargen
unbillig	JJ	1	unbillig
beleidigten	NN	1	beleidigten
war	VB	1	war
zählen	VB	1	zählt
mitbringen	VB	1	mitbringen
leider	RB	1	leider
artige	JJ	1	artige
nunmehr	IN	1	nunmehr
fort	RP	1	fort
beschwerlich	JJ	1	beschwerlich
Voll	NN	1	Voll
verdammte	NN	1	verdammte
übereilet	NN	1	übereilet
Entdecken	NN	1	Entdecken
gelangen	PRP$	1	gelangen
Tränen	NN	1	Tränen
schweig	JJ	1	schweig
erholen	VB	1	erholen
Freundin	NN	1	Freundin
banquerout	NN	1	banquerout
Erstaunen	NN	1	Erstaunen
Zwischen	IN	1	Zwischen
Verdrusse	NN	1	Verdrusse
Mährgen	IN	1	Mährgen
Aufrichtig	IN	1	Aufrichtig
gehören	VB	1	gehöret
unschmackhaft	PRP$	1	unschmackhaft
ersetzen	VB	1	ersetzen
Schmerz	NN	1	Schmerz
Glauben	NN	1	Glauben
sieht	VB	1	sieht
Falschheit	NN	1	Falschheit
kützeln	NN	1	kützeln
verliebt	JJ	1	verliebt
spielte	NN	1	spielte
wählen	VB	1	wählen
entzücket	NN	1	entzücket
schwerlich	JJ	1	schwerlich
Rang	NN	1	Rang
vernünftigsten	NN	1	vernünftigsten
Kreaturen	NN	1	Kreaturen
Angelegenheiten	NN	1	Angelegenheiten
ungegründet	NN	1	ungegründet
selben	VBN	1	selbst
aufbringen	VB	1	aufbringen
Verschwiegenheit	NN	1	Verschwiegenheit
wiederholen	VB	1	wiederholen
Unrecht	NN	1	Unrecht
einzigen	VB	1	einzige
erdulden	NN	1	erdulden
scheinet	NN	1	scheinet
Zuwurf	NN	1	Zuwurf
übereinstimmte	NN	1	übereinstimmte
Summe	NN	1	Summe
aufhelfen	NN	1	aufhelfen
herbestellet	NN	1	herbestellet
auszusöhnen	NN	1	auszusöhnen
schaden	VB	1	schaden
dich	PRP	1	dich
schadet	VB	1	schadet
Zwei	CD	1	Zwei
vorplaudern	NN	1	vorplaudern
bleibe	NNP	1	bleibe
liebern	VB	1	lieber
bezeigen	VBN	1	bezeigte
Begriffen	NN	1	Begriffen
unsers	PRP$	1	unsers
Bei	IN	1	Bei
worüber	RB	1	worüber
würdigen	VB	1	würdigen
unsere	PRP$	1	unsere
unserm	PRP$	1	unserm
gestern	IN	1	gestern
Sage	NN	1	Sage
würdig	JJ	1	würdig
Unsre	NN	1	Unsre
Unterschied	NN	1	Unterschied
Bezeigen	NN	1	Bezeigen
Mit	IN	1	Mit
gewisseste	JJ	1	gewisseste
beruhen	VB	1	beruht
inständig	JJ	1	inständig
zärtlichen	VBN	1	zärtlich
schwärmst	NN	1	schwärmst
zärtlicher	NN	1	zärtlicher
schlimm	JJ	1	schlimm
Gesellschaft	NN	1	Gesellschaft
beschliessen	VBN	1	beschlossen
Gunst	NN	1	Gunst
immer	RP	1	immer
woran	WDT	1	woran
Jener	NNP	1	Jener
verschwenderisch	JJ	1	verschwenderische
tauschen	VB	1	tauschen
höret	VB	1	höret
quält	NN	1	quält
Begreifen	VB	1	Begriffe
Fall	NN	1	Fall
Schäfchen	VB	1	Schäfchen
empfindlichern	VB	1	empfindlicher
stolze	NN	1	stolze
gedient	NN	1	gedient
verzeiht	NNP	1	verzeiht
Wucher	NN	1	Wucher
Findet	NN	1	Findet
bekömmt	NN	1	bekömmt
zuschreiben	VB	1	zuschreiben
Verräterei	NN	1	Verräterei
tadeln	VB	1	tadeln
schuldig	JJ	1	schuldig
Grams	NN	1	Grams
Licht	NN	1	Licht
scheint	JJ	1	scheint
Vorwürfe	NN	1	Vorwürfe
Stark	NN	1	Stark
versuchten	NN	1	versuchten
befinden	VB	1	befinde
schlagen	VB	1	schlagen
ewig	JJ	1	ewig
Feuer	NN	1	Feuer
schlecht	JJ	1	schlecht
Kurz	NN	1	Kurz
Leute	NN	1	Leute
wert	RP	1	wert
gehe	NN	1	gehe
bestehen	VB	1	bestehen
stärk	JJ	1	stärker
vertrauen	VB	1	vertrauen
abzuwaren	VB	1	abzuwarten
sag	NN	1	sag
beinahe	WRB	1	beinahe
Tauschen	VB	1	Tauschen
sau	JJ	1	sauer
Halt	NN	1	Halt
Angst	NN	1	Angst
schätzte	NN	1	schätzte
Mitleiden	NN	1	Mitleiden
falle	NN	1	falle
Notwendig	JJ	1	Notwendig
Noch	RB	1	Noch
ausholen	VB	1	ausholen
Soldatenmode	NN	1	Soldatenmode
lernen	VB	1	lernen
einsehen	VB	1	einsehen
führen	VB	1	führt
Wen	NN	1	Wen
verrichten	VB	1	verrichten
schimpfte	NNP	1	schimpfte
auszuhalten	NN	1	auszuhalten
Einöde	NN	1	Einöde
Wo	WRB	1	Wo
Entschlusses	NN	1	Entschlusses
erleichtern	VB	1	erleichtern
beurteilen	VB	1	beurteilt
merken	VB	1	merke
erzürnet	NN	1	erzürnet
nachzusetzen	NN	1	nachzusetzen
geh	NN	1	geh
Alles	NN	1	Alles
schwer	JJ	1	schwerer
Madamen	JJ	1	Madam
beizustehen	NN	1	beizustehen
vielmalten	VBN	1	vielmal
Verlassen	NN	1	Verlassen
erkundigen	VB	1	erkundigen
liebsten	NN	1	liebsten
besonder	JJ	1	besonderes
Müssen	NN	1	Müssen
zugestossen	NN	1	zugestoßen
geschwind	RP	1	geschwind
versichert	NN	1	versichert
gottlose	NN	1	gottlose
Frauenzimmers	NN	1	Frauenzimmers
jemanden	NN	1	jemanden
kämpfen	VB	1	kämpfen
gedulden	NN	1	gedulden
Verdriessliche	JJ	1	Verdrießliche
Erlauben	NN	1	Erlauben
Rockknöpfe	NN	1	Rockknöpfe
andres	NN	1	andres
teilen	VB	1	teilen
vorfallender	NN	1	vorfallender
glaube	VB	1	glaube
möge	RB	1	möge
besitze	NN	1	besitze
berede	NN	1	berede
eigennützig	JJ	1	eigennützig
niederträchtigen	NN	1	niederträchtigen
niederträchtiger	NN	1	niederträchtiger
verunglücket	NN	1	verunglücket
gehässiger	NNP	1	gehässiger
glücklichen	VBN	1	glücklich
Schwäche	NN	1	Schwäche
anzuvertrauen	VB	1	anzuvertrauen
Munde	JJ	1	Munde
Versichern	NN	1	Versichern
parat	JJ	1	parat
gewollt	NN	1	gewollt
Abends	NN	1	Abends
Vorwand	NN	1	Vorwand
neuem	NN	1	neuem
begegnen	VB	1	begegnet
schonen	VBN	1	schon
Sperlinge	NN	1	Sperlinge
verdammen	VB	1	verdammen
versteht	JJ	1	versteht
klüger	NN	1	klüger
garen	VB	1	gar
wahren	VB	1	wahre
bemühen	VB	1	bemühen
zuvor	RP	1	zuvor
vergeben	VB	1	vergeben
habt	NN	1	habt
Gehen	NN	1	Gehen
schamhaft	NN	1	schamhaft
lossprechen	VBN	1	lossprechen
nötig	JJ	1	nötige
befreien	VB	1	befreien
eitel	JJ	1	eitel
Wesentlichen	NN	1	Wesentlichen
Alsdenn	NN	1	Alsdenn
aufzuopfern	NN	1	aufzuopfern
abfinden	PRP$	1	abfinden
Kannst	NN	1	Kannst
welcher	WP	1	welcher
gäben	NN	1	gäben
Zweck	NN	1	Zweck
welchem	WP	1	welchem
kostbarste	NN	1	kostbarste
wiederholte	NN	1	wiederholte
Sollte	NN	1	Sollte
getröste	NN	1	getröste
Dessen	WDT	1	Dessen
Wisset	NN	1	Wisset
zärtlichsten	NN	1	zärtlichsten
keins	NN	1	keins
zanken	NN	1	zanken
redete	NN	1	redete
vorsagen	VBN	1	vorgesagt
verliebte	NN	1	verliebte
eigentlich	JJ	1	eigentlich
Darf	NN	1	Darf
unerschrocknen	NN	1	unerschrocknen
Nichts	NN	1	Nichts
Geniessen	NN	1	Genießen
Alsdann	NNP	1	Alsdann
Winter	NN	1	Winter
alt	JJ	1	alten
törichten	NN	1	törichten
verstehst	NN	1	verstehst
Habt	NN	1	Habt
gescheiter	NN	1	gescheiter
Fein	NN	1	Fein
Bleiben	VB	1	Bleiben
gewahr	NN	1	gewahr
begleiten	PRP$	1	begleiten
Kleinigkeit	NN	1	Kleinigkeit
rate	NN	1	rate
unterstehen	NN	1	unterstehen
warteten	NN	1	warteten
verleumden	VB	1	verleumden
Vielleichen	VBN	1	Vielleicht
treffen	VB	1	treffen
Verdienst	NN	1	Verdienst
meist	DT	1	meisten
mengest	NN	1	mengest
Pfui	NN	1	Pfui
Mühe	NN	1	Mühe
häufig	JJ	1	häufig
Ton	NN	1	Ton
Kräften	NN	1	Kräften
mache	NN	1	mache
widerlegen	VB	1	widerlegen
streite	NN	1	streite
Verziehen	NN	1	Verziehen
taub	JJ	1	taub
halte	NN	1	halte
übrigens	RP	1	übrigens
gegründet	JJ	1	gegründeter
beitragen	VB	1	beitragen
anbringen	RP	1	angebracht
Warum	NN	1	Warum
rasend	JJ	1	rasend
werfen	VB	1	werfen
verliebten	JJ	1	verliebten
zehnmal	IN	1	zehnmal
Gasthofe	NN	1	Gasthofe
verliebter	NN	1	verliebter
versehen	VB	1	versehen
unzähligen	NN	1	unzähligen
Wände	NN	1	Wände
nachlässiger	NNP	1	nachlässiger
vollends	NN	1	vollends
Armen	NN	1	Armen
ferner	IN	1	ferner
bestimmen	VB	1	bestimmen
allerliebster	NN	1	allerliebster
erwählen	NN	1	erwählen
schallen	VB	1	schallen
Wertester	NN	1	Wertester
Liebst	JJ	1	Liebster
unersetzlich	JJ	1	unersetzlichen
Notlügen	NN	1	Notlügen
Anblick	NN	1	Anblick
Hase	NNS	1	Hasen
prächtige	NN	1	prächtige
Verzeihungen	NN	1	Verzeihungen
närrisch	JJ	1	närrischen
löblich	JJ	1	löbliche
flüchtig	JJ	1	flüchtig
tausend	CD	1	tausend
uneinig	JJ	1	uneinig
Unwürdigen	NN	1	Unwürdigen
nachteilige	NN	1	nachteilige
genennet	NN	1	genennet
zugestehen	VB	1	zugestehen
ungeschickt	JJ	1	ungeschickt
unerträglich	JJ	1	unerträglich
Niederträchtig	JJ	1	Niederträchtig
bewaffnet	JJ	1	bewaffnet
zukommen	PRP$	1	zukommen
lässen	VB	1	läßt
hinlänglich	JJ	1	hinlänglich
blieb	NN	1	blieb
Haar	NN	1	Haar
Füssen	NNP	1	Füßen
irren	VB	1	irren
hassen	VB	1	hassen
mächtiger	NN	1	mächtiger
schlüge	NN	1	schlüge
Dienerin	NN	1	Dienerin
weisst	NN	1	weißt
jed	DT	1	jeder
vollkommen	JJ	1	vollkommene
Gegengunst	NN	1	Gegengunst
zärtlichst	JJ	1	zärtlichste
Umstand	NNS	1	Umstände
entzückende	NN	1	entzückende
erdichtete	NN	1	erdichtete
Kein	JJ	1	Keines
Gunstbezeigungen	NN	1	Gunstbezeigungen
zwölf	CD	1	zwölf
Erfahrung	NN	1	Erfahrung
grösstes	NN	1	größtes
Schelmstück	NN	1	Schelmstück
Vorwande	NN	1	Vorwande
hintergangen	NN	1	hintergangen
kostbar	JJ	1	kostbare
Einfallen	NN	1	Einfallen
Verbrechen	NN	1	Verbrechen
unserer	PRP$	1	unserer
Hab	NN	1	Hab
Stande	NN	1	Stande
verblendet	NN	1	verblendet
Freierei	NN	1	Freierei
Heute	RB	1	Heute
schwiegen	NN	1	schwiegen
Reich	VB	1	Reichen
ungestümes	NN	1	ungestümes
fliehen	VB	1	fliehen
Notwendigkeit	NN	1	Notwendigkeit
Waage	NN	1	Waage
ungesund	NN	1	ungesund
lachen	VB	1	lacht
Knall	NN	1	Knall
schüchtern	JJ	1	schüchtern
vermuteten	NN	1	vermuteten
Könnte	NN	1	Könnte
gäbe	NN	1	gäbe
dumm	JJ	1	dumme
auchen	VBN	1	auch
fähig	JJ	1	fähig
unvergeblich	JJ	1	unvergeblich
klug	JJ	1	klug
Entschlusse	NN	1	Entschlusse
nützlich	JJ	1	nützlich
Reue	NN	1	Reue
Ohre	NN	1	Ohre
würfeln	VB	1	würfeln
lass	JJ	1	laß
Treue	NN	1	Treue
finde	NN	1	finde
Tode	NN	1	Tode
Fehler	NN	1	Fehler
Urteilen	NN	1	Urteilen
Unruhe	NN	1	Unruhe
Bettlerin	NN	1	Bettlerin
heeissen	RB	1	heißt
unschuldig	JJ	1	unschuldig
nähern	VBN	1	näher
bewahren	VB	1	bewahren
sehren	VB	1	sehr
Nachwelt	NN	1	Nachwelt
trotzt	NN	1	trotzt
hegen	NN	1	hegen
Unwürdigern	NN	1	Unwürdigern
Arbeit	NN	1	Arbeit
eingenommen	NN	1	eingenommen
recht	VB	1	recht
fühlen	VB	1	fühle
verhasst	NN	1	verhaßt
warum	WRB	1	warum
Versuch	NN	1	Versuch
entdeckten	NN	1	entdeckten
Sollen	MD	1	Soll
Kummer	NNP	1	Kummer
brechen	VB	1	brechen
Vater	NN	1	Vater
Zufalle	NN	1	Zufalle
erschrecken	VB	1	erschrecken
vermutet	NN	1	vermutet
bin	JJ	1	bin
Zärtliche	RB	1	Zärtliche
erste	RB	1	erste
Niemand	NN	1	Niemand
Bundes	NN	1	Bundes
hinter	IN	1	hinter
Bosheit	NN	1	Bosheit
seinetwegen	JJ	1	seinetwegen
Nehmen	VB	1	Nehmen
Banquerouten	NN	1	Banquerouten
Empfindung	NNS	1	Empfindungen
Tagen	NN	1	Tagen
Sammelplatz	NN	1	Sammelplatz
gröblich	JJ	1	gröblich
ungestüm	JJ	1	ungestüm
acht	CD	1	acht
verachtungswert	NN	1	verachtungswert
hergekommen	NN	1	hergekommen
Wichtigen	VB	1	Wichtige
ausdrücklich	RB	1	ausdrücklich
verderben	VB	1	verderben
verursachen	VB	1	verursachen
Hartnäckigkeit	NN	1	Hartnäckigkeit
verfahren	VB	1	verführen
Geheimnis	NN	1	Geheimnis
sähe	NN	1	sähe
ausschütten	VB	1	ausschütten
tändeln	NN	1	tändeln
Rtlr	NN	1	Rtlr
Herren	NN	1	Herren
Ansehung	NN	1	Ansehung
verkündigen	VBN	1	verkündigt
Frauenzimmer	NN	1	Frauenzimmer
Begierde	NN	1	Begierde
willen	IN	1	willen
stünden	NN	1	stünden
Geiz	NN	1	Geiz
teilten	NN	1	teilten
Man	DT	1	Man
einigermassen	RB	1	einigermaßen
Itzo	NN	1	Itzo
nähmen	NN	1	nähmen
dran	RP	1	dran
holen	VB	1	holt
eingelaufen	NN	1	eingelaufen
Nase	NN	1	Nase
edl	JJ	1	edle
ausstehen	NN	1	ausstehen
dagegen	RB	1	dagegen
könnte	VB	1	könnte
gescheute	JJ	1	gescheute
Not	NN	1	Not
Schon	RB	1	Schon
brächten	NN	1	brächten
Angesicht	NN	1	Angesicht
gemein	JJ	1	gemein
beliebt	JJ	1	beliebt
weien	VBN	1	weit
Statt	RP	1	Statt
belebt	JJ	1	belebter
stünde	NN	1	stünde
vereinigen	VB	1	vereinigen
Brief	NNS	1	Briefe
gütig	JJ	1	gütig
Gemüt	NN	1	Gemüt
süssen	NN	1	süßen
übermorgen	RB	1	übermorgen
Verziehn	NN	1	Verziehn
liebenswürdigsten	NN	1	liebenswürdigsten
Stolze	NN	1	Stolze
Seeln	VB	1	Seelen
ergeben	VBN	1	ergeben
besorgten	NN	1	besorgten
unglücklichste	NN	1	unglücklichste
zuging	FW	1	zuging
Lügen	NN	1	Lügen
untereinander	NN	1	untereinander
wenigst	JJ	1	wenigsten
kurzen	NN	1	kurzen
liebst	JJ	1	liebster
Machen	VB	1	Machen
erhabenen	NN	1	erhabenen
widerführe	NN	1	widerführe
Worinne	NN	1	Worinne
eigennützige	NNP	1	eigennützige
Euer	NN	1	Euer
liebenswürdig	JJ	1	liebenswürdig
ziemlich	JJ	1	ziemlich
erstaunet	NN	1	erstaunet
gereuen	NN	1	gereuen
Erfüllung	NN	1	Erfüllung
horchen	VB	1	horchen
beschieden	NN	1	beschieden
Geldern	NN	1	Geldern
hoch	JJ	1	hoch
wundern	RP	1	gewundert
zehn	CD	1	zehn
Womit	NN	1	Womit
morgen	RB	1	morgen
seltsam	JJ	1	seltsam
Sollten	NN	1	Sollten
Allein	NN	1	Allein
Widern	VB	1	Wider
erwählt	NN	1	erwählt
Gleich	JJ	1	Gleiches
Galgenschwengeln	NNP	1	Galgenschwengeln
Tun	NN	1	Tun
liebenswürdigen	JJ	1	liebenswürdigen
besess	JJ	1	besessen
suchte	NN	1	suchte
Teil	NN	1	Teil
müd	JJ	1	müde
heraus	RB	1	heraus
hinderlich	JJ	1	hinderlich
Abschied	NN	1	Abschied
erwägen	VB	1	erwägen
Narr	NN	1	Narr
wunderlich	JJ	1	wunderlich
dahin	RB	1	dahin
anwendeten	NN	1	anwendeten
wodurch	WRB	1	wodurch
Hause	NN	1	Hause
vorteilhaftesten	NN	1	vorteilhaftesten
herausfordern	NN	1	herausfordern
Erklärungen	NN	1	Erklärungen
verpflichten	VBN	1	verpflichtet
uneigennützigst	JJ	1	uneigennützigsten
Versuchen	NN	1	Versuchen
Scherz	NN	1	Scherz
hättest	WRB	1	hättest
ausschweifende	NN	1	ausschweifende
übrigen	VBN	1	übrig
vorhin	RB	1	vorhin
prächtig	JJ	1	prächtig
wundersam	JJ	1	wundersam
anfangs	RB	1	anfangs
kurz	JJ	1	kurzem
jemand	DT	1	jemand
darbien	VB	1	darbieten
einzusehen	NN	1	einzusehen
munter	JJ	1	munter
aushalten	NN	1	aushalten
schuld	NN	1	schuld
geleg	JJ	1	gelegen
Dem	DT	1	Dem
stehen	VB	1	steht
Befürchten	NN	1	Befürchten
Schluss	NN	1	Schluß
Glücklichsten	NN	1	Glücklichsten
stehet	NN	1	stehet
Unsere	PRP$	1	Unsere
Geschicklichkeit	NN	1	Geschicklichkeit
Entweder	NN	1	Entweder
Bauersfrau	NN	1	Bauersfrau
Haben	VB	1	Haben
davor	RB	1	davor
Fehlers	NN	1	Fehlers
gleichwo	NN	1	gleichwo
Anhalten	NN	1	Anhalten
standhafte	NN	1	standhafte
dein	PRP$	1	dein
Lieben	NN	1	Lieben
unüberwindlich	JJ	1	unüberwindlichen
setzten	NN	1	setzten
anderern	VB	1	anderer
Schwierigkeit	NN	1	Schwierigkeit
vorhalte	NN	1	vorhalte
Grausamer	NN	1	Grausamer
Lob	NNS	1	Lobe
besinnen	VB	1	besinnen
Schimpfe	NN	1	Schimpfe
gebe	NN	1	gebe
Ganze	NN	1	Ganze
eifersüchtigen	VBN	1	eifersüchtig
Geh	NN	1	Geh
Könnten	NN	1	Könnten
Könntet	NN	1	Könntet
loben	VB	1	loben
entziehen	VB	1	entziehen
Hoffnung	NN	1	Hoffnung
nütze	NN	1	nütze
ändern	RP	1	geändert
entdecken	VB	1	entdecken
Unkosten	NN	1	Unkosten
verachtungswürdiger	NN	1	verachtungswürdiger
Zweifelt	NN	1	Zweifelt
entzogen	NN	1	entzogen
gewuchert	NN	1	gewuchert
schw	JJ	1	schwer
Sorgen	NN	1	Sorgen
oft	IN	1	oft
Welch	JJ	1	Welchen
Nebenbuhlern	NN	1	Nebenbuhlern
abwarten	VB	1	abwarten
vorschlagen	VB	1	vorschlagen
wen	WP	1	wen
geholfen	NN	1	geholfen
niederträchtige	NNP	1	niederträchtige
klugen	VBN	1	klug
Lebt	NN	1	Lebt
beurteile	NN	1	beurteile
Damons	NN	1	Damons
liebt	NN	1	liebt
schlage	NN	1	schlage
aufgehört	NN	1	aufgehört
Maus	NN	1	Maus
dahinter	RB	1	dahinter
Reichtume	NN	1	Reichtume
Um	IN	1	Um
Jugend	NN	1	Jugend
neidisch	JJ	1	neidisch
erworbener	NN	1	erworbener
weder	CC	1	weder
Geldes	NN	1	Geldes
Gelder	NN	1	Gelder
entschlassen	VB	1	entschließen
geheim	JJ	1	geheime
ausnehmende	NN	1	ausnehmende
Bald	NN	1	Bald
Nötiges	NN	1	Nötiges
übrig	JJ	1	übrig
ltzo	NN	1	ltzo
Den	DT	1	Den
Vertrauen	NN	1	Vertrauen
Dienen	NN	1	Dienen
treten	VB	1	treten
ins	IN	1	ins
Anbeter	NN	1	Anbeter
getreust	JJ	1	getreuste
genau	RB	1	genau
vorzuwerfen	VB	1	vorzuwerfen
niemalsen	VB	1	niemals
Fällen	NN	1	Fällen
wohlgemachte	NN	1	wohlgemachte
täten	NN	1	täten
