Title: Der Schatz
Number of all lemmas: 11596
Nummber of different lemmas: 2131

Lemma	POS	Frequency	Tokens
sein	VB, VBN, PRP$, RB, JJ	373	sein, bin, wäre, wären, ist, sind, war, sei, gewesen, waren
ich	JJ, PRP, PRP$	317	ich
Sie	JJ, PRP	248	Sie
ein	DT, RP	238	ein, eine, einer, einem, einen, eines
nicht	RB	214	nicht
haben	VB, RB	188	hat, haben, habe, hätte, hatten, hätten, hatte
und	CC	155	und
die	WDT, DT	138	die
das	DT, WDT	136	das
es	PRP, JJ, PRP$	135	es
zu	TO, IN, RB	132	zu
der	DT, WDT	127	der, deren
so	RB, IN, NNP, WRB	121	so
dass	IN, RB	119	daß
Ich	PRP	111	Ich
er	JJ, PRP	109	er
wollen	MD	98	wollten, will, wollte, wollen, wollt, wolle
mir	PRP, JJ	97	mir
Herr	NN, NNP, JJ	90	Herr
den	DT, WDT	90	den
werden	VB, VBN	89	wird, würden, werden, wurde, würde, geworden, werde
mich	PRP	82	mich
sich	PRP	79	sich
sie	PRP, JJ	78	sie
doch	RB, CC, RP, IN, NNP, WRB	75	doch
können	VBN, VB, PRP$	74	könnte, kann, können, könne, kannst, könnten, konnte
mein	PRP$, JJ	74	mein, meine, meiner
von	IN, TO	74	von
in	IN, TO	71	in
sollen	MD	69	soll, sollte, sollen
wenn	IN, RB	68	wenn
Er	PRP, JJ	67	Er
noch	RB, RP, IN	65	noch
wohl	RP, RB, IN	65	wohl
dem	DT, WDT	64	dem
auf	IN, RP, TO	63	auf
was	WP, WDT, DT	63	was
Und	CC, RB	59	Und
sagen	RP, VB, VBN	59	gesagt, sage, sagen, sagt, sagte
als	IN	58	als
all	DT, JJ	57	alles, allen, alle, aller, allem
mit	IN, RP, TO	57	mit
auch	RB, IN, RP	56	auch
nur	RB, IN, WRB, RP, NNP	55	nur
Das	DT	54	Das
Aber	CC, RB	53	Aber
Ihnen	PRP, JJ	52	Ihnen
Lelio	NN, NNP, JJ	52	Lelio
gut	JJ, VB	50	gut, guten, gute, guter, gutem
für	IN, TO	49	für
du	PRP, JJ	49	du
Was	WP	49	Was
denn	RB, IN, RP	45	denn
an	IN, RP, TO	41	an
wieder	RB, RP, IN	41	wieder
mussen	VB, VBN, RB	40	muß, mußte, mußt
bei	IN, TO	40	bei
ihm	PRP, JJ	39	ihm
ja	RB, RP	38	ja
Ihr	PRP$, JJ, NN	36	Ihr, Ihres, Ihrem
meinen	PRP$, VB, VBN	35	meinen, meine, meinte, meinten
nun	RB, RP	34	nun
wie	IN	34	wie
ihn	PRP, JJ	33	ihn
Es	PRP, PRP$	33	Es
Philto	NN, NNP	33	Philto
Anselmo	NN, NNP, JJ	32	Anselmo
Ja	NN, JJ	32	Ja
man	DT	32	man
eben	RB, RP, NNP, IN	31	eben
viel	RB, RP, IN, DT	31	viel, vielen
geben	VB, VBN	30	geben, gibt, gegeben, gäben, gab
dies	DT, WDT	30	dieses, diesen, diese, dieser, diesem
aber	RB, WRB, RP, IN, CC	30	aber
schon	RB, IN, RP	30	schon
Nun	UH	30	Nun
Maskarill	NNP, NN	30	Maskarill
ganz	NNP, IN, RB, JJ, RP	30	ganz, ganze, ganzer, ganzen, ganzes
alt	JJ, VB	29	alt, alte, alter, alten
gar	RB, RP	29	gar
Sohn	NN, NNP	28	Sohn
Wenn	IN, RB	28	Wenn
Wie	IN	28	Wie
machen	VB, VBN	28	machen, macht, gemacht
lassen	VB, VBN, NN, RB	28	lasse, lassen
kommen	VB, VBN	28	kommen, komme, kam, käme, gekommen
Vater	NN, NNP	27	Vater
tun	VB, VBN, RP	27	tun, tut, getan, tat
Freund	NN, NNS, JJ	27	Freund, Freunde
lieb	JJ, VB	25	lieb, lieber, liebe, liebes, lieben
Mann	JJ, NN, NNP	25	Manne, Mann
Haus	NN	25	Haus
Taler	NN	24	Taler
mehr	IN, RB, WRB, RP	23	mehr
kein	JJ, DT	23	keine, kein, keinen
sehen	VB, VBN, RB	22	sehen, gesehen, sieht, sah
selbst	JJ	22	selbst
Jahr	NN, JJ	22	Jahr, Jahre
Sein	PRP$, VBN, VB, RB	22	Sein, Ist, Sind, War
gehen	VB	22	gehen, ging, geht
aus	IN, RP	21	aus
nichts	DT, RB	21	nichts
dich	PRP	21	dich
etwas	DT, JJ	21	etwas
Staleno	NNP, NN	21	Staleno
um	RP, IN	21	um
Ihre	PRP$	21	Ihre
Geld	NN	21	Geld
ist	VB, RB, JJ	20	ist
da	IN, RB	20	da
gewiss	NN, JJ	19	gewiß, gewissen, gewisse
sprechen	VB, VBN, RP	19	sprechen, gesprochen, sprach, spricht
tausend	CD	19	tausend
sehr	RB, IN	19	sehr
Ein	DT	19	Ein, Eine, Einen
hier	IN, RB, RP	19	hier
Leute	NN	18	Leute
müssen	VB, RB	18	müssen, müßte, müßten
genug	IN, RP, RB	17	genug
des	DT	17	des
O	NN, NNP	17	O
weeissen	VB	17	weiß
jetzt	RB, RP	16	jetzt
wissen	VB	16	wissen
meine	PRP$	16	meine
Die	DT	16	Die
hören	VB	15	höre, hören, hörte, hört
oder	CC	15	oder
So	RB, IN	15	So
Herrn	JJ, NN	15	Herrn
vor	IN, RP	15	vor
seinen	PRP$	15	seinen
Schwester	NN	14	Schwester
Mädchen	NN	14	Mädchen
Wort	NN, NNS	14	Wort, Worte
wahr	RP, JJ	14	wahr, wahre
zur	IN	14	zur
ob	IN, RB	14	ob
Leander	NN	14	Leander
Anselmus	NN	14	Anselmus
glauben	VB, VBN	14	glaube, glaubte, glauben, geglaubt, glaubt
Hause	NN	14	Hause
gleich	JJ	14	gleich
gegen	IN	13	gegen
soen	VBN, RB	13	so
wo	WRB	13	wo
dir	PRP	13	dir
Je	IN, RB	13	Je
Ohne	IN	13	Ohne
Namen	NN	13	Namen
Aussteuer	NN	13	Aussteuer
ihr	PRP, JJ	13	ihr
sehe	PRP$	13	sehe
Raps	NN, NNP	13	Raps
Der	DT	13	Der
wenig	RB, IN, JJ	12	wenig, wenigen
ehrlich	JJ	12	ehrliche, ehrlicher, ehrlichen, ehrlich
nehmen	VB, RB	12	nehme, nehmen, genommen, nahm, nimmt
Du	NN	12	Du
kennen	VB, VBN	12	kennt, kennen, kenne
über	IN	12	über
durch	IN	12	durch
also	RP, RB	12	also
Mündel	NN	12	Mündel
Interessen	NN	12	Interessen
Vormund	NN, NNP	12	Vormund
Brief	NNS	12	Briefe
wir	PRP, JJ	12	wir
rechen	VB, VBN	12	recht, rechte
Nicht	RB, NN	12	Nicht, Nichten
wer	WP	12	wer
heeissen	RB, VB	12	heißt, heiße, heißen
Tochter	NN	11	Tochter
bringen	VB, VBN	11	bringt, gebracht, bringen, bringe
meinem	PRP$	11	meinem
einmal	RB, RP, IN, JJ	11	einmal
ohne	IN	11	ohne
kriegen	VB	11	kriegt, kriegen
Betrieger	NN	11	Betrieger
finden	VB, RB	11	finden, findet, fand
Koffer	NN	11	Koffer
weg	JJ, RP, VB, RB	11	weg
Ach	NN	11	Ach
klein	JJ, VB	10	klein, kleine, kleiner, kleinen
uns	JJ, PRP	10	uns
erst	RB, JJ, VB	10	erst, ersten, erste
mögen	VB	10	mögen, mag, möchte, möchten
lange	RB, IN, RP	10	lange
verdienen	VB, VBN	10	verdienen, verdient
seine	PRP$	10	seine
ab	RP, RB	10	ab
Ei	NN	10	Ei
bekommen	VB, VBN	10	bekommen
nach	IN, RP	10	nach
arm	JJ, NN	10	arm, armen, armes, arme, armer
kömmen	MD	9	kömmt
Seite	NN	9	Seite
im	IN	9	im
denken	VB	9	denken, denke
lüderlich	JJ	9	lüderlichen
In	IN	9	In
gross	JJ	9	großes, groß, großer
reden	VB	9	reden, redet
Mein	NN, JJ	9	Mein
Bei	IN	9	Bei
verkaufen	VB, VBN	9	verkauft, verkaufen
jung	JJ	9	jung, junge, jungen
bezahlen	RP, VB, VBN	8	bezahlt, bezahlen
wirklich	JJ	8	wirklich
deinen	NN, JJ	8	deinen
bitten	VB	8	bitte
unter	IN	8	unter
gehören	VBN, VB, RP	8	gehört, gehören
Ihrer	PRP$	8	Ihrer
sechs	CD	8	sechs
Da	IN	8	Da
Sache	NN	8	Sache
besser	RB	8	besser
Gehen	VB, NN, RB	8	Geht, Gehen
kaufen	VB, VBN, RP	8	kaufen, gekauft
nennen	VB, PRP$	8	nennt, nennen, nenne
andern	JJ, VB, DT	8	andern, andere
Gott	NN, JJ	8	Gott
recht	NN, JJ, RB	8	recht, rechter
warum	WRB	8	warum
zwar	RB, JJ	8	zwar
weit	JJ	8	weit
Man	DT	8	Man
wenigstens	RB	8	wenigstens
Frau	NN, JJ	8	Frau
deine	PRP$	8	deine
Den	DT	8	Den
Nachricht	NN, NNS, JJ	8	Nachricht, Nachrichten
Zeit	NN, JJ	7	Zeit
zum	IN	7	zum
Hand	NN	7	Hand
Ihrem	NN	7	Ihrem
Unglück	NN	7	Unglück
wegen	IN, RP	7	wegen
Kinder	NN	7	Kinder
habe	RB, VB	7	habe
Jahren	NN	7	Jahren
wohnt	NN	7	wohnt
sonst	RB, IN	7	sonst
weil	IN, RB	7	weil
funfzig	RB, JJ	7	funfzig
letzt	JJ	7	letzter, letzten, letzte
bleiben	VB, PRP$	7	bleiben, bleibt
halten	VBN, VB, RB	7	gehalten, halten
stehen	VB	7	stehen, steht
leben	VB	7	leben
einig	DT, JJ	7	einige, einigen, einiges
Welt	NN	7	Welt
Barschaft	NN	6	Barschaft
neu	JJ	6	neuen, neue
muss	VB, JJ, RB	6	muß
vierzig	CD	6	vierzig
niemand	DT	6	niemand
Vorsprecher	NN	6	Vorsprecher
Streich	JJ, NN	6	Streiche, Streich
best	JJ	6	beste, besten
anders	RB, RP	6	anders
Ha	NN	6	Ha
vielleicht	IN, RP, RB	6	vielleicht
zählen	VBN, VB	6	gezählt, zählen, zählt
immer	RB, IN	6	immer
beid	DT, JJ	6	beides, beide
Kerl	NN	6	Kerl
Wer	WP	6	Wer
zwanzig	CD	6	zwanzig
dabei	RB	6	dabei
erfahren	VBN, VB, RP	6	erfahren, erfuhr
richtig	JJ	6	richtig
worden	VBN	6	worden
hast	NN	6	hast
alsdann	NNP	6	alsdann
fünf	CD	6	fünf
Komm	NN	6	Komm
selb	DT	6	selber
Auch	RB, IN, WRB	6	Auch
Jungfer	NN	6	Jungfer
Talern	NN	6	Talern
bist	NN	6	bist
An	IN	6	An
Augen	NN	6	Augen
gern	RB, RP, WRB	6	gern
Gut	NN, JJ	6	Gut, Guter
Mit	IN	6	Mit
Ernst	NNP, NN	6	Ernst
etwa	RB, IN	6	etwa
setzen	VB, VBN	6	setzen, gesetzt, setzte
bald	RB, JJ	6	bald
freilich	RB, RP, JJ	6	freilich
davon	RB	6	davon
neun	CD	5	neun
Hier	RB, RP	5	Hier
drei	CD	5	drei
Person	NN	5	Person
Frage	NN	5	Frage
Herz	NN, NNS	5	Herz, Herzen
Ware	NNS	5	Waren
leihen	VB	5	leihen
Schuld	NN	5	Schuld
Zweifel	NN	5	Zweifel
bis	IN	5	bis
Art	NN	5	Art
funfzehn	NN	5	funfzehn
Arm	NNS, NN	5	Arme, Arm
Degen	NN	5	Degen
Ihren	NN	5	Ihren
Wo	WRB	5	Wo
Vorwerk	NN	5	Vorwerk
sieben	CD	5	sieben
Kaufmann	NN, JJ	5	Kaufmann
kann	VB, JJ	5	kann
leihe	NN	5	leihe
liebster	NN, JJ	5	liebster
geschwind	RP, RB, WRB	5	geschwind
einzig	JJ, VB	5	einzige, einzigen, einzig, einziger
fragen	VB, VBN	5	fragen, fragt
Menschen	NN	5	Menschen
übel	JJ	5	übel
Auf	IN	5	Auf
sondern	CC	5	sondern
damien	IN, VB	5	damit
Oder	NN	5	Oder
fallen	VB	5	fallen, fiel
endlich	RB	5	endlich
Henker	NN	5	Henker
heuen	VB, VBN	5	heute
Nur	RB, IN	5	Nur
sechstausend	JJ	5	sechstausend
lass	JJ	5	lasse, laß
Nein	NN	5	Nein
sitzen	VB	5	sitzen, sitze
betrogen	NN	5	betrogen
Himmel	NN	5	Himmel
wohnen	VB, RB	5	wohnen
zehn	CD	5	zehn
damit	RB, IN	5	damit
seinem	PRP$	5	seinem
Stadt	NN	5	Stadt
Kopf	NNP, NN	5	Kopf
Kamilla	NN	5	Kamilla
seit	IN	5	seit
vortrefflich	JJ	5	vortrefflich, vortrefflichen
allein	RB, RP	5	allein
wahrhaftig	JJ	4	wahrhaftig
Zu	IN	4	Zu
Fisch	NNS	4	Fische
Pate	NN	4	Pate
Wenig	RP, WRB, DT	4	Wenig, Wenige
Teiche	NN	4	Teiche
Rips	NN, NNP	4	Rips
solch	DT	4	solchen, solche
laufen	VB	4	läuft, lief
Jahre	NN	4	Jahre
ihren	PRP$	4	ihren
fort	RP	4	fort
Sehen	NN	4	Sehen
Soen	VBN, RB	4	So
halb	JJ, CD	4	halben, halb, halbe
Prozent	NN	4	Prozent
Lohn	NN	4	Lohn
unterdessen	NN	4	unterdessen
Name	NN	4	Name
Noch	RB	4	Noch
kurz	JJ	4	kurze, kurz, kurzem
führen	VB	4	führte, führen, führe
ansehen	VB	4	ansieht, ansehen
merken	VB, VBN	4	merken, gemerkt, merke
Hätte	NN	4	Hätte
herum	IN	4	herum
möglich	JJ	4	mögliche, möglich
Dass	IN	4	Daß
Trinkgeld	NN	4	Trinkgeld
tausendmal	RB, RP	4	tausendmal
welches	WDT	4	welches
welcher	WP	4	welcher
am	IN	4	am
Teufel	NN	4	Teufel
Gewissen	NN	4	Gewissen
mirs	NN	4	mirs
Recht	NN	4	Recht
Warum	NN	4	Warum
Rat	NN	4	Rat
lässen	VB, VBN	4	läßt
Vorwerke	NN	4	Vorwerke
Für	IN	4	Für
Tage	NN	4	Tage
bin	VB	4	bin
darauf	RB	4	darauf
könnte	VB	4	könnte
Jugend	NN	4	Jugend
Kamillen	NN	4	Kamillen
darinn	JJ	4	darinne
dochen	RB, VB	4	doch
seiner	PRP$	4	seiner
zurück	RP, RB, IN	4	zurück
jemand	DT, RB	4	jemand
neugierig	JJ	4	neugierig, neugierigen
niemanden	NN, RB	4	niemanden
Gallipoli	NNP	4	Gallipoli
Herzensfreund	NN	4	Herzensfreund
Denn	RB, WRB	4	Denn
ziehen	VB, RP	4	zog, ziehen, gezogen
wünschen	VB	4	wünschen
ha	NN	4	ha
Indemen	RB, VB	3	Indem
jemals	RB	3	jemals
Gasse	NN	3	Gasse
Zeug	NN	3	Zeug
vom	IN	3	vom
willst	WRB, RP, RB	3	willst
hundert	CD	3	hundert
Jetzt	NN	3	Jetzt
Augenblick	NN	3	Augenblick
wahrscheinlich	JJ	3	wahrscheinlich
frei	JJ	3	freiem, frei
daraufen	VB	3	darauf
weniger	RB, RP	3	weniger
gehabt	NN	3	gehabt
Strasse	NN	3	Straße
ihrem	PRP$	3	ihrem
Ganz	NN, JJ	3	Ganz
dürfen	VB	3	dürfte, darf
vieles	NN	3	vieles
Sollen	MD	3	Soll
ansehnlich	JJ	3	ansehnliche, ansehnlich
Lelane	NN	3	Lelane
Bin	NN	3	Bin
wirst	WRB	3	wirst
daher	RB	3	daher
anfangen	VB, VBN	3	anfangen, anfängt
schämen	PRP$, VB	3	schämen
rufen	VB, PRP$	3	rufen, rief
gerne	RB, RP	3	gerne
unglücklicher	NN	3	unglücklicher
Aufsicht	NN	3	Aufsicht
Erlaubnis	NN	3	Erlaubnis
wüsste	NN	3	wüßte
nie	RB	3	nie
legen	VB	3	legen
sollt	NN	3	sollt
jetzo	NN	3	jetzo
dächte	NN	3	dächte
Beweis	NN, NNS	3	Beweis, Beweise
Tugend	NN	3	Tugend
Spiele	NN	3	Spiele
läng	JJ	3	länger
Sagen	NN, VB	3	Sagen, Sagt
mitgegeben	NN	3	mitgegeben
lieben	JJ, VB	3	lieben, liebe
Asinus	NN	3	Asinus
Von	IN	3	Von
ihnen	PRP	3	ihnen
Dies	DT	3	Dieses, Diese
Dieb	NNS, NN	3	Diebe, Dieb
ihre	PRP$	3	ihre
umarmen	VB	3	umarmen
Wirtschaft	NN	3	Wirtschaft
fasen	VB	3	fast
zeigen	VB, RB	3	zeigen, zeigte
Stiletti	NN	3	Stiletti
schuldig	JJ	3	schuldig
Kurz	NN	3	Kurz
wert	IN, RP, JJ	3	wert
sau	JJ	3	sauer
gekannt	NN	3	gekannt
dazuen	VB	3	dazu
Dardanellen	NN	3	Dardanellen
Nachschuss	NN	3	Nachschuß
jemanden	NN	3	jemanden
darf	VB	3	darf
nötig	JJ	3	nötig, nötige
fein	JJ	3	fein
welchen	WP	3	welchen
lang	JJ	3	langen
Sollte	NN	3	Sollte
Meine	PRP$	3	Meine
Nichts	NN	3	Nichts
tu	JJ, NN	3	tu
dreissig	CD	3	dreißig
Habe	NN	3	Habe
Kommen	NN, NNP	3	Kommen
Gesichte	NN	3	Gesichte
bloss	RB	3	bloß
Leandern	NN, RB	3	Leandern
närrisch	JJ	3	närrisch, närrische
nimmermehr	NN	3	nimmermehr
Schatz	NN	3	Schatz
Haar	NN, NNS	3	Haar, Haare
Füssen	NNP	3	Füßen
vollkommen	JJ	3	vollkommenen, vollkommene
Seine	PRP$	3	Seine
versuchen	VB	3	versuchen
hin	IN	3	hin
seh	PRP$	3	seh
klug	JJ	3	klug
dein	PRP$	3	dein
Dank	RP, IN, TO	3	Dank
freudig	JJ	3	freudig
scheinen	VB	3	scheinen, scheint
fällen	VB, RP	3	fällt, gefällt
Bissch	VB, JJ	3	Bißchen
danke	RP, IN	3	danke
schaffen	VB	3	schaffen
meinetwegen	RP, RB, IN	3	meinetwegen
stossen	VB	3	stoßen
leicht	JJ	3	leicht
Hände	NN	3	Hände
Zum	IN	3	Zum
reich	JJ	3	reich
grossmütig	RB, JJ	3	großmütig
Indem	RB	3	Indem
Bruder	NN	3	Bruder
Hat	NN, JJ	3	Hat
lee	JJ	3	leer
Hut	NN	3	Hut
schön	JJ	3	schön, schöne
Machen	VB	3	Machen
wiedern	VB	3	wieder
eher	RB, RP	3	eher
Teil	JJ, NN	3	Teile, Teil
kaum	RB	3	kaum
heraus	IN, RP	3	heraus
heisst	JJ, RB	3	heißt
Ewigkeit	NN	3	Ewigkeit
seines	PRP$	3	seines
Doch	RB, WRB	3	Doch
ists	NN	3	ists
Vielleicht	RB	3	Vielleicht
begehen	VBN, VB	3	begangen, begehen
vier	CD	3	vier
fremd	JJ	3	fremde, fremd
suchen	VBN, VB	3	suchen
Liebe	NN	3	Liebe
mitkriegen	VB, NN, VBN	3	mitkriegt, mitkriegen
gleichwohl	NNP, RP, RB	3	gleichwohl
wen	WP	3	wen
Gelegenheit	NN	3	Gelegenheit
Kamille	NN	3	Kamille
wider	IN	3	wider
Willen	NN	3	Willen
daran	RB	3	daran
Bald	NN	3	Bald
Freundschaft	NN	3	Freundschaft
schöne	NN	2	schöne
vergessen	VBN, RP	2	vergessen
ausserordentlich	RB	2	außerordentlich
träumen	VBN, VB	2	geträumt
pflegen	VB	2	pflegen
Handelsmann	NN	2	Handelsmann
brauchte	NN	2	brauchte
toll	RB, JJ	2	toll
annehmen	VB	2	annehmen
dort	RB	2	dort
überzeugen	VB	2	überzeugt
vorher	RP, RB	2	vorher
freundschaftlich	JJ	2	freundschaftlich
Mangel	NN	2	Mangel
reichen	PRP$, VB	2	reichen, reicht
schiehen	VB	2	geschieht
sicher	RB	2	sicher
spät	JJ	2	spät
springen	VB	2	sprang
vielleichen	RP, RB	2	vielleicht
Neun	CD	2	Neun
eng	NN	2	enge
wegkommen	VB	2	wegkommen
antreffen	NN	2	antreffen
Als	IN	2	Als
Antwort	NN	2	Antwort
klingen	VB, RP	2	klingt
Geschwind	NN	2	Geschwind
brauchen	VB	2	brauchen
sahe	NN	2	sahe
Seinen	PRP$	2	Seinen
Ernste	NN	2	Ernste
Gedanke	NNS	2	Gedanken
175	CD	2	175
Rohr	NN	2	Rohr
Bedienter	NN	2	Bedienter
verraten	VB	2	verraten
Geschlechte	NN	2	Geschlechte
Sei	NN	2	Sei
kaltsinnig	RB	2	kaltsinnig
entschuldigen	VB	2	entschuldigen
Gewalt	NN	2	Gewalt
ihrer	PRP$	2	ihrer
Dienste	NN	2	Dienste
singen	VB	2	singt, singen
Neubegierde	NN	2	Neubegierde
Freilich	JJ	2	Freilich
Ausstattung	NN	2	Ausstattung
saur	JJ	2	saure
rund	RB	2	rund
Sohne	PRP$	2	Sohne
fangen	VB	2	fangen
sachter	NN	2	sachter
mehren	VBN	2	mehr
Hälfte	NN	2	Hälfte
hat	RB	2	hat
Willkommen	NN	2	Willkommen
fände	NN	2	fände
Zehne	NN	2	Zehne
weisen	VB	2	weisen
Gesundheit	NN	2	Gesundheit
unglücklich	JJ	2	unglücklich
frage	NN	2	frage
weiss	VB	2	weiß
dankbar	JJ	2	dankbar
jaten	RB, VB	2	ja
schwarz	JJ	2	schwarzen, schwarze
Dochen	RB	2	Doch
sonderbar	JJ	2	sonderbar, sonderbarer
Wechsel	NN	2	Wechsel
Punkt	NN	2	Punkt
o	DT	2	o
stecken	VB	2	stecken, steckt
Arnolph	NN	2	Arnolph
woran	WDT	2	woran
Herde	NN	2	Herde
Ende	NN	2	Ende
Wunder	NN	2	Wunder
war	VB	2	war
Schulden	NN	2	Schulden
Tone	NN	2	Tone
Willst	WRB	2	Willst
Ausschweifungen	NN	2	Ausschweifungen
nu	UH	2	nu
verstehen	VB	2	versteht
Partie	NN	2	Partie
Verschlossen	NN	2	Verschlossen
zurechte	NN	2	zurechte
ergehen	VB	2	ergehen
gröss	JJ	2	größer
grauen	VB	2	grauen
Grossmut	NN	2	Großmut
Tat	NN	2	Tat
Dingen	NN	2	Dingen
Pandolfo	NN	2	Pandolfo
fehlen	VB	2	fehlt, gefehlt
übrige	NN	2	übrige
Vermögen	NN	2	Vermögen
Summe	NN	2	Summe
Absicht	NN	2	Absicht
Pest	NN	2	Pest
Wahrhaftig	JJ, RB	2	Wahrhaftig
hoffen	VB	2	hoffe
Bouteille	NN	2	Bouteille
genugen	VBN	2	genug
verborgen	VBN	2	verborgen
beim	IN	2	beim
Torheit	NN	2	Torheit
Beutel	NN	2	Beutel
spielen	VBN, VB	2	spielen
ei	NN, RP	2	Ei, ei
bekömmt	NN	2	bekömmt
Verräter	NN	2	Verräter
List	NN	2	List
völlig	JJ	2	völliger
behalten	VBN, VB	2	behalten
Münze	NN	2	Münze
Prophezeiung	NN	2	Prophezeiung
gehe	NN	2	gehe
Schrecken	NN	2	Schrecken
and	JJ	2	ander
ohnfehlbar	JJ	2	ohnfehlbar
Geduld	NN	2	Geduld
stössen	VB	2	stößt
Lande	NN	2	Lande
lernen	VBN, VB	2	gelernt, lernen
wunderbar	JJ	2	wunderbar, wunderbarer
fassen	VBN, VB	2	gefaßt, fassen
bereits	RB	2	bereits
schassen	VB	2	schießen
bekümmert	NN	2	bekümmert
Diensten	NN	2	Diensten
beschwöre	NN	2	beschwöre
sollten	NN	2	sollten
gleichsam	RB, IN	2	gleichsam
väterlich	JJ	2	väterlichen, väterliches
Boden	NN	2	Boden
entweder	CC, RB	2	entweder
Ihm	PRP	2	Ihm
Königen	NN	2	Königen
Güte	NN	2	Güte
tragen	VB	2	tragen
anvertraute	NN	2	anvertraute
andrer	NN	2	andrer
Paphlagonien	NN	2	Paphlagonien
hernach	NN	2	hernach
zugleich	RB	2	zugleich
gleichen	VBN	2	gleich
Spitzbube	NN	2	Spitzbube
Können	NN	2	Können
vortrefflicher	NN	2	vortrefflicher
Unrechtes	NN	2	Unrechtes
Fremde	NN	2	Fremde
vergeben	RP, VBN	2	vergeben
Rap	NN	2	Rap
Eben	NN	2	Eben
Neigung	NN	2	Neigung
Nu	NN	2	Nu
welchem	WP	2	welchem
rechnen	VB	2	rechnen
sagst	NN	2	sagst
Ehre	NN	2	Ehre
Darf	NN	2	Darf
Lebens	NN	2	Lebens
Kürzesten	NN	2	Kürzesten
Exempel	NN	2	Exempel
gibts	NN	2	gibts
Gelde	NN	2	Gelde
Stille	NN	2	Stille
wohin	RB	2	wohin
hinein	RB	2	hinein
laut	JJ	2	lauter
ersparen	VB	2	ersparen
immerhin	NN	2	immerhin
leichtsinnig	JJ	2	leichtsinnige, leichtsinnig
sogleich	RB	2	sogleich
hervor	IN	2	hervor
Freundes	NN	2	Freundes
wiederkommen	NN	2	wiederkommen
zweimal	RB	2	zweimal
verleumden	VB	2	verleumden
hinaus	IN	2	hinaus
leid	JJ	2	leid
fragte	NN	2	fragte
verzweifelt	JJ, NN	2	verzweifelt, verzweifelter
Mühe	NN	2	Mühe
darum	RB	2	darum
Viehsterben	NN	2	Viehsterben
grösst	JJ	2	größte, größten
Verziehen	NN	2	Verziehen
halte	NN	2	halte
herab	NN	2	herab
Küste	NN	2	Küste
vorbei	IN	2	vorbei
Schlingel	NN	2	Schlingel
Erde	NN	2	Erde
Vorschlag	NN	2	Vorschlag
hastig	JJ, RB	2	hastig
vollends	NN	2	vollends
Alten	VB, NN	2	Alte, Alten
allerliebster	NN	2	allerliebster
heiraten	PRP$, VB	2	heiraten
Ers	NN	2	Ers
Verleumdung	NNS	2	Verleumdungen
Busch	NNP	2	Busch
Tag	NN	2	Tag
Verkaufen	NN	2	Verkaufen
Mannes	NN	2	Mannes
Mündels	NN	2	Mündels
Vaters	NN	2	Vaters
Zügen	NN	2	Zügen
Welche	WP	2	Welche
Umstand	NNS	2	Umstände
Vergebung	NN	2	Vergebung
Meinigen	NN	2	Meinigen
kostbar	JJ	2	kostbare
Anstecken	NN	2	Anstecken
Hören	NN	2	Hören
willkomm	JJ	2	willkommen
Freude	NN	2	Freude
ersen	VB	2	ersten
auchen	VB	2	auch
fähig	JJ	2	fähig
Kind	NN	2	Kind
Katze	NN	2	Katze
Bettlerin	NNP, NN	2	Bettlerin
zusammen	RB	2	zusammen
unschuldig	JJ	2	unschuldig
Busche	NNP, NN	2	Busche
Fingern	NN	2	Fingern
melden	VB	2	melden
geschwinden	NN, VBN	2	geschwinden, geschwind
Manne	NN	2	Manne
Nenne	NN	2	Nenne
Blutigel	NN	2	Blutigel
Lass	NN	2	Laß
Zufall	NN	2	Zufall
bös	JJ	2	böse
Ohren	NN	2	Ohren
Nehmen	VB	2	Nehmen
weis	JJ	2	weise, weiser
Gesicht	NNP, NN	2	Gesicht
daraus	RB	2	daraus
Geheimnis	NN	2	Geheimnis
Häuschen	NN	2	Häuschen
helfen	VB	2	helfen
Ansehung	NN	2	Ansehung
Namens	NN, JJ	2	Namens
Ansel	NN	2	Ansel
hör	NN, VB	2	hör, höre
Schurke	NN	2	Schurke
Abwesenheit	NN	2	Abwesenheit
holen	VB	2	holen, holte
taugen	VB	2	taugt
vollwichtigen	JJ, NN	2	vollwichtigen
lügen	VB, RP	2	lügen, gelogen
Leben	NN	2	Leben
Bist	NN	2	Bist
früh	JJ	2	früh
Blitz	NN	2	Blitz
gesprächig	JJ	2	gesprächig
Ort	NN	2	Ort
verdammter	NN	2	verdammter
Korn	NNS	2	Korne
Sonst	NN	2	Sonst
zwischen	IN	2	zwischen
dafüren	VB	2	dafür
ziemlich	JJ	2	ziemlich
rechtschaffnen	NN	2	rechtschaffnen
nochen	VBN, RB	2	noch
worin	RB	2	worin
Sobald	NN	2	Sobald
sprichst	NN	2	sprichst
morgen	RB, IN	2	morgen
seltsam	JJ	2	seltsame, seltsam
Allein	NN	2	Allein
besinne	NN	2	besinne
warten	VB	2	warten
liegen	VB	2	liegen, liegt
gutes	NN	2	gutes
Würde	NN	2	Würde
wovon	WRB	2	wovon
gedenken	VBN	2	gedacht
Warnung	NN, NNS	2	Warnung, Warnungen
dahin	RP	2	dahin
Paar	NN	2	Paar
Dukaten	NN	2	Dukaten
hiess	VB	2	hieß
einbilden	NN	2	einbilden
Anton	NNP	2	Anton
ichs	NN	2	ichs
übriges	JJ, NN	2	übriges
zärtlich	JJ	2	zärtliches, zärtlich
Dem	DT	2	Dem
Glück	NN	2	Glück
Sonne	NN	2	Sonne
Sinnen	PRP$	2	Sinnen
Haben	NN	2	Haben
Kränzchen	VB, JJ	2	Kränzchen
reif	JJ	2	reif
gram	JJ	2	gram
gefallen	RP, VBN	2	gefallen
bezaubert	NN	2	bezaubert
verhindern	VB	2	verhindern, verhindert
Rolle	NN	2	Rolle
Wahrheit	NN	2	Wahrheit
gebe	NN	2	gebe
aussieht	VB, JJ	2	aussieht
ändern	VB	2	ändern
Eckhause	NN	2	Eckhause
welche	WDT	2	welche
oft	RB, IN	2	oft
Einem	NN	2	Einem
Euch	NN	2	Euch
Personen	NN	2	Personen
leihest	NN	2	leihest
Rabe	NN	2	Rabe
Um	IN	2	Um
eins	CD	2	eins
erkennen	VB	2	erkennen
Todes	NN	2	Todes
hassen	VB	2	hieße, hieß
fürs	NN, JJ	2	fürs
übrig	RB, JJ	2	übrig
Des	JJ	2	Des
Ehrenschulden	NN	2	Ehrenschulden
verschloss	JJ	2	verschlossen
seid	NN	2	seid
Gewiss	UH	2	Gewiß
wegreisete	NN	2	wegreisete
Alsdann	NNP	2	Alsdann
Fusse	NN	2	Fuße
Respekt	NN	1	Respekt
würde	RB	1	würde
betteln	VB	1	betteln
Ehe	JJ	1	Eher
gesteh	NN	1	gesteh
Zwar	RB	1	Zwar
Sprache	NN	1	Sprache
gänzlich	JJ	1	gänzlichen
hinterbracht	NN	1	hinterbracht
voraus	RP	1	voraus
rücklings	NN	1	rücklings
Schönheit	NN	1	Schönheit
vertraue	NN	1	vertraue
ohngeachtet	NN	1	ohngeachtet
gerade	RP	1	gerade
staubigten	JJ	1	staubigten
ausgesehen	NN	1	ausgesehen
fürchterlich	JJ	1	fürchterlichen
Mörd	JJ	1	Mörder
andre	NN	1	andre
Menschenverstand	NN	1	Menschenverstand
versprach	NN	1	versprach
fällt	VB	1	fällt
zuletzt	RB	1	zuletzt
Rast	TRUNC	1	Rast-
Messer	NN	1	Messer
verrate	NN	1	verrate
Tragisch	JJ	1	Tragisch
Miene	NN	1	Miene
klügrer	NN	1	klügrer
eigennützigen	NN	1	eigennützigen
Wasser	NN	1	Wasser
blossen	NN	1	bloßen
Unglücke	NN	1	Unglücke
ungefähr	RB	1	ungefähr
steckt	VB	1	steckt
liebenswürdige	NN	1	liebenswürdige
Andre	NNP	1	Andre
allzeit	NN	1	allzeit
sprächen	VB	1	sprächen
Taschenspieler	NN	1	Taschenspieler
erfreuen	VB	1	erfreut
desselben	NN	1	desselben
Gefälligkeit	NN	1	Gefälligkeit
Sich	PRP$	1	Sich
drauf	RP	1	drauf
anzusehen	VB	1	anzusehen
Acht	NN	1	Acht
obenhin	NN	1	obenhin
Gemeinschaft	NN	1	Gemeinschaft
Aufopferung	NN	1	Aufopferung
einigen	VB	1	einigen
arme	NN	1	arme
Zwaren	RB	1	Zwar
nichtswürdig	JJ	1	nichtswürdigen
Dinge	NN	1	Dinge
Schwierigkeit	NN	1	Schwierigkeit
zuwider	NN	1	zuwider
zuvorgekommen	NN	1	zuvorgekommen
Text	NN	1	Text
Trommelschläger	NN	1	Trommelschläger
Reisendern	NN	1	Reisender
versorgen	VB	1	versorgen
Sieh	NN	1	Sieh
wann	WRB	1	wann
Uneigennützigkeit	NN	1	Uneigennützigkeit
anstehen	NN	1	anstehen
Grossvat	NN	1	Großvater
Närrisch	JJ	1	Närrisch
sterben	VBN	1	gestorben
Termin	NN	1	Termin
versprechen	VBN	1	versprochen
satt	JJ	1	satt
voriges	JJ	1	voriges
gelass	JJ	1	gelassen
Schwerlich	JJ	1	Schwerlich
kehren	VB	1	gekehrt
vorigen	NN	1	vorigen
hört	JJ	1	hörte
verschwiegen	NN	1	verschwiegen
A	NN	1	A
mieten	VB	1	mieten
Kindischesen	VB	1	Kindisches
Feinden	NN	1	Feinden
kriege	NN	1	kriege
Bösen	NN	1	Bösen
mitbrächte	NN	1	mitbrächte
Schaf	NNS	1	Schafe
All	JJ	1	Alle
Winkel	NN	1	Winkel
Stunde	NN	1	Stunde
Tälerchen	VB	1	Tälerchen
husch	NN	1	husch
letzthin	JJ	1	letzthin
Enden	NN	1	Enden
herausziehen	NN	1	herausziehen
Vorwissen	NN	1	Vorwissen
stinkend	JJ	1	stinkenden
Nachreden	NN	1	Nachreden
bisher	RB	1	bisher
ablässt	NN	1	abläßt
Hie	RB	1	Hier
deinem	NN	1	deinem
deiner	PRP$	1	deiner
geweissen	VB	1	gewiß
Klotz	NN	1	Klotz
Lunte	NN	1	Lunte
Stirne	NN	1	Stirne
Holz	NN	1	Holz
Fenstern	NN	1	Fenstern
Muss	NN	1	Muß
geliebt	NN	1	geliebt
Beschwörer	NN	1	Beschwörer
Anstössiges	NN	1	Anstößiges
durchgebracht	NN	1	durchgebracht
anrichten	VBN	1	angerichtet
anzeigen	VB	1	anzeigen
versöhnen	VB	1	versöhnen
gehörigen	NN	1	gehörigen
nichtswürdiger	NNP	1	nichtswürdiger
darnach	RB	1	darnach
nichtswürdigen	NN	1	nichtswürdigen
gefährlich	JJ	1	gefährlich
abhauen	VB	1	abhauen
allenfalls	IN	1	allenfalls
tot	JJ	1	tot
verbannen	NN	1	verbannen
Herzens	NN	1	Herzens
Schlüssel	NN	1	Schlüssel
Lelios	NN	1	Lelios
Gesinnung	NNS	1	Gesinnungen
Dampf	NN	1	Dampf
beides	RB	1	beides
wiedergekommen	NN	1	wiedergekommen
Bedienten	NN	1	Bedienten
nahm	VB	1	nahm
albern	JJ	1	albern
versage	NN	1	versage
nahe	RP	1	nahe
Post	NN	1	Post
Gefängnisse	NN	1	Gefängnisse
Nichtswürdiger	NN	1	Nichtswürdiger
Geschlechts	NN	1	Geschlechts
ähnlich	JJ	1	ähnlich
Gang	NN	1	Gang
Vergnügen	JJ	1	Vergnügen
durchaus	RB	1	durchaus
modert	NN	1	modert
rar	JJ	1	rar
herrschen	VB	1	herrschen
leugnen	VB	1	leugnen
Anschlag	NN	1	Anschlag
Gegend	NN	1	Gegend
angenehm	JJ	1	angenehm
balden	VBN	1	bald
Historie	NN	1	Historie
gestehe	NN	1	gestehe
Ungelegenheit	NN	1	Ungelegenheit
Asi	JJ	1	Asi
empfangen	VBN	1	empfangen
Zähnen	NN	1	Zähnen
geschlagen	NN	1	geschlagen
Wann	NNP	1	Wann
herauskommen	VB	1	herauskommen
Sinne	NN	1	Sinne
gesund	JJ	1	gesund
edelmütiger	NNP	1	edelmütiger
sage	VB	1	sage
Mache	NN	1	Mache
prächtigsten	NN	1	prächtigsten
nachzählen	NN	1	nachzählen
sieh	NN	1	sieh
weswegen	RB	1	weswegen
Allenfalls	RB	1	Allenfalls
Bis	IN	1	Bis
Possen	NN	1	Possen
Todbette	NN	1	Todbette
gehn	NN	1	gehn
ermorden	VB	1	ermorden
unzeitige	NN	1	unzeitige
schimpflich	JJ	1	schimpflichen
Schmähungen	NN	1	Schmähungen
stärksten	NN	1	stärksten
machst	RP	1	machst
schreiben	VBN	1	geschrieben
irr	JJ	1	irre
weiter	RB	1	weiter
erhalten	VB	1	erhalten
spendabeln	JJ	1	spendabeln
Lassen	MD	1	Lassen
vermuten	VB	1	vermuten
Nichtswürdigkeit	NN	1	Nichtswürdigkeit
fette	NN	1	fette
Treu	NN	1	Treu
elenden	JJ	1	elenden
Wollen	MD	1	Will
Wenigstens	NN	1	Wenigstens
Anfangs	NN	1	Anfangs
Behüte	NN	1	Behüte
Avisobriefe	NN	1	Avisobriefe
auszusehen	NN	1	auszusehen
abschläglich	JJ	1	abschlägliche
hag	JJ	1	hager
behorcht	NN	1	behorcht
gekaufte	NN	1	gekaufte
Schweig	JJ	1	Schweig
Unter	IN	1	Unter
Grund	NN	1	Grund
Schwein	NN	1	Schwein
valten	VBN	1	viel
Halten	NN	1	Halten
bekräftige	NN	1	bekräftige
Rechenschaft	NN	1	Rechenschaft
Goldstücke	NN	1	Goldstücke
stehlen	VB	1	gestohlen
Aufmerksamkeit	NN	1	Aufmerksamkeit
fest	RP	1	fest
Guckt	NN	1	Guckt
begehst	NN	1	begehst
Kerls	NN	1	Kerls
Quintessenz	NN	1	Quintessenz
Anerbietens	NN	1	Anerbietens
Gross	JJ	1	Große
Handlung	NNS	1	Handlungen
desto	CC	1	desto
erzählen	VB	1	erzählt
Euchs	NN	1	Euchs
wenden	VB	1	wenden
Schande	NNS	1	Schanden
Schmeicheleien	NN	1	Schmeicheleien
ersäuft	NN	1	ersäuft
Narren	NN	1	Narren
Danksagung	NN	1	Danksagung
Unwillen	NN	1	Unwillen
ihres	PRP$	1	ihres
gesinnt	NN	1	gesinnt
lasst	WRB	1	laßt
ohngefähr	NN	1	ohngefähr
besen	VB	1	besten
brennen	VB	1	brennen
schämt	NN	1	schämt
wüsst	NN	1	wüßte
gewinnen	PRP$	1	gewinnen
solle	NN	1	solle
vornehmen	VB	1	vornehmen
Geschlecht	NN	1	Geschlecht
indisch	JJ	1	indische
Anfange	NN	1	Anfange
Anerbieten	NN	1	Anerbieten
gewollt	NN	1	gewollt
Orte	NN	1	Orte
unten	RP	1	unten
Geier	NN	1	Geier
wobei	WRB	1	wobei
Vormunds	NN	1	Vormunds
Traurigste	NN	1	Traurigste
verborgenen	NN	1	verborgenen
widerfahren	NN	1	widerfahren
verdenken	NN	1	verdenken
Verschwender	NN	1	Verschwender
Heisst	NN	1	Heißt
Gläubiger	NN	1	Gläubiger
hundertmal	JJ	1	hundertmal
He	NN	1	He
hüte	NN	1	hüte
Gras	NN	1	Gras
berühmten	NN	1	berühmten
vertan	NN	1	vertan
Sechstausend	JJ	1	Sechstausend
auszumachen	VB	1	auszumachen
geringst	JJ	1	geringste
missbrauchen	VB	1	mißbrauchen
nochmals	RP	1	nochmals
Komödie	NN	1	Komödie
vergafft	NN	1	vergafft
Geschichte	NN	1	Geschichte
unbillig	JJ	1	unbillig
Fasse	NNP	1	Fasse
Hang	NN	1	Hang
sporenstreichs	NN	1	sporenstreichs
ohnedem	RB	1	ohnedem
sechse	NN	1	sechse
nähme	NN	1	nähme
Besitzer	NN	1	Besitzer
Ängstige	NN	1	Ängstige
dieselbe	NN	1	dieselbe
nunmehr	RB	1	nunmehr
geschähe	NN	1	geschähe
Weges	NN	1	Weges
Liverei	NN	1	Liverei
Vor	IN	1	Vor
vergolten	NN	1	vergolten
bedienen	PRP$	1	bedienen
geliebten	NN	1	geliebten
Tränen	NN	1	Tränen
Leihe	NN	1	Leihe
Gurgel	NN	1	Gurgel
rätselhaft	JJ	1	rätselhaft
schönste	NN	1	schönste
Falls	IN	1	Falls
jährlich	RB	1	jährlich
zwanzigen	NN	1	zwanzigen
Amerika	NNP	1	Amerika
Hund	NN	1	Hund
waschen	RP	1	gewaschen
Baum	NN	1	Baum
Wollt	NN	1	Wollt
grossmütige	NN	1	großmütige
ausgestorb	JJ	1	ausgestorben
ausgraben	VB	1	ausgraben
erregen	VB	1	erregen
sieht	VB	1	sieht
alleweile	NN	1	alleweile
herzlich	JJ	1	herzlich
ward	NNP	1	ward
macht	VB	1	macht
Dahintern	RB	1	Dahinter
Verdiensten	NN	1	Verdiensten
deswegen	RP	1	deswegen
Ansatz	NN	1	Ansatz
Spricht	NN	1	Spricht
Schade	NN	1	Schade
verliebt	JJ	1	verliebt
vorkäme	NN	1	vorkäme
schwerlich	JJ	1	schwerlich
setze	NN	1	setze
erkundige	NN	1	erkundige
Hannibal	NN	1	Hannibal
reichste	NN	1	reichste
aufsetzen	NN	1	aufsetzen
selben	NN	1	selben
Narrenspossen	NN	1	Narrenspossen
galante	NN	1	galante
anklopfen	NN	1	anklopfen
zahlen	VB	1	zahlen
Teilen	NN	1	Teilen
verhalten	VB	1	verhalten
Bedenke	NN	1	Bedenke
wohlfeilen	JJ	1	wohlfeilen
Unrecht	NN	1	Unrecht
Hefen	NN	1	Hefen
einzigen	NN	1	einzige
Verschwendungen	NN	1	Verschwendungen
zurückkommen	VB	1	zurückkommen
Fort	NN	1	Fort
bange	NN	1	bange
Verlangen	NN	1	Verlangen
steckte	NN	1	steckte
Herrchen	VB	1	Herrchen
stören	VB	1	stören
vorstellen	VBN	1	vorgestellt
Wirst	WRB	1	Wirst
verlieben	VB	1	verlieben
bleibt	VB	1	bleibt
lesen	VB	1	lesen
glücklich	JJ	1	glückliche
schleppen	VB	1	schleppen
garstigen	NN	1	garstigen
Glossen	NN	1	Glossen
Tausenden	NN	1	Tausenden
zweifle	NN	1	zweifle
gestern	IN	1	gestern
unbekannen	VBN	1	unbekannt
Sage	NN	1	Sage
würdig	JJ	1	würdig
beifällt	DT	1	beifällt
beantworten	VB	1	beantworten
Ausflüchte	NN	1	Ausflüchte
gewohnt	JJ	1	gewohnt
ausgefallen	NN	1	ausgefallen
Mir	NN	1	Mir
Leuten	NN	1	Leuten
Niederträchtigkeit	NN	1	Niederträchtigkeit
Vieh	NN	1	Vieh
angehangen	NN	1	angehangen
dumm	JJ	1	dumm
schlimm	JJ	1	schlimm
unaussprechlich	JJ	1	unaussprechliches
Verderben	NN	1	Verderben
mitkriegt	VB	1	mitkriegt
nähren	VB	1	nähren
Warten	NN	1	Warten
Empfang	NN	1	Empfang
Stelle	NN	1	Stelle
davonen	VB	1	davon
richtiger	NNP	1	richtiger
Verleumder	NN	1	Verleumder
verlorne	NN	1	verlorne
nimm	NN	1	nimm
entbehren	VB	1	entbehren
Schelmstücken	NN	1	Schelmstücken
Galgen	NN	1	Galgen
Häuser	NN	1	Häuser
gebracht	VBN	1	gebracht
ausgestoch	JJ	1	ausgestochen
grämen	VB	1	grämen
nichtswürdige	NN	1	nichtswürdige
Rechnungen	NN	1	Rechnungen
Äusserste	NN	1	Äußerste
versichre	NN	1	versichre
verliess	NN	1	verließ
Anführer	NN	1	Anführer
lügst	NN	1	lügst
Gelassenheit	NN	1	Gelassenheit
Müsste	NN	1	Müßte
aufhalten	VB	1	aufhalten
Lud	JJ	1	Luder
Letzte	NN	1	Letzte
offenbar	JJ	1	offenbar
ernstlich	JJ	1	ernstlich
Sammler	NN	1	Sammler
kenn	NN	1	kenn
betriegen	NN	1	betriegen
fragten	NN	1	fragten
blasen	VB	1	blasen
Jude	NN	1	Jude
beneidenswürdiger	NN	1	beneidenswürdiger
unvergleichlichen	JJ	1	unvergleichliche
quitt	JJ	1	quitt
gilts	NN	1	gilts
abzuwehren	VB	1	abzuwehren
Bock	NN	1	Bock
Wen	NN	1	Wen
Ansehen	NN	1	Ansehen
Begriff	NN	1	Begriff
siehst	NN	1	siehst
Vorwürfe	NN	1	Vorwürfe
umsehen	VB	1	umsieht
auszugeben	NN	1	auszugeben
geiziger	NNP	1	geiziger
Topp	NN	1	Topp
geizigen	NN	1	geizigen
Ernte	NN	1	Ernte
Pommern	NNP	1	Pommern
Atem	NN	1	Atem
aufheben	VB	1	aufgehoben
dachten	RB	1	dachten
reifen	VB	1	reifen
verheiratet	JJ	1	verheiratet
anvertrauet	NN	1	anvertrauet
schlecht	JJ	1	schlecht
ehrvergessener	NNP	1	ehrvergessener
Anwerbung	NN	1	Anwerbung
freiem	NN	1	freiem
bemerken	VB	1	bemerkt
anvertrauen	VB	1	anvertrauen
bauen	VB	1	gebaut
nachdächte	FW	1	nachdächte
Am	IN	1	Am
geht	VB	1	geht
nunen	RB	1	nun
bestehen	VB	1	besteht
vertrauen	VB	1	vertrauen
sag	NN	1	sag
Hals	NN	1	Hals
Halt	NNS	1	Halte
hats	NN	1	hats
Bescheidenheit	NN	1	Bescheidenheit
abzulegen	VB	1	abzulegen
gefälligen	JJ	1	gefälligen
Einfall	NN	1	Einfall
abstatten	NN	1	abstatten
allzubald	NN	1	allzubald
Kapwein	NN	1	Kapwein
beizukomm	DT	1	beizukommen
Trümpfe	JJ	1	Trümpfe
betauernswürdige	NN	1	betauernswürdige
Mitleiden	NN	1	Mitleiden
abgeleg	JJ	1	abgelegen
nachsehen	VB	1	nachsehen
wegzunehmen	NN	1	wegzunehmen
jedermann	NNP	1	jedermann
einsehen	VB	1	einsehen
zusammenhalten	NN	1	zusammenhalten
Weg	NN	1	Weg
auszuposaunen	NN	1	auszuposaunen
König	DT	1	Könige
Tadel	NN	1	Tadel
daselbst	RB	1	daselbst
erstlich	JJ	1	erstlich
Fenster	NN	1	Fenster
Wohin	NN	1	Wohin
dienstfertiger	NN	1	dienstfertiger
schmerzen	VB	1	schmerzen
bekümmern	NN	1	bekümmern
aufhören	VB	1	aufhören
Aufzuge	NN	1	Aufzuge
unverschämten	NN	1	unverschämten
verachten	VB	1	verachten
verachtet	NN	1	verachtet
geh	NN	1	geh
Alles	NN	1	Alles
Wahnwitzigen	NN	1	Wahnwitzigen
entlaufen	NN	1	entlaufen
Begebenheit	NN	1	Begebenheit
verdrüsslich	JJ	1	verdrüßlich
erkundiget	NN	1	erkundiget
Schwanz	NN	1	Schwanz
verwildert	NN	1	verwildert
Anfangsbuchstaben	NN	1	Anfangsbuchstaben
Sonderbar	JJ	1	Sonderbar
Gefehlt	NN	1	Gefehlt
schreien	VB	1	schrie
Viertel	NN	1	Viertel
vorgeben	VB	1	vorgeben
eingeschmissen	NN	1	eingeschmissen
altem	NN	1	altem
aufsuchen	VB	1	aufsuchen
erstaunend	JJ	1	erstaunend
Anspruch	NN	1	Anspruch
fängt	VB	1	fängt
je	RB	1	je
verzeihen	VB	1	verzeihen
vorgebt	NN	1	vorgebt
Kann	NN	1	Kann
mans	NN	1	mans
Vorsprecherin	NN	1	Vorsprecherin
zugegen	NN	1	zugegen
Ihn	JJ	1	Ihn
Kanal	NN	1	Kanal
rundes	NN	1	rundes
Armut	NN	1	Armut
wied	JJ	1	wieder
offenherzig	JJ	1	offenherzig
sichs	NN	1	sichs
gleichviel	NN	1	gleichviel
Stich	NNS	1	Stiche
Hunde	NN	1	Hunde
gewünscht	JJ	1	gewünschter
verhelfen	VB	1	verhelfen
dergleichen	PRP	1	dergleichen
Unterdessen	NN	1	Unterdessen
Geschlechter	NN	1	Geschlechter
hinterlassen	VB	1	hinterlassen
Glücke	NN	1	Glücke
Abreise	NN	1	Abreise
ginge	NN	1	ginge
übersehen	VBN	1	übersehen
reichsten	NN	1	reichsten
rupfen	NN	1	rupfen
besitze	NN	1	besitze
Stücken	NN	1	Stücken
Verschulden	NN	1	Verschulden
Schrot	NN	1	Schrot
schwören	VB	1	schwören
Höflichkeit	NN	1	Höflichkeit
Äcker	NN	1	Äcker
gelten	VB	1	gelten
Ankunft	NN	1	Ankunft
Schwäche	NN	1	Schwäche
reiseten	NN	1	reiseten
meinst	JJ	1	meinst
glücklicher	NN	1	glücklicher
martre	NN	1	martre
dicke	NN	1	dicke
dreissigjährigen	NN	1	dreißigjährigen
meinigen	NN	1	meinigen
Gattung	NN	1	Gattung
hinterliess	NN	1	hinterließ
Guten	NN	1	Guten
erkenntlich	JJ	1	erkenntlich
Abends	NN	1	Abends
teilhaftig	JJ	1	teilhaftig
unglaublich	RB	1	unglaublich
vergelten	VB	1	vergelten
Lehnstuhle	NN	1	Lehnstuhle
Gauner	NN	1	Gauner
höh	JJ	1	höher
aufzusuchen	VB	1	aufzusuchen
ohnmächtig	JJ	1	ohnmächtig
Achtel	NN	1	Achtel
anselmisiert	NN	1	anselmisiert
Engel	NN	1	Engel
Neu	JJ	1	Neues
wozu	WRB	1	wozu
solltest	WRB	1	solltest
meisterlichen	VBN	1	meisterlich
hieher	NN	1	hieher
kennte	NN	1	kennte
meiner	RB	1	meiner
wächst	NN	1	wächst
suche	NN	1	suche
einhändigen	NN	1	einhändigen
bedenke	NN	1	bedenke
jagen	VB	1	jagen
gebrauchen	VBN	1	gebraucht
Leutchen	VB	1	Leutchen
gerades	NN	1	gerades
ausreden	NN	1	ausreden
vermutete	NN	1	vermutete
Betrachtung	NNS	1	Betrachtungen
aufsuche	NN	1	aufsuche
Überwegen	NN	1	Überwegen
Männer	NN	1	Männer
zürnen	VB	1	zürnen
her	IN	1	her
Ansi	NN	1	Ansi
stark	JJ	1	stark
zugehört	NN	1	zugehört
los	RB	1	los
ehe	CC	1	ehe
Wurf	NN	1	Wurf
prophezeit	NN	1	prophezeit
gibt	VB	1	gibt
Stall	NNS	1	Ställe
zuerst	RB	1	zuerst
schöner	NN	1	schöner
schönes	NN	1	schönes
gütigen	NN	1	gütigen
Vormünder	NN	1	Vormünder
schicke	NN	1	schicke
rück	NN	1	rück
gütiger	NNP	1	gütiger
Nichten	NN	1	Nichten
Hof	NN	1	Hof
schimpfen	VB	1	schimpfen
ah	UH	1	ah
Schwager	NN	1	Schwager
Wissen	NN	1	Wissen
reiche	VB	1	reiche
pfui	UH	1	pfui
worauf	RB	1	worauf
Vermögens	NN	1	Vermögens
eigentlich	JJ	1	eigentlich
verrät	NN	1	verrät
verwünschter	NN	1	verwünschter
Warte	NN	1	Warte
abzugeben	VB	1	abzugeben
Hafen	NN	1	Hafen
dienen	VB	1	dienen
müsste	VB	1	müßte
waren	VB	1	waren
Schweine	NN	1	Schweine
Elle	NN	1	Elle
Nachteiligste	NN	1	Nachteiligste
italienisch	JJ	1	italienische
Superbes	NN	1	Superbes
Betragens	NN	1	Betragens
Kahlkopf	NN	1	Kahlkopf
Verzeihen	NN	1	Verzeihen
drehen	VB	1	drehte
Reise	NN	1	Reise
Rest	NN	1	Rest
begleiten	VB	1	begleiten
Kleinigkeit	NN	1	Kleinigkeit
rate	NN	1	rate
Strafe	NN	1	Strafe
abe	RB	1	aber
Plunder	NN	1	Plunder
Körper	NN	1	Körper
grausam	JJ	1	grausam
Verführer	NNP	1	Verführer
ehrvergessner	NN	1	ehrvergeßner
vertreten	VBN	1	vertreten
treffen	VB	1	treffen
Gnade	NN	1	Gnade
Barmherzigkeit	NN	1	Barmherzigkeit
meist	DT	1	meisten
besitzen	VB	1	besitzen
tust	NN	1	tust
Freudentagen	NN	1	Freudentagen
Bezahlung	NN	1	Bezahlung
Aug	NN	1	Augen
Pfui	NN	1	Pfui
nachsagen	NN	1	nachsagen
häufig	JJ	1	häufig
fernere	NN	1	fernere
Europa	NNP	1	Europa
Wein	NNS	1	Weine
verhüte	NN	1	verhüte
Seinem	PRP$	1	Seinem
schlechten	NN	1	schlechten
gegenwärtig	RP	1	gegenwärtig
St	PRP$	1	St
vermachte	NN	1	vermachte
Bettel	NN	1	Bettel
Koche	NN	1	Koche
verlieren	VB	1	verlieren
entanselmisieren	NN	1	entanselmisieren
ungeratner	NN	1	ungeratner
Ins	JJ	1	Ins
herunter	RB	1	herunter
Schmutze	NN	1	Schmutze
ungeratnen	NN	1	ungeratnen
versteh	NN	1	versteh
abgekauft	NN	1	abgekauft
prellt	NN	1	prellt
lichter	NN	1	lichter
Horn	NN	1	Horn
etlichen	RB	1	etlichen
Fall	NN	1	Fall
Haushälterin	NN	1	Haushälterin
Schneider	NNP	1	Schneider
Pauke	NN	1	Pauke
Austern	NN	1	Austern
angehen	VB	1	angehen
abscheulich	JJ	1	abscheulichen
ausgehalten	NN	1	ausgehalten
bekenne	VB	1	bekenne
Eignes	NN	1	Eignes
ferner	RB	1	ferner
Setzt	NN	1	Setzt
allerliebstes	JJ	1	allerliebstes
feste	NN	1	feste
Alter	NN	1	Alter
alle	RB	1	alle
Stein	NN	1	Stein
weltbekannten	NN	1	weltbekannten
genannt	JJ	1	genannten
bezahls	NN	1	bezahls
Fuchs	NN	1	Fuchs
Drücke	NN	1	Drücke
zufreien	NN	1	zufreien
rechtschaffner	NN	1	rechtschaffner
getreuerer	NN	1	getreuerer
erstern	NN	1	erstern
erlauben	VB	1	erlaubt
nein	RP	1	nein
freigebig	JJ	1	freigebig
Schlimmern	NN	1	Schlimmern
ernsthaft	RB	1	ernsthaft
Kopfe	JJ	1	Kopfe
zweifelst	NN	1	zweifelst
Adieu	NN	1	Adieu
sichrer	NN	1	sichrer
Verkehr	NN	1	Verkehr
Leides	NN	1	Leides
Reden	NN	1	Reden
Abgetragene	NN	1	Abgetragene
Deinig	DT	1	Deinige
besorgten	NN	1	besorgten
unerträglich	JJ	1	unerträglich
viermal	RB	1	viermal
manch	JJ	1	manche
Gebe	NN	1	Gebe
ausgehen	VB	1	ausgehen
Nachts	NN	1	Nachts
brüderlich	JJ	1	brüderliche
natürlichen	IN	1	natürlichen
probieren	VB	1	probieren
misslich	JJ	1	mißlichen
eingeschlagen	NN	1	eingeschlagen
riechen	VB	1	riechen
Pflastersteinen	NN	1	Pflastersteinen
Endlich	JJ	1	Endlich
vollkomm	JJ	1	vollkommen
allerchristlichst	JJ	1	allerchristlichste
Toppen	NN	1	Topp
wagen	VB	1	wagen
frech	JJ	1	frech
höchst	JJ	1	höchsten
Figur	NN	1	Figur
nächste	NN	1	nächste
verzweifelter	NN	1	verzweifelter
Wohlfahrt	NN	1	Wohlfahrt
weisst	NN	1	weißt
jed	DT	1	jedes
aufbringen	VBN	1	aufgebracht
vorzurücken	VB	1	vorzurücken
untergehen	VBN	1	untergegangen
gereiset	NN	1	gereiset
weitläuftiger	NNP	1	weitläuftiger
darüber	RB	1	darüber
Mittel	NN	1	Mittel
überall	RB	1	überall
Ursache	NN	1	Ursache
stehn	NN	1	stehn
reise	NN	1	reise
vertun	VB	1	vertun
schamrot	NN	1	schamrot
abzuwenden	VB	1	abzuwenden
schlafen	VB	1	schlafen
Nie	NN	1	Nie
wussen	VB	1	wußte
Im	IN	1	Im
Bringe	NN	1	Bringe
unrecht	JJ	1	unrecht
eisern	JJ	1	eiserne
spreche	NN	1	spreche
kam	VB	1	kam
Ist	VB	1	Ist
Achtung	NN	1	Achtung
stürzte	NN	1	stürzte
abtreten	NN	1	abtreten
Schubsacke	NN	1	Schubsacke
Verbrechen	NN	1	Verbrechen
beläuft	JJ	1	beläuft
Freiheit	NN	1	Freiheit
Dritt	JJ	1	Dritten
Ehrentitel	NN	1	Ehrentitel
Gewächse	NN	1	Gewächse
ruhig	JJ	1	ruhiger
nachdem	IN	1	nachdem
gewusst	NN	1	gewußt
irgend	JJ	1	irgend
nehmt	NN	1	nehmt
Händen	NN	1	Händen
hatte	RB	1	hatte
vergnügt	JJ	1	vergnügt
hie	RB	1	hier
furchtsam	JJ	1	furchtsam
gerechtfertiget	NN	1	gerechtfertiget
haften	VB	1	haften
bedanke	NN	1	bedanke
Wäsche	NN	1	Wäsche
Kennst	NN	1	Kennst
Hell	JJ	1	Heller
Darlehn	NN	1	Darlehn
treiben	VB	1	treiben
Sorge	NN	1	Sorge
Könnte	NN	1	Könnte
Nahrung	NN	1	Nahrung
Kaufe	NN	1	Kaufe
abschneiden	VB	1	abschneiden
schurkisch	JJ	1	schurkischen
eigner	NN	1	eigner
manchmal	IN	1	manchmal
Esel	NN	1	Esel
fang	JJ	1	fange
jeden	RB	1	jeden
Treugen	NN	1	Treugen
unnützen	JJ	1	unnützen
Neig	JJ	1	Neige
Tode	NN	1	Tode
Schaden	NN	1	Schaden
Schnappsack	NN	1	Schnappsack
reisete	NN	1	reisete
Gibraltar	NNP	1	Gibraltar
Bezahlt	NN	1	Bezahlt
stürzen	VB	1	stürzte
Unerfahrenheit	NN	1	Unerfahrenheit
Huhn	NNS	1	Hühner
weder	CC	1	weder
Schranke	NNS	1	Schranken
Mach	JJ	1	Machen
bliebe	NN	1	bliebe
erfährt	NN	1	erfährt
packe	NN	1	packe
heute	RB	1	heute
Gespenste	NN	1	Gespenste
verübt	NN	1	verübte
Ding	NN	1	Ding
Nach	IN	1	Nach
abern	JJ	1	aber
Heirat	NN	1	Heirat
Sagten	NN	1	Sagten
bewegen	VB	1	bewegen
herein	RB	1	herein
nützen	VB	1	nützen
Papiere	NN	1	Papiere
vorüber	NN	1	vorüber
Besuch	JJ	1	Besuch
Kniffe	NN	1	Kniffe
verlassen	VB	1	verlassen
Beistand	NN	1	Beistand
fühlen	VBN	1	fühlt
fortbringen	NN	1	fortbringen
Maska	NN	1	Maska
andermal	RP	1	andermal
Gehe	NN	1	Gehe
reisen	VB	1	reisen
Geht	RB	1	Geht
Testamente	JJ	1	Testamente
stellen	VB	1	stellen
tanzen	VB	1	tanzen
gehts	NN	1	gehts
Dienst	NN	1	Dienst
unebene	NN	1	unebene
verändern	VBN	1	verändert
wannen	NN	1	wannen
Zerstreuer	NN	1	Zerstreuer
Last	FW	1	Last
Schämen	NN	1	Schämen
schonen	VB	1	schon
erwarten	VB	1	erwarten
Gärtner	NN	1	Gärtner
Pferde	NN	1	Pferde
Niemand	NN	1	Niemand
Schiff	NNS	1	Schiffe
Fluch	NN	1	Fluch
Reinlichkeit	NN	1	Reinlichkeit
soff	NN	1	soff
allzu	RB	1	allzu
beträchtlich	JJ	1	beträchtliches
Teils	NN	1	Teils
Kommission	NN	1	Kommission
Engeland	NN	1	Engeland
Tagen	NN	1	Tagen
reissen	RB	1	riß
behielte	NN	1	behielte
Freuen	NN	1	Freuen
Edles	NN	1	Edles
dreihundert	NN	1	dreihundert
Treppe	NN	1	Treppe
erschrak	NN	1	erschrak
Rom	NNP	1	Rom
garstiger	NN	1	garstiger
allerdings	RB	1	allerdings
Wohl	RB	1	Wohl
anzutreffen	VB	1	anzutreffen
dauern	VB	1	dauern
Kapua	NN	1	Kapua
fruchtlos	JJ	1	fruchtlos
Flasch	JJ	1	Flasche
Schicksal	NN	1	Schicksal
Burschen	VB	1	Burschen
fast	RB	1	fast
gewiesen	NN	1	gewiesen
sähe	NN	1	sähe
Tritt	NN	1	Tritt
Öfe	NN	1	Öfen
jage	NN	1	jage
sowohl	CC	1	sowohl
fliessen	VBN	1	geflossen
Frauenzimmer	NN	1	Frauenzimmer
Eckhaus	NN	1	Eckhaus
murmeln	VB	1	murmeln
erstickt	NN	1	erstickt
verwenden	VB	1	verwenden
schreckt	NN	1	schreckt
Mas	JJ	1	Mas
erteilen	VB	1	erteilen
gottloser	NN	1	gottloser
auslegen	VBN	1	ausgelegt
erfahre	NN	1	erfahre
dringen	VB	1	gedrungen
Anlass	NN	1	Anlaß
einhändiget	NN	1	einhändiget
Gar	NN	1	Gar
niederträchtig	JJ	1	niederträchtig
Ah	NN	1	Ah
Profitch	VB	1	Profitchen
verschwund	RP	1	verschwunden
werfen	VB	1	warf
Siehst	NN	1	Siehst
dadurchen	VB	1	dadurch
Verbesserungen	NN	1	Verbesserungen
schicken	VB	1	schicken
Lehren	NN	1	Lehren
Steh	NN	1	Steh
geschehen	RP	1	geschehen
Familie	NN	1	Familie
Not	NN	1	Not
Schon	RB	1	Schon
Nötige	NN	1	Nötige
Mögen	NN	1	Mögen
antworen	VB	1	antworten
beliebt	JJ	1	beliebt
angenehmst	JJ	1	angenehmsten
Fälle	NN	1	Fälle
getanen	NN	1	getanen
schlassen	VB	1	schließen
Manieren	NN	1	Manieren
Rinder	NN	1	Rinder
Auflauf	NN	1	Auflauf
ermangeln	NN	1	ermangeln
stünde	NN	1	stünde
dahinter	RB	1	dahinter
möglichstes	NN	1	möglichstes
Bedenken	NN	1	Bedenken
prahlen	VB	1	prahlen
Verspare	NN	1	Verspare
abgeben	VBN	1	abgegeben
gemeinte	NN	1	gemeinte
kannst	VB	1	kannst
dürft	VB	1	dürfte
Ahnen	NN	1	Ahnen
trauriger	NN	1	trauriger
sind	VB	1	sind
sehnlich	JJ	1	sehnlich
Aussaat	NN	1	Aussaat
umsiehet	NN	1	umsiehet
anhalten	VB	1	anhalten
redt	NNP	1	redt
voll	JJ	1	voll
Pilze	NN	1	Pilze
Lügen	NN	1	Lügen
geliehen	NN	1	geliehen
übeln	NN	1	übeln
Solo	NN	1	Solo
Vorschlage	NN	1	Vorschlage
Siegel	NN	1	Siegel
Korb	NN	1	Korb
erklären	VB	1	erklären
befehlen	VB	1	befehlen
wenigst	JJ	1	wenigsten
ersonnen	NN	1	ersonnen
unverantwortlich	JJ	1	unverantwortlich
Nachdruck	NN	1	Nachdruck
Lang	NN	1	Lang
überschlage	NN	1	überschlage
alsoen	JJ	1	also
Rapsen	NN	1	Rapsen
übermässig	NN	1	übermäßige
kehre	NN	1	kehre
reifern	NN	1	reifern
grossern	JJ	1	großer
Bescheid	NN	1	Bescheid
begreifen	VB	1	begreifen
vergraben	VB	1	vergraben
voraussahe	NN	1	voraussahe
eigennützige	NN	1	eigennützige
unverhoffte	NN	1	unverhoffte
ruinieren	VB	1	ruinieren
kenne	VB	1	kenne
Schwur	NN	1	Schwur
Verzeih	NN	1	Verzeih
empfehlen	VB	1	empfehlen
danken	RP	1	gedankt
Scheltworte	NN	1	Scheltworte
Dasmal	RB	1	Dasmal
klar	JJ	1	klar
Verstand	NN	1	Verstand
halfs	NN	1	halfs
wette	NN	1	wette
pflegte	NN	1	pflegte
darumen	RB	1	darum
verlangen	VB	1	verlangt
Meinen	NN	1	Meinen
hoch	JJ	1	hoch
wirs	NN	1	wirs
Bändern	VB	1	Bänder
Taube	NNS	1	Tauben
ausgeklagten	NN	1	ausgeklagten
Mitleids	NN	1	Mitleids
Zunge	NN	1	Zunge
gleichgültig	JJ	1	gleichgültig
Schäfch	JJ	1	Schäfchen
vorgefallen	NN	1	vorgefallen
befallen	VBN	1	befallen
letztemalten	VBN	1	letztemal
lebt	VB	1	lebt
besinnt	NN	1	besinnt
vierhundert	CD	1	vierhundert
Nachbar	NNS	1	Nachbarn
Wende	NNS	1	Wenden
empfinden	VB	1	empfunden
Seinigen	PRP$	1	Seinigen
Rip	NN	1	Rip
Gefahr	NN	1	Gefahr
beruhigen	VB	1	beruhigen
Allzuviel	NN	1	Allzuviel
Tun	NN	1	Tun
lebhaft	JJ	1	lebhaft
suchte	NN	1	suchte
bestätigen	VB	1	bestätiget
Anfang	NN	1	Anfang
Reisenden	NN	1	Reisenden
Seiten	NN	1	Seiten
ungersch	JJ	1	ungerschen
Absehen	NN	1	Absehen
Propheten	NN	1	Propheten
Narr	NN	1	Narr
wunderlich	JJ	1	wunderlich
Vorwurf	NN	1	Vorwurf
dawidern	VB	1	dawider
wohlfeil	NN	1	wohlfeil
infamer	NN	1	infamer
Deutsch	NN	1	Deutsch
aussprechen	VBN	1	ausgesprochen
Träger	NN	1	Träger
Ehren	NN	1	Ehren
aufrichtig	JJ	1	aufrichtiges
zufried	JJ	1	zufrieden
Ochsen	NN	1	Ochsen
zugezogen	NN	1	zugezogen
Zorn	NN	1	Zorn
hättest	RP	1	hättest
unhöflich	VB	1	unhöflichen
notdürftig	JJ	1	notdürftig
losmachen	VB	1	losmachen
Geizhalses	NN	1	Geizhalses
vorhin	RB	1	vorhin
Kaufs	NN	1	Kaufs
anzufangen	VB	1	anzufangen
Wohnung	NN	1	Wohnung
plaudern	VB	1	plaudern
Kosten	NN	1	Kosten
aushalten	NN	1	aushalten
Loch	NN	1	Loch
Wolle	NNS	1	Wollen
geleg	JJ	1	gelegen
nied	JJ	1	nieder
nien	VB	1	nie
Rande	NN	1	Rande
Wetter	NN	1	Wetter
verlor	JJ	1	verloren
einander	PRP	1	einander
Rabatt	NN	1	Rabatt
Schmeichelei	NN	1	Schmeichelei
anschlagen	NN	1	anschlagen
Pst	RB	1	Pst
eingeschlafen	NN	1	eingeschlafen
Betriegereien	NN	1	Betriegereien
Schelm	NN	1	Schelm
geredt	NNP	1	geredt
Gelehrsamkeit	NN	1	Gelehrsamkeit
menschlichem	NN	1	menschlichem
schlau	JJ	1	schlau
jetzen	VB	1	jetzt
seitdem	CC	1	seitdem
Lieber	NN	1	Lieber
zuhält	NN	1	zuhält
rechtschaffene	NN	1	rechtschaffene
bessern	VB	1	bessern
rechtschaffenst	JJ	1	rechtschaffenste
Marsch	NN	1	Marsch
Spitzen	NN	1	Spitzen
Tropfen	NN	1	Tropfen
grössrer	NN	1	größrer
mags	NN	1	mags
Niederlage	NN	1	Niederlage
lüge	NN	1	lüge
versündigen	VB	1	versündigen
verteufelten	NN	1	verteufelten
Stoff	NN	1	Stoff
sparen	VBN	1	gespart
schlechen	VBN	1	schlecht
Kennen	NN	1	Kennen
überlegen	VBN	1	überlegt
allezeit	NN	1	allezeit
insbesondere	RP	1	insbesondere
drohend	JJ	1	drohende
Zahlen	NN	1	Zahlen
Laterne	NN	1	Laterne
taten	NN	1	taten
wäre	VB	1	wäre
volles	NN	1	volles
möchte	VB	1	möchte
Knecht	NNP	1	Knecht
Lob	NN	1	Lob
käm	JJ	1	käme
Höre	NN	1	Höre
besinnen	VB	1	besinnen
Spitzbuben	NN	1	Spitzbuben
Krieg	NNS	1	Kriege
tragisch	JJ	1	tragische
scherzen	VB	1	scherzen
Strafpredigen	RP	1	Strafpredigt
Verrichtungen	NN	1	Verrichtungen
Ansa	NN	1	Ansa
Geh	NN	1	Geh
Zehnmalten	VB	1	Zehnmalen
allerlei	JJ	1	allerlei
verschwendete	NN	1	verschwendete
Wendisch	JJ	1	Wendischen
allmählig	JJ	1	allmählig
sollst	RB	1	sollst
sobald	CC	1	sobald
Früchtchen	NN	1	Früchtchen
Skripturen	NN	1	Skripturen
Schuhblätter	NN	1	Schuhblätter
Besinnen	NN	1	Besinnen
kriegten	NN	1	kriegten
Ans	NN	1	Ans
Hoffnung	NN	1	Hoffnung
entlegenen	NN	1	entlegenen
längst	RB	1	längst
ausgezogen	NN	1	ausgezogen
entdecken	VB	1	entdecken
Verzeichnis	NN	1	Verzeichnis
weggeflogen	NN	1	weggeflogen
Zweifler	NN	1	Zweifler
Sperling	NN	1	Sperling
ausgestanden	NN	1	ausgestanden
allzuviel	RB	1	allzuviel
siebenmal	RB	1	siebenmal
kleben	VB	1	kleben
Buckel	NN	1	Buckel
vorzubeugen	VB	1	vorzubeugen
retten	VB	1	retten
schw	JJ	1	schwer
schriftlich	JJ	1	schriftlich
Mundwerk	NN	1	Mundwerk
Drittel	NN	1	Drittel
Lebtage	NN	1	Lebtage
verwehren	VB	1	verwehren
Leuteschinder	NN	1	Leuteschinder
Worauf	NN	1	Worauf
geschafft	NN	1	geschafft
kleinst	JJ	1	kleinste
vorschlagen	VB	1	vorschlagen
Auge	NN	1	Auge
Magd	NN	1	Magd
Drum	NN	1	Drum
Karte	NN	1	Karte
Umständen	NN	1	Umständen
wenigsen	VB	1	wenigsten
belaufen	VB	1	belaufen
Wolf	NN	1	Wolf
womit	WRB	1	womit
anguckt	NN	1	anguckt
darinnen	NN	1	darinne
höflich	JJ	1	höflich
untergestütztem	NN	1	untergestütztem
Nennen	NN	1	Nennen
Vorgebirge	NN	1	Vorgebirge
abgegangen	NN	1	abgegangen
Ausser	IN	1	Außer
zwei	CD	1	zwei
floss	NN	1	floß
wetten	VB	1	wetten
gehenkt	NN	1	gehenkt
Eingeschlag	NN	1	Eingeschlagen
Schlösser	NN	1	Schlösser
fahren	VBN	1	fuhr
nackend	JJ	1	nackend
rechtfertigen	VB	1	rechtfertigen
Hellern	VB	1	Heller
weltberühmten	NN	1	weltberühmten
aufstehen	VB	1	aufstehen
bescheid	JJ	1	bescheiden
Gewölbe	NN	1	Gewölbe
verkauft	VB	1	verkauft
eine	RP	1	eine
abwesend	JJ	1	abwesend
Erstlich	JJ	1	Erstlich
Denkst	NN	1	Denkst
geheim	JJ	1	geheimes
schätzen	VB	1	schätzen
Allernotwendigsten	NN	1	Allernotwendigsten
Brüder	NN	1	Brüder
meldet	NN	1	meldet
he	NN	1	he
entsetzlich	JJ	1	entsetzlich
Diener	NN	1	Diener
äusserste	NN	1	äußerste
nuren	VB	1	nur
zweifeln	VB	1	zweifeln
treten	VB	1	treten
ärgerlich	JJ	1	ärgerlich
natürlich	RP	1	natürlich
billig	JJ	1	billig
ins	IN	1	ins
brauche	NN	1	brauche
beissen	VBN	1	gebissen
Antworte	NN	1	Antworte
überliefern	VB	1	überliefern
verkleiden	VB	1	verkleiden
Haut	NN	1	Haut
Million	NN	1	Million
Frühjahr	NN	1	Frühjahr
einbringen	VBN	1	einbringt
entblössen	NN	1	entblößen
Fünf	NN	1	Fünf
Ausschweifung	NN	1	Ausschweifung
erschreckst	NN	1	erschreckst
verstorben	VBN	1	verstorben
Schwätzer	NN	1	Schwätzer
Mensch	NN	1	Mensch
Kindern	NN	1	Kindern
Lust	NN	1	Lust
