Title: Miß Sara Sampson
Number of all lemmas: 25395
Nummber of different lemmas: 3843

Lemma	POS	Frequency	Tokens
Sie	PRP, JJ, PRP$	709	Sie
ich	PRP, JJ, PRP$	699	ich
sein	VB, VBN, PRP$, RB, NN, JJ	637	sind, ist, wären, gewesen, sein, war, bin, sei, waren, wäre
ein	DT, RP	522	eine, ein, eines, einer, einen, einem
nicht	RB	437	nicht
zu	IN, TO, RB, RP	435	zu
die	DT, WDT	376	die
es	PRP, JJ	364	es
haben	VB, RB	362	hat, habe, hätte, haben, hatte, hätten, hatten
und	CC	348	und
mir	PRP, JJ, PRP$	306	mir
mich	PRP	293	mich
der	DT, WDT	290	der, deren
sie	JJ, PRP, PRP$	289	sie
werden	VB, VBN, RB, RP	280	werden, würde, wird, würden, werde, geworden, wirst, wurden, wurde
dass	RB, IN	273	daß
Ich	PRP	260	Ich
wollen	MD	237	wollen, will, wollten, wolle, wollte, woll, wollt, wolltest
so	RB, IN, RP, JJ	235	so
in	IN, TO	219	in
er	PRP, JJ	198	er
als	IN	195	als
das	DT, WDT	190	das
den	DT, WDT	186	den, denen
dies	DT, WDT	185	diesem, diesen, diese, dieses, dieser
können	VB, VBN, RB	181	könnten, kannst, könnte, kann, können, konnte, könne, könntest
sich	PRP	181	sich
mit	IN, TO, RP	167	mit
von	IN, TO	155	von
noch	IN, RP, RB, WRB	149	noch
Mellefont	NN, NNP, RB, RP	144	Mellefont
für	IN	132	für
wenn	IN, RB	130	wenn
mein	PRP$, JJ	129	mein, meiner, meine, meines
auf	IN, RP, TO	126	auf
Miss	NN, NNP, JJ	126	Miß
ihn	PRP, JJ	125	ihn
nur	RB, RP, IN	122	nur
Ihnen	PRP, JJ	116	Ihnen
sollen	MD	111	soll, sollen, sollte
auch	RB, WRB, RP, IN	110	auch
Marwood	NN, NNP, JJ	108	Marwood
was	WP, WDT	104	was
du	PRP, JJ, PRP$	101	du
an	IN, RP, TO	101	an
doch	RB, CC, RP, VB, IN, WRB	98	doch
ihr	PRP, JJ, PRP$	97	ihr
machen	VB, VBN	91	machen, gemacht, macht, machten, machte
wieder	RP, RB, NNP, IN, WRB	90	wieder
ihm	PRP, JJ, PRP$	88	ihm
all	DT, JJ	87	allen, aller, alle, alles, allem
selbst	JJ	86	selbst
mussen	VB, VBN	86	muß, mußte, mußt
Was	WP	85	Was
dem	DT, WDT	83	dem
Aber	CC, RB	81	Aber
Und	CC, RB	79	Und
sagen	VB, VBN	78	sage, sagen, gesagt, sagt, sagte
aus	IN, RP, TO	70	aus
ohne	IN	69	ohne
lassen	VB, RB, VBN, NN	68	lassen, lasse, ließ, gelassen
Lady	IN, NNP, NN	67	Lady
Ach	NN, NNP	67	Ach
Vater	NN, NNP	66	Vater
nichts	DT, RB	65	nichts
Er	PRP, JJ	64	Er
schon	RB, IN, RP, NNP, WRB	63	schon
sehen	VB, RB, VBN, RP	61	sehen, sieht, gesehen, sah
wohl	IN, RB, RP	61	wohl
bei	IN	60	bei
Liebe	NN	60	Liebe
aber	WRB, IN, RB, CC, RP, NNP	59	aber
meinen	PRP$, VB, VBN, RP	59	meinen, meine, meinst, gemeint
mehr	RP, RB, IN, WRB	58	mehr
wie	IN	58	wie
Wenn	IN, RB	57	Wenn
Es	PRP	57	Es
denn	RB, RP, IN, WRB	56	denn
kein	DT, JJ	55	keiner, keinen, keine, kein, keinem
Ihre	PRP$	51	Ihre
müssen	VB	51	müßte, müssen, müsse, müßt, müßten, müßtest
uns	PRP, JJ	50	uns
tun	VB, VBN, RP, RB	50	tun, getan, tut, tat
dich	PRP, JJ	49	dich
gegen	IN, TO	49	gegen
kommen	VB, RP, VBN	49	kommen, komme, kam, gekommen, käme, kamen
Herz	NN, NNS	48	Herz, Herzen
ganz	JJ, RB, RP, IN, NNP	47	ganzen, ganz, ganze, ganzes
ihre	PRP$	46	ihre
Wie	IN	45	Wie
des	DT	45	des
Sara	NNP, NN	44	Sara
meine	PRP$	44	meine
sehr	RB, RP, IN	42	sehr
ja	RP, IN, RB	41	ja
durch	IN, RP	41	durch
Waitwell	NN	41	Waitwell
gut	JJ	40	gut, gute, guten, guter
vor	IN, RP	39	vor
gewiss	NN, JJ, NNP, VB	38	gewiß, gewisse, gewisser, gewissen
Tochter	NN, NNP	38	Tochter
nach	RP, IN	38	nach
Die	DT	38	Die, Dies
Brief	NN, NNS	38	Brief, Briefe
viel	RB, IN, RP, WRB, JJ, DT	38	viel, vieler, viele, vielen
nun	RB, IN, RP, WRB	37	nun
soen	VBN, RB, VB	37	so
um	IN	37	um
Ein	DT	36	Ein, Eine, Einen
seine	PRP$	34	seine
dir	PRP	33	dir
einmal	RB, IN, RP, WRB	33	einmal
weeissen	VB, RB	33	weiß
ist	JJ, VB, RB	32	ist
wissen	VB, RB	32	wissen
mögen	VB, RB	32	mag, möchten, möchte, mögen, möge, mochte
Hand	NN, JJ	32	Hand
gehen	VB, VBN	32	gehen, geht, gingen, ging, gegangen
Ihrer	PRP$	32	Ihrer
hier	RB, IN, RP	32	Hier, hier
vielleicht	IN, RB, RP	31	vielleicht
Ihr	PRP$, NN, JJ	31	Ihr, Ihren, Ihrem, Ihres
So	RB, IN, RP	31	So
wir	PRP, JJ	31	wir
man	DT	30	man
itzt	DT, RP	30	itzt
Du	NN, JJ, NNP	30	Du
meinem	PRP$	30	meinem
etwas	DT, JJ	30	etwas
allein	RB, RP, JJ	30	allein
Sein	VB, RB, PRP$, VBN	29	Ist, Sind, War, Sein
erst	JJ, RB, VB, IN, RP	29	ersten, erste, erst
dürfen	VB, VBN	29	darfst, dürfen, darf, dürfte, durfte, dürfe
Nein	NN	29	Nein
glauben	VBN, VB	29	glaubt, glauben, glaubst, glaube, glaubte, glaubten
Nun	UH	28	Nun
Betty	FW, NN	28	Betty
eben	RB, IN, RP	28	eben
bitten	VB, VBN	27	bitte, bitten, bittet, gebeten, bat
oder	CC, RB	27	oder
seiner	PRP$	27	seiner
da	IN, RB	26	da
wahr	JJ, RB, RP, IN	26	wahre, wahr, wahres
Das	DT	26	Das
nehmen	VB, RP	26	nimmt, nehmen, genommen, nehme, nahm
über	IN, TO	26	über
Warum	NN, NNP	26	Warum
weil	IN, RB	26	weil
vergessen	RP, VB, VBN	25	vergessen
Augenblick	NNP, NN	25	Augenblick, Augenblicke
Sir	NN	25	Sir
Ihren	JJ, NN, NNP	25	Ihren
ab	RP, IN, RB	25	ab
geben	VB, VBN	24	geben, gab, gibt, gegeben
ihrer	PRP$	24	ihrer
Norton	NN, NNP	24	Norton
lieb	JJ, VB	24	lieber, lieben, liebe, lieb
immer	RB, RP, IN	24	immer
meines	NN, JJ, NNP	24	meines
Augen	JJ, NN	24	Augen
Doch	WRB, RP, RB, IN	24	Doch
gleich	JJ	24	gleich, gleichen, gleicher, gleiche
lesen	VB, PRP$, VBN	23	lies, lesen, gelesen
glücklich	JJ	23	glücklich, glücklichen, glückliche
Welt	NN	23	Welt
genug	RB, RP, IN	22	genug
wenig	RB, IN, JJ, RP	22	wenig, wenigen
lange	RB, IN, RP	22	lange
denken	VB	22	denke, denken, denkt
ob	IN, RB	22	ob
also	RB, RP, IN, JJ	22	also
warum	WRB	22	warum
einig	JJ, DT	22	einigen, einige, einiger
finden	RB, VB, VBN	21	fand, finden, gefunden, findet
nie	IN, RB	21	nie
sprechen	VB, PRP$	21	gesprochen, sprechen, spricht
alt	JJ	21	alter, alte, alten, alt
Leben	NN	21	Leben
wer	WP	21	wer
unglücklich	JJ	20	unglücklich, unglücklichen, unglückliches, unglückliche
anders	RB, RP	20	anders
Tugend	NN, JJ	20	Tugend
bringen	VB, VBN	20	bringen, bringe, gebracht, brachte, bringt
liebste	NN, JJ, NNP	20	liebste
Vaters	NN, NNP	20	Vaters
bis	IN	20	bis
O	NN, NNP	20	O
letzt	JJ, VB	20	letzte, letzten
bleiben	VB, VBN, RP	20	bleiben, geblieben, bleibt
zurück	RB, JJ, IN, RP	20	zurück
stehen	VB, VBN	20	stehen, stand, steht, stehe
Der	DT	20	Der
wider	IN	19	wider
Gott	NN, JJ	19	Gott
halten	VB, VBN	19	halten, gehalten, hielt
wünschen	VB, VBN	19	wünschen, wünscht, wünschte, wünsche, gewünscht, wünschten
Herr	NN, NNP	18	Herr
wo	WRB	18	wo
andern	DT, JJ	18	andern
Tränen	NN, JJ, NNP	18	Tränen
Ja	NN	18	Ja
weit	JJ, RB	18	weit
neu	JJ, NN	17	neue, neuen, neuem, neuer, neu
muss	VB, JJ, NN, RB	17	muß
sterben	VB, VBN, PRP$	17	sterben, gestorben, starb, stirbt, sterbe
solch	DT	17	solcher, solche, solchen, solches
weiter	DT, RB, RP, NNP	17	weiteres, weiter
lieben	NN, VB, RB, JJ	17	lieben, liebe
Mann	NN	17	Mann
kennen	VB, VBN, RB	17	kennen, kenne, kennt
vergeben	RP, VB, VBN	17	vergeben
Augenblicke	NN	17	Augenblicke
verlassen	VB	17	verlassen
klein	JJ, RB	17	kleinen, kleiner, kleine, klein
deine	PRP$	17	deine
Wort	NN, NNS	16	Wort, Worte
welche	WDT, WP	16	welche
läng	JJ	16	länger
Hannah	NNP, NN	16	Hannah
Mutter	NN	16	Mutter
Kind	NN	16	Kind
gar	RB, RP	16	gar
fühlen	VB	16	fühle, fühlte, fühlt, fühlen
Namen	NN	16	Namen
gern	RB, RP, IN	16	gern
andre	NN	15	andre
Zweifel	NN	15	Zweifel
ewig	JJ	15	ewigen, ewig, ewige
seinen	PRP$	15	seinen
Art	NN	15	Art
Dies	DT	15	Diese, Dieses, Dieser
möglich	JJ	15	möglich
welcher	WP	15	welcher
Verbrechen	NN	15	Verbrechen
ruhig	JJ	15	ruhiger, ruhig
Mein	NN, JJ	15	Mein, Meiner
Frauenzimmer	NN	15	Frauenzimmer
Himmel	NN, NNP	15	Himmel
zärtlich	JJ	15	zärtlichen, zärtliche, zärtlich
suchen	VB, VBN	15	suchen, sucht, gesucht
Hülfe	NN	14	Hülfe
kömmen	MD	14	kömmt, kömmst
leben	VB, VBN	14	leben, lebt, lebe, lebte
hören	VB	14	höre, hören, hörte, hört, hörst
Ehre	NN	14	Ehre
Tage	NN, JJ	14	Tage
wenigstens	IN, RB, RP	14	wenigstens
setzen	VB, VBN, RP, PRP$	14	setzen, gesetzt, setzt, setzte
Geh	NN	14	Geh
weniger	IN, RB, RP	13	weniger
Lassen	MD	13	Lassen
unter	IN	13	unter
Tag	NN	13	Tag
wegen	RP, IN	13	wegen
welchen	WP	13	welchen
am	IN	13	am
Arabellen	NN	13	Arabellen
nein	RB, RP	13	nein
Füssen	NNP	13	Füßen
derselben	NN	13	derselben
eher	RB, IN, RP	13	eher
rechen	VB, VBN	13	recht, gerecht, rechten
Nicht	RB	13	Nicht
bald	WRB, RB, RP	13	bald
ihren	PRP$	12	ihren
im	IN	12	im
Zeit	NN, JJ	12	Zeit
ihrem	PRP$	12	ihrem
Ende	NN	12	Ende
Vermögen	NN	12	Vermögen
hoffen	VB	12	hoffe, hoffen
beid	DT, JJ	12	beiden, beide, beides
gefallen	VB, VBN, RP	12	gefallen
führen	VB	12	führt, führen, führte, führe
verlieren	VB, VBN	12	verlieren, verloren, verlöre
sind	JJ, RB, VB	12	sind
Glück	NN	12	Glück
liebt	NN	12	liebt
annehmen	VB, RP	11	annehmen, angenommen
Gedanke	NNS, NN	11	Gedanken, Gedanke
angenehm	JJ, VB	11	angenehm, angenehme, angenehmer, angenehmen
wirst	WRB, RB, JJ	11	wirst
schreiben	VBN, VB, RB	11	geschrieben, schreiben, schreibt
jetzt	IN, RB, NNP, RP	11	jetzt
zur	IN	11	zur
verstehen	VB	11	verstehe, verstehen, versteht, verstanden
Ihres	NN, NNP	11	Ihres
folgen	VB, VBN	11	folgen, folgt, folgte, folgten, gefolgt
Mit	IN	11	Mit
kann	JJ, RB, VB, NN	11	kann
verdienen	VB, VBN	11	verdient, verdienen
lernen	VB, RP, VBN	11	lernte, gelernt, lernen, lerne
Wer	WP	11	Wer
einzig	JJ	11	einzige, einziger, einzigen, einzig
deinen	NN	11	deinen
ehe	CC, RB	11	ehe
grausam	JJ	11	grausam, grausame, grausamer, grausamen
hast	NN	11	hast
Unglück	NN	11	Unglück
endlich	IN, RB, JJ	11	endlich, endliche
jed	DT, JJ	11	jeder, jeden, jede
nennen	VB	11	nenne, nennen, nennt, genannt, nannte
Freude	NN	11	Freude
dein	PRP$	11	dein
Fehler	NN	11	Fehler
darauf	RB	11	darauf
Sampson	NN, NNP	11	Sampson
oft	RB, IN, RP	11	oft
dazu	RB	10	dazu
willst	RP, WRB	10	willst
Seite	NN	10	Seite
damit	RB, IN	10	damit
Arm	NN, NNS	10	Armen, Arme, Arm
deswegen	RB, RP	10	deswegen
unsern	PRP$	10	unsern
kurz	JJ	10	kurze, kurz, kurzen, kurzer
Bitte	NNS, NN	10	Bitten, Bitte
Dass	IN, RB	10	Daß
erfahren	VBN, VB, RP	10	erfahren, erfuhr
gehabt	NN	10	gehabt
lass	JJ, VB	10	laß, lasse
scheinen	VB, VBN, RB	10	scheinen, scheint, schien
Sollen	MD, VB	10	Soll, Sollen
Lass	NN, NNP	10	Laß
erwarten	VB	10	erwarten
bist	NN	10	bist
helfen	VB	10	hilft, half, helfen
unserer	PRP$	10	unserer
Indem	RB	10	Indem
daran	RB	10	daran
Hier	RB, IN, RP	9	Hier
ward	NNP, NN	9	ward
Vergnügen	NN	9	Vergnügen
Empfindung	NNS, NN	9	Empfindungen, Empfindung
Bella	NN	9	Bella
unsere	PRP$	9	unsere
ansehen	VBN, VB	9	angesehen, ansehen, ansieht
Wo	WRB	9	Wo
väterlich	JJ	9	väterliches, väterlichen, väterliche
welchem	WP	9	welchem
erinnern	VB, VBN	9	erinnern, erinnere, erinnert
unser	PRP$	9	unser
List	NN	9	List
erlauben	VB, VBN	9	erlauben, erlaubte, erlaubt
wagen	VB, RP, VBN	9	wagen, gewagt
dann	NNP, RP, RB	9	dann
Auch	RB, WRB, IN	9	Auch
reden	VB, VBN, RP	9	reden, redet, rede, geredet
sehe	PRP$	9	sehe
wäre	RB, VB	9	wäre
Hoffnung	NN, JJ	9	Hoffnung
Mensch	NN	9	Mensch
Sprache	NN	8	Sprache
Zu	IN, RB	8	Zu
desselben	NN	8	desselben
Dolch	NN	8	Dolch
Antwort	NN	8	Antwort
durchaus	RB	8	durchaus
Ha	NN	8	Ha
lieset	NN	8	lieset
zum	IN	8	zum
Schmerz	NNS, NN	8	Schmerzen, Schmerz
fehlen	VB	8	fehlen, fehlt, fehlte, fehle
schrecklich	JJ	8	schreckliche, schrecklicher, schrecklichen, schrecklich
Klage	NNS	8	Klagen
Mitleiden	NN, JJ	8	Mitleiden
leicht	IN, JJ, RP	8	leicht, leichter
gross	JJ	8	groß, große, großes
besser	RP, RB, JJ	8	besser, bessere
welches	WDT, WP	8	welches
Lebens	NN	8	Lebens
Wut	NN	8	Wut
lässen	VB	8	läßt
jen	DT	8	jener, jene, jenem
Nur	RB, IN	8	Nur
Vergebung	NN	8	Vergebung
sonst	RB	8	sonst
zwar	RB, RP, JJ	8	zwar
Gewalt	NN	8	Gewalt
geschehen	VB, VBN	8	geschehen
Seele	NN	8	Seele
Madam	JJ, RB	8	Madam
verlangen	VB	8	verlangen, verlangt
seinem	PRP$	8	seinem
zeigen	VB, VBN	8	zeigen, gezeigt, zeigt
Solmes	NN, NNP	8	Solmes
Freund	NNS, NN, NNP	8	Freunde, Freund
Schicksal	NN, NNS	8	Schicksal, Schicksale
Willen	NN	8	Willen
nuren	RB, RP, VBN, VB	8	nur
davon	RB	8	davon
Nachricht	NNS, NN	8	Nachrichten, Nachricht
Miene	NN, NNS	7	Miene, Mienen
Person	NN	7	Person
Rache	NN	7	Rache
deiner	PRP$	7	deiner
William	JJ	7	William
brauchen	VB	7	braucht, brauchen
gefährlich	JJ	7	gefährlichen, gefährliche, gefährlich
Herzens	JJ, NN	7	Herzens
Geschlechts	NN	7	Geschlechts
dafür	RB	7	dafür
Verbindung	NN	7	Verbindung
erhalten	VB, VBN	7	erhalten
alles	RB	7	alles
ausser	IN	7	außer
ihres	PRP$	7	ihres
fort	IN, RP	7	fort
Schwachheit	NN	7	Schwachheit
Freundin	NN, NNS	7	Freundin, Freundinnen
Verstellung	NN, NNP	7	Verstellung
ihnen	PRP	7	ihnen
fliehen	VB	7	fliehen, flieht
Ihrem	NN, JJ	7	Ihrem
fasen	VB, VBN, JJ	7	fast
Gerechtigkeit	JJ, NN	7	Gerechtigkeit
Leute	NN	7	Leute
verzeihen	VB	7	verzeihen
Kann	NNP, NN	7	Kann
falsch	JJ	7	falsch, falschen
Wollust	NN	7	Wollust
empfinden	VB, VBN	7	empfinden, empfunden
Reden	NN	7	Reden
Gift	NN	7	Gift
Mühe	NN	7	Mühe
werfen	VB, VBN, RP	7	warfen, geworfen, werfen
bloss	RP, RB, JJ	7	bloß, bloße
Komm	NN	7	Komm
heuen	VB, VBN	7	heute, heut
Welche	WP	7	Welche
Gesinnung	NNS	7	Gesinnungen
gestehen	VB, VBN	7	gestehen, gestanden
seh	PRP$	7	seh
Natur	NN	7	Natur
Zimmer	NN, JJ	7	Zimmer
weinen	VB	7	weinen, geweint
allzu	RB	7	allzu
Nacht	NN, NNP	7	Nacht
Man	DT, RB	7	Man
Bedenken	NN	7	Bedenken
erklären	VB	7	erklären, erkläre, erklärt, erklärten
wiedern	VB, VBN	7	wieder
Gefahr	NN	7	Gefahr
dahin	JJ, RB, RP	7	dahin
verbinden	VB, VBN, RP	7	verband, verbunden, verbinden
verlor	NN, JJ	7	verlor, verloren
Vielleicht	RP, RB, IN	7	Vielleicht
natürlich	RP, RB	7	natürlich
Vorwurf	NN, NNP	7	Vorwurf
ziehen	VB	7	zog, ziehen, zieht
weder	CC	7	weder
Blick	NN	7	Blick
jemals	RB, IN	6	jemals
überzeugen	VB, VBN	6	überzeugt, überzeugen
wann	WRB	6	wann
plötzlich	JJ	6	plötzlich, plötzliche
Mädchen	NN	6	Mädchen
nahe	TO, IN, RP	6	nahe
fällen	VB	6	fällt
Dienste	NN	6	Dienste
schwach	JJ, RB	6	schwach, schwache
fangen	VB	6	fängt, fangen
fürchten	VB, RP	6	fürchten, gefürchtet
enthalten	VBN	6	enthalten
Schande	NN	6	Schande
kalt	JJ	6	kalter, kalt, kaltem, kalte
Vorstellungen	NN, JJ	6	Vorstellungen
nunmehr	RB	6	nunmehr
Wir	PRP	6	Wir
mache	NN	6	mache
Flucht	NN	6	Flucht
davonen	VB, RB	6	davon
Laster	NN	6	Laster
gehe	NN	6	gehe
Wohin	NN, NNP	6	Wohin
Erlauben	NN	6	Erlauben
sogleich	RP, RB, IN	6	sogleich
Anteil	NN	6	Anteil
In	IN	6	In
London	NN	6	London
erzeigen	VB, NN, VBN	6	erzeigt, erzeigen
Nichts	NN	6	Nichts
teu	JJ	6	teuer
Tod	NN	6	Tod
darum	RB	6	darum
sondern	RB, CC	6	sondern
Gewissen	NN	6	Gewissen
Oder	NN	6	Oder
Armen	NN	6	Armen
unruhig	JJ	6	unruhige, unruhig, unruhiger
dabei	RB	6	dabei
bekommen	VBN, VB, RB	6	bekommen
euch	PRP	6	euch
Morgen	NN	6	Morgen
Händen	NN	6	Händen
Reue	NN	6	Reue
Ohne	IN	6	Ohne
fürchte	NN	6	fürchte
bös	JJ	6	böse
verursachen	VB, VBN, RP	6	verursachen, verursacht
Aufenthalt	NN	6	Aufenthalt
Allein	NN	6	Allein
gedenken	VB, VBN	6	gedenken, gedacht
empfangen	VB	6	empfangen
Geben	NN	6	Geben
Geist	NN	6	Geist
Anverwandte	NN	6	Anverwandte
Gewiss	UH, DT	6	Gewiß, Gewisse
jung	JJ	6	jungen, jung, junge, junges
Freundschaft	NN	6	Freundschaft
Indemen	RB, VB	5	Indem
Sohn	NN	5	Sohn
frei	JJ	5	freien, frei, freie
best	VB, JJ	5	beste, bester
Abscheu	NN	5	Abscheu
fest	JJ, RP	5	festes, fest, festen
Hälfte	NN	5	Hälfte
legen	VB	5	gelegt, legen
Leidenschaft	NNS, NN, JJ	5	Leidenschaften, Leidenschaft
Angst	NN	5	Angst
reeissen	VB	5	reißt, reißen
schweigen	RP, VB	5	geschwiegen, schweigen
entdeckt	NN, JJ	5	entdeckt, entdeckter
Sage	NN	5	Sage
wirklich	JJ	5	wirkliche, wirklich
Kräfte	NN	5	Kräfte
halb	CD	5	halb
Vorwürfe	NN	5	Vorwürfe
Schrecken	NN	5	Schrecken
Schlinge	NN	5	Schlinge
Noch	RB	5	Noch
kosen	VB	5	kosten, kostet
merken	VB	5	merke, merken, merkte
sollten	NN	5	sollten
liebster	NN	5	liebster
geschwind	RB, IN	5	geschwind
Wert	NN	5	Wert
Zwang	NN	5	Zwang
Ihn	NN, JJ	5	Ihn, Ihnen
Sache	NN	5	Sache
Stich	NNS, NN	5	Stiche, Stich
Erbarmen	NN, NNP	5	Erbarmen
Gehen	VB, NN	5	Geht, Gehen
nötig	JJ, VB	5	nötig, nötiger
habe	RB, VB	5	habe
Schönheit	NN	5	Schönheit
Darf	NN	5	Darf
Traum	NNS, NN	5	Träume, Traum
Kommen	NN	5	Kommen
Strafe	NN	5	Strafe
Gesichte	NN	5	Gesichte
treffen	VB	5	treffen, trifft, getroffen
krank	JJ	5	krank
Recht	NN	5	Recht
Anblick	NN, NNS	5	Anblick, Anblicke
tausend	CD	5	tausend
Mut	NN, JJ	5	Mut
Verführer	NN	5	Verführer
fallen	VB	5	fiel, fallen
Ursache	NN, JJ	5	Ursache
Freiheit	NN	5	Freiheit
Einbildungen	NN	5	Einbildungen
scheinet	NN	5	scheinet
strafen	VB	5	strafen
Dank	IN, RP	5	Dank
dadurch	RB	5	dadurch
zwingen	VB, VBN	5	gezwungen, zwingen, zwinget, zwang
abern	CC, VBN, VB	5	aber
Besuch	NN, NNP	5	Besuch
danke	RP, RB, IN	5	danke
bin	JJ, VB	5	bin
handeln	VB	5	handle, handeln, handelt
darinen	VB	5	darin
Itzt	NN	5	Itzt
lang	JJ	5	langen, lang, langem
Martern	NN	5	Martern
Schon	FW, RB	5	Schon
Elende	NN	5	Elende
früh	JJ	5	früh
liegen	VB	5	liegt, liegen
reg	JJ	5	rege
zufried	JJ	5	zufrieden
bessern	VB, RP, PRP$, VBN	5	bessern, besser
vergebens	JJ, RB	5	vergebens
Denn	RB	5	Denn
selten	RB	5	selten
längst	RB	5	längst
Einbildung	NN	5	Einbildung
Auge	NN	5	Auge
dess	WDT	5	dessen
Gelegenheit	NN	5	Gelegenheit
übrig	JJ	5	übrigen, übrig
Diener	NNP	5	Diener
zweifeln	VB, RP	5	zweifeln, gezweifelt
Haus	NN	5	Haus
Denkungsart	NNP	4	Denkungsart
versprach	NN	4	versprach
Arabella	NNP, NN	4	Arabella
derjenig	DT, WDT	4	derjenigen, derjenige
Drohung	NNS	4	Drohungen
Acht	NN	4	Acht
vermögen	VB	4	vermag, vermögen
arme	NN, FW	4	arme
spät	JJ	4	späte, spät
niemand	DT	4	niemand
tragen	VB, VBN	4	tragen, getragen
deinem	NN	4	deinem
geliebt	NN	4	geliebt
sahe	NN	4	sahe
Erbschaft	NN	4	Erbschaft
tot	JJ, RB	4	tot
Bedienter	NN	4	Bedienter
entschuldigen	VB	4	entschuldigen, entschuldigt
Einfall	NN	4	Einfall
Bin	NN	4	Bin
anfangen	VB	4	anfangen
desto	RB, CC	4	desto
Sieh	NN	4	Sieh
gefällig	JJ	4	gefällig, gefällige
hab	NN	4	hab
niemals	RB, IN, RP	4	niemals
hat	RB	4	hat
gönnen	VB	4	gönnen
welch	WDT	4	welche, welch, welches
widerfahren	NN	4	widerfahren
Vergeben	NN	4	Vergeben
verschwinden	VB, VBN	4	verschwinden, verschwunden
überwinden	VBN, VB	4	überwunden, überwinden
erscheinen	VB	4	erschienen, erscheinen
geliebten	NN, NNP	4	geliebten
grösst	JJ	4	größten
Betrübnis	NN	4	Betrübnis
Eben	NN	4	Eben
Vergessen	NN	4	Vergessen
gehören	VBN, VB	4	gehört
trennen	VB	4	trennen
Glauben	NN	4	Glauben
Tat	NN	4	Tat
Wohltat	NN	4	Wohltat
Absicht	NN	4	Absicht
verbergen	VB	4	verbergen, verbirgt
Verlangen	NN	4	Verlangen
Sehen	NN, NNP	4	Sehen
Soen	VBN, RB	4	So
Schmeichelei	NN	4	Schmeichelei
Glückseligkeit	NN	4	Glückseligkeit
Verderben	NN	4	Verderben
ungern	JJ, NN	4	ungern
Stelle	NN	4	Stelle
still	JJ	4	still, stille
erweisen	VBN, VB	4	erwiesen, erweisen
aufhalten	VB	4	aufhalten
Verräter	NN	4	Verräter
siehst	NN	4	siehst
behalten	VB, VBN, RP	4	behalten
hätte	RB	4	hätte
Geheimnis	NNS, NN	4	Geheimnisse, Geheimnis
befinden	VB	4	befinden, befinde, befanden
bereits	RB, IN	4	bereits
dazuen	VB, RB	4	dazu
betrachten	VB, RP	4	betrachten, betrachtet
Hitze	NN	4	Hitze
Da	IN, RB	4	Da
Jahr	NN	4	Jahr
Güte	NN	4	Güte
wied	JJ	4	wieder
warten	VB	4	wartet, warten
Stahl	NN	4	Stahl
zugleich	IN, RB	4	zugleich
zittern	VB	4	zittern
glücklicher	NN	4	glücklicher
verführt	NN, NNP	4	verführt
eigne	NN, JJ	4	eigne
Luft	NN	4	Luft
fragen	VB	4	fragen
ach	UH	4	ach
Zug	NN	4	Zug
her	IN	4	her
erschrecke	NN	4	erschrecke
Herrn	NN, JJ	4	Herrn
Meine	PRP$	4	Meine
laut	JJ	4	lauter
meist	DT, JJ	4	meisten, meiste
Deine	NN	4	Deine
Auf	IN	4	Auf
Schritt	NN	4	Schritt
ersparen	VB	4	ersparen
geringste	NN, JJ	4	geringste
vollkomm	JJ	4	vollkommen
weisst	NN	4	weißt
darüber	RB	4	darüber
Zettel	NN	4	Zettel
Busen	NN	4	Busen
anzunehmen	VB	4	anzunehmen
Reich	NNS, NN	4	Reiche, Reich
hin	IN	4	hin
Ohnmacht	NN	4	Ohnmacht
erkaufen	NN	4	erkaufen
eignen	VB	4	eignen
Inhalt	NN	4	Inhalt
Bluts	NN	4	Bluts
unschuldig	JJ	4	unschuldig
herein	RP, RB	4	herein
erschrecken	VB	4	erschrecken
gnädiger	NNP	4	gnädiger
vermute	NN	4	vermute
Gesicht	NN	4	Gesicht
Glücklich	JJ, VB	4	Glücklich, Glückliche
Buhlerin	NN	4	Buhlerin
Unglücklich	VB, JJ	4	Unglückliche
Hände	NN	4	Hände
strafbar	JJ	4	strafbarer, strafbar, strafbare
Weil	RB, IN	4	Weil
gemein	JJ	4	gemeiner, gemeinen, gemeine
befehlen	VBN, VB, PRP$	4	befohlen, befehlen
genassen	VB	4	genießen
Besuche	NN	4	Besuche
Gut	NN, JJ	4	Gut, Gute
entsagen	VB	4	entsagen, entsagt
Verzeihen	NN	4	Verzeihen
zwischen	IN	4	zwischen
danken	VB	4	dankt, danken
nochen	RB, VB, VBN	4	noch
dochen	RB, RP, VB	4	doch
gleichgültig	JJ	4	gleichgültig
gutes	NN, JJ	4	gutes
bekennen	VB	4	bekannten, bekannt, bekennen
Anfang	NN	4	Anfang
dasjenig	DT	4	dasjenige
seines	PRP$	4	seines
Genug	NN	4	Genug
Wolle	NNS	4	Wollen
einander	PRP	4	einander
unwürdig	JJ	4	unwürdig, unwürdiges
überlegen	VB	4	überlegen
allezeit	NN	4	allezeit
Ungeheuer	NN	4	Ungeheuer
näh	JJ	4	näher
entdecken	VB	4	entdecken
Folgen	NN	4	Folgen
Verzweiflung	NN	4	Verzweiflung
Reiz	NNS	4	Reize
retten	VB	4	retten
Welch	JJ	4	Welcher, Welches
weg	RB, RP	4	weg
Personen	NN	4	Personen
freilich	RB, RP	4	freilich
Geliebte	NN	4	Geliebte
Segen	NN	4	Segen
vortrefflich	JJ	4	vortrefflich, vortreffliche
würde	RB	3	würde
schöne	NN	3	schöne
reissen	VB	3	riß
voraus	JJ, IN	3	voraus
Andenken	NN	3	Andenken
fürchterlich	JJ	3	fürchterlichen, fürchterliche
vorwerfen	VB	3	vorwerfen
entschliessen	VBN	3	entschlossen
Gegenwart	NN	3	Gegenwart
vorher	RB	3	vorher
verspreche	NN	3	verspreche
Vorteil	NN	3	Vorteil
darübern	VB	3	darüber
Verzögerung	NN	3	Verzögerung
Wirt	NN	3	Wirt
sicher	IN, RB	3	sicher
Lebensart	NNP	3	Lebensart
springen	VB	3	sprang, springen, springt
kehren	VB	3	kehren
verschwiegen	NN	3	verschwiegen
Himmels	NN	3	Himmels
Trost	NN	3	Trost
gemäss	IN, RP	3	gemäß
leiben	VBN	3	lieb, geliebet
Rechte	NN	3	Rechte
Lese	NNS	3	Lesen
Geschwind	NN	3	Geschwind
wüsste	NN	3	wüßte
Zeilen	NN	3	Zeilen
schmeichelhaft	JJ	3	schmeichelhaft
Närrin	NN	3	Närrin
Gleichgültigkeit	NN	3	Gleichgültigkeit
verraten	VB	3	verraten
Sei	NN	3	Sei
Band	NN	3	Band
weint	NN	3	weint
Jahre	NN	3	Jahre
sieh	NN	3	sieh
Sarchen	JJ, VB	3	Sarchen
schimpflich	JJ	3	schimpflichen, schimpfliche
erwarte	NN	3	erwarte
erfüllen	VB, VBN	3	erfülle, erfüllt
Unglücklicher	NN	3	Unglücklicher
Grund	NN	3	Grund
Sag	NN	3	Sag
erzählen	VB	3	erzählen, erzählte
Bote	NN	3	Bote
denen	WP, WDT	3	denen
Sagen	NN	3	Sagen
Punkt	NN	3	Punkt
unnatürlich	JJ	3	unnatürlichen, unnatürliche, unnatürlich
nochmals	RP, RB	3	nochmals
Fuss	NN	3	Fuß
Von	IN	3	Von
erholen	VB	3	erholen, erholt
Falle	NN	3	Falle
Eifersucht	NN	3	Eifersucht
Zärtlichkeit	NN	3	Zärtlichkeit
Blicke	NN	3	Blicke
Vorsprecher	NN	3	Vorsprecher
Aussicht	NN	3	Aussicht
setze	NN	3	setze
Unrecht	NN	3	Unrecht
zurückholen	NN	3	zurückholen
Wirkung	NN	3	Wirkung
schuldige	NN	3	schuldige
unserm	PRP$	3	unserm
würdig	JJ	3	würdig
Beleidigungen	NN	3	Beleidigungen
verachtet	NN, JJ	3	verachtet, verachteten
drohen	VB	3	drohet, drohten, drohen
entbehren	VB	3	entbehren
vorbei	IN	3	vorbei
Munde	NN	3	Munde
teils	NN	3	teils
schuldig	JJ	3	schuldig
gewähren	VB	3	gewähren
Klugheit	NN	3	Klugheit
untröstlich	JJ	3	untröstlich
aufheben	VBN, VB, RP	3	aufgehoben, aufheben
schlecht	JJ	3	schlechte, schlecht
Gattin	NN	3	Gattin
Kurz	NN	3	Kurz
erröten	VB	3	erröten
freuen	VB	3	freuen
traurig	JJ	3	traurig
sau	JJ	3	sauer
Glied	NN, NNS	3	Glied, Glieder
tugendhaft	NN	3	tugendhaft
fremd	JJ	3	fremde
Wochen	NN	3	Wochen
Weg	NN, NNP	3	Weg
fassen	VB	3	fassen, gefaßt
aufhören	VB	3	aufhören
geh	NN	3	geh
Alles	NN	3	Alles
Gefühl	NN	3	Gefühl
herablassen	NN	3	herablassen
Weise	NN, NNP	3	Weise
Qual	JJ, VB	3	Qualen
je	RB	3	je
darin	RB	3	darin
schnell	JJ	3	schnell
Hätte	NN	3	Hätte
verlustig	JJ	3	verlustig
Briefes	NN	3	Briefes
Unbässlichkeit	NN	3	Unbäßlichkeit
hernach	NN	3	hernach
herum	IN	3	herum
Mund	JJ, NN	3	Mund
Willst	WRB	3	Willst
zittere	NN	3	zittere
geniessen	VB, VBN	3	genossen, genießen
seufzen	VB	3	seufzen
lehren	VB	3	lehren
meinigen	NN	3	meinigen
Haupt	NN	3	Haupt
darf	VB	3	darf
Kinder	NN	3	Kinder
Engel	NN	3	Engel
wozu	WRB	3	wozu
meiner	RB	3	meiner
genugen	VBN, VB	3	genug
zurückkehren	VB	3	zurückkehren
Betrachtung	NN, NNS	3	Betrachtung, Betrachtungen
Strenge	NN	3	Strenge
Menschen	NN	3	Menschen
Höchsten	NN	3	Höchsten
Sollte	NN	3	Sollte
Waffe	NNS	3	Waffen
sagst	NN	3	sagst
leisten	VB	3	leistet, leisten
Exempel	NN	3	Exempel
Vermächtnis	NN	3	Vermächtnis
übel	JJ	3	übel
worden	VBN	3	worden
Rest	NN	3	Rest
begleiten	VB, RP	3	begleiten, begleitet
Körper	NN	3	Körper
Bekanntschaft	NN	3	Bekanntschaft
vernichten	VB	3	vernichten
besitzen	VB	3	besitzen
eilen	VB	3	eilen
aufs	NN	3	aufs
Teufel	NN	3	Teufel
edel	RB, JJ	3	edel
bestimmen	VBN, VB	3	bestimmt, bestimmen
Alter	NN	3	Alter
Hast	NN	3	Hast
Begierden	NN	3	Begierden
Ärzte	NN	3	Ärzte
diejenig	JJ, DT	3	diejenige, diejenigen
Mörderin	NN	3	Mörderin
fehlt	VB, JJ	3	fehlt, fehlte
hilf	NN	3	hilf
anwenden	VB	3	anwenden
Je	IN	3	Je
Kein	DT, JJ	3	Keine, Keiner
bedenken	VB	3	bedenken
bitter	JJ	3	bittere
Umstand	NN, NNS	3	Umstand, Umstände
Schranke	NNS	3	Schranken
Regungen	NN	3	Regungen
heisst	JJ, VB	3	heißt
Bediente	NN	3	Bediente
Wege	NN	3	Wege
überlassen	VB	3	überlassen
Achtung	NN	3	Achtung
empfinde	NN, NNP	3	empfinde
kostbar	JJ, VB	3	kostbaren, kostbarer, kostbares
alsdann	NN, NNP	3	alsdann
Undank	NN	3	Undank
Träne	NN	3	Träne
Schöpfer	NN	3	Schöpfer
Hören	NN	3	Hören
antworen	VB	3	antworten
Hat	NN	3	Hat
vergnügt	JJ	3	vergnügt
Gnade	NN	3	Gnade
Zukunft	NN	3	Zukunft
auchen	VB	3	auch
Ursach	VB, JJ, NN	3	Ursachen, Ursach
finde	NN	3	finde
Unruhe	NN	3	Unruhe
gewisses	NN	3	gewisses
Wodurch	NN	3	Wodurch
Blute	NN	3	Blute
verwandeln	VB	3	verwandeln
vergehen	VB	3	vergeht, vergehen
schenkt	NN	3	schenkt
Umsonst	NN	3	Umsonst
Irrtum	NN	3	Irrtum
richten	VB, PRP$	3	richten
beleidiget	NN	3	beleidiget
näher	JJ	3	nähere, näherer
schlägt	JJ	3	schlägt
bewegen	VB	3	bewegt, bewegen
Betrieger	NN	3	Betrieger
vorüber	NN, RP	3	vorüber
bringst	NN	3	bringst
schlafen	VB	3	schlafen
Dienst	NN	3	Dienst
voll	JJ	3	voll
schonen	VB, PRP$	3	schonen, schon
entschuldiget	NN	3	entschuldiget
acht	CD	3	acht
menschlich	JJ	3	menschlichen, menschliche
schaffen	VB	3	schaffen
meinetwegen	IN	3	meinetwegen
erinnerst	NNP, NN	3	erinnerst
versöhnt	RP, NN	3	versöhnt
Herren	NN	3	Herren
Bei	IN	3	Bei
schreckt	NN	3	schreckt
tugendhafte	NNP, NN	3	tugendhafte
Abwesenheit	JJ, NN	3	Abwesenheit
aufgeopfert	NN	3	aufgeopfert
Siehst	NN	3	Siehst
rauben	VB, RP	3	rauben, geraubt
Gib	NNP	3	Gib
schicken	VB, VBN	3	geschickt, schicken
könnte	VB, RB	3	könnte
Ruhe	NN	3	Ruhe
Stimme	NN, NNP	3	Stimme
tue	NNP, NN	3	tue
schlassen	VB	3	schließen
verdanken	VB	3	verdanken
Schatten	NN	3	Schatten
indem	IN	3	indem
Meinetwegen	NN	3	Meinetwegen
Machen	VB	3	Machen
Veränderung	NN	3	Veränderung
morgen	RB	3	morgen
Zunge	NN	3	Zunge
gewaltsam	JJ	3	gewaltsamen
Woche	NN	3	Woche
Todes	NN	3	Todes
Teil	NN	3	Teil
heilig	JJ	3	heilige, heilig
verächtlich	JJ	3	verächtlichen, verächtlich
vielleichen	VBN, VB	3	vielleicht
Hause	NN	3	Hause
Zuflucht	NN	3	Zuflucht
Lächeln	NN	3	Lächeln
Wohnung	NN	3	Wohnung
Zeremonie	NN	3	Zeremonie
vorstellen	VBN, VB	3	vorgestellt, vorstellen, vorstellte
begehen	VB, VBN	3	begehen, begangen
Sinnen	PRP$	3	Sinnen
etwa	RB	3	etwa
Wessen	NN	3	Wessen
Grenzen	NN	3	Grenzen
Vetters	NN	3	Vetters
Schwierigkeit	NN	3	Schwierigkeit
Untreue	NN	3	Untreue
Hartes	NN	3	Hartes
treten	VB	3	getreten, treten
heimlich	JJ	3	heimlich, heimlicher
Wiederhole	NN	3	Wiederhole
Anmut	NN	3	Anmut
Sturm	NN	3	Sturm
Verwirrung	NN	3	Verwirrung
Mörder	NN	3	Mörder
göttlich	JJ	3	göttlichen
Bösewicht	NN	3	Bösewicht
gleichwohl	RB, IN	3	gleichwohl
Lieset	NN	3	Lieset
kleinst	JJ	3	kleinste
wen	WP	3	wen
unterbrechen	VB	3	unterbricht
schätzen	VB, PRP$	3	schätzen
Werde	NN	3	Werde
fahren	VBN, VB	3	gefahren, fährt, fahren
geringsten	NN	3	geringsten
erkennen	VB	3	erkennen
Pein	NN	3	Pein
Bald	NN	3	Bald
hassen	VB	3	hassen
dringen	VBN	3	dringt, gedrungen
Den	DT	3	Den
seit	IN	3	seit
wär	JJ, NN	3	wäre, wär
Zorn	NN	3	Zorn
vorsätzlich	JJ	3	vorsätzliche, vorsätzlichen
billig	JJ	3	billig
versagen	VB	3	versagen, versagte
Fusse	NN	3	Fuße
Vergleich	NN, JJ	3	Vergleich
Verwünschungen	NN	3	Verwünschungen
ungeachtet	IN, RP	3	ungeachtet
Zurückkunft	NN	2	Zurückkunft
neun	CD	2	neun
schöpfen	VB	2	schöpfen
verfolgen	VBN, VB	2	verfolgt, verfolgen
zuletzt	RB	2	zuletzt
Unglücke	NN	2	Unglücke
ungefähr	RB	2	ungefähr
grossmütigen	NN	2	großmütigen
reichen	VB	2	reichen
vom	IN	2	vom
hintergehen	NN	2	hintergehen
Würde	NN	2	Würde
Schluchzend	JJ	2	Schluchzend
eng	JJ	2	enge, engen
erstemal	RP	2	erstemal
Taten	NN	2	Taten
Aufrichtigkeit	NN	2	Aufrichtigkeit
versprechen	VB	2	verspricht
Stunde	NN	2	Stunde
Übereilung	NN	2	Übereilung
Monat	NN	2	Monat
Gestalt	NN	2	Gestalt
schmerzhafte	NN	2	schmerzhafte
Anverwandten	NN	2	Anverwandten
Gesichter	NN	2	Gesichter
Bande	NN	2	Bande
abspenstig	JJ	2	abspenstig
vergibt	NN	2	vergibt
Misstrauen	NN	2	Mißtrauen
Behalten	NN	2	Behalten
Besitze	NN	2	Besitze
gerächet	NN	2	gerächet
Bleib	NN	2	Bleib
zitternde	NN	2	zitternde
werde	RB	2	werde
entschloss	JJ	2	entschlossen
Ward	NNP	2	Ward
daraufen	VB	2	darauf
anzeigen	VB	2	angezeigt, anzeigen
vorbereiten	VB, VBN	2	vorbereiten, vorbereitet
zubringen	NN	2	zubringen
Worten	NN	2	Worten
Mannes	NN	2	Mannes
laufen	VB	2	läuft, laufen
wussen	VB	2	wußte
Bedienten	NN	2	Bedienten
bebe	NN	2	bebe
öffentlich	JJ	2	öffentliche
Ganz	NN	2	Ganz
Ahnung	NNS	2	Ahnungen
Geschlechte	NN	2	Geschlechte
leugnen	VB	2	leugnen
verdient	VB, JJ	2	verdient, verdiente
geschliffen	NN	2	geschliffen
beschäftigen	VB	2	beschäftigten, beschäftigen
Vernunft	JJ, NN	2	Vernunft
unterlassen	VB	2	unterlassen
beschämt	JJ	2	beschämt
Fehltritt	NN	2	Fehltritt
verweilen	NN	2	verweilen
liest	NN	2	liest
schenken	VB	2	schenken
sagt	VB	2	sagt
Verführung	NN, JJ	2	Verführung
Papier	NN	2	Papier
besen	VB, NN	2	beste, besten
überschreiten	VB	2	überschritten, überschreiten
Verfinsterung	NN	2	Verfinsterung
vielmehr	RB, RP	2	vielmehr
fussfällig	JJ	2	fußfällig
auslassen	VB	2	auslassen
Unglücks	NN	2	Unglücks
hiesig	JJ	2	hiesigen
argwohnen	NN	2	argwohnen
Verachtung	NN	2	Verachtung
dasmal	RB	2	dasmal
elenden	NN	2	elenden
Brust	NN	2	Brust
verlange	NN	2	verlange
Zeugen	NN	2	Zeugen
Schweig	JJ	2	Schweig
natürliche	IN	2	natürliche
Halten	NN	2	Halten
entzweien	VB	2	entzweien
erkenne	NN	2	erkenne
Verstandes	NN	2	Verstandes
Besitz	NN	2	Besitz
Wange	NN	2	Wange
Handlung	NN	2	Handlung
Sieg	NN	2	Sieg
wenden	VB	2	wenden
gönne	NN	2	gönne
ankleiden	NN	2	ankleiden
freieren	VB	2	freier
sollt	NN	2	sollt
Faust	NN	2	Faust
Heftigkeit	NN	2	Heftigkeit
dächte	NN	2	dächte
anrechnen	NN	2	anrechnen
Werden	NN	2	Werden
brennen	VB	2	brennen
weiss	VB, JJ	2	weiß
Mädchens	NN	2	Mädchens
erkenn	NN	2	erkenn
jaten	VB, RB	2	ja
bereit	JJ	2	bereit
Hochachtung	NN	2	Hochachtung
Etwas	NN	2	Etwas
mehrern	NN	2	mehrern
weiblich	JJ	2	weiblichen
bricht	NN	2	bricht
binden	VBN, VB	2	gebunden, binden
Mannspersonen	NN	2	Mannspersonen
Nerve	NN	2	Nerve
Nachdem	IN	2	Nachdem
abgematteten	NN	2	abgematteten
Nachsicht	NN	2	Nachsicht
stecken	VB	2	stecken, steckt
Still	NN	2	Still
fern	JJ	2	ferne, fern
unterliegen	VB	2	unterliegen
war	VB, JJ	2	war
Unschuld	NN	2	Unschuld
Beschützer	NN	2	Beschützer
Tone	NN	2	Tone
Erinnern	NN	2	Erinnern
gemach	UH	2	gemach
Genuss	NN	2	Genuß
aushalten	NN	2	aushalten
unwert	NN	2	unwert
Ausschweifungen	NN	2	Ausschweifungen
Marwoods	NN	2	Marwoods
Redlichkeit	NN	2	Redlichkeit
Phantasie	NN	2	Phantasie
quälen	VB	2	quälen
Grossmut	NN	2	Großmut
Grausamkeit	NN	2	Grausamkeit
Wendung	NN	2	Wendung
Grabe	NN	2	Grabe
ehrlich	JJ	2	ehrlicher
Falschheit	NN	2	Falschheit
versuchen	VB	2	versucht, versuchen
süss	JJ	2	süße, süß
Preis	NN	2	Preis
Bereitwilligkeit	NN	2	Bereitwilligkeit
liebern	VB	2	lieber
wüssten	NN	2	wüßten
Feld	NN	2	Feld
Fügungen	NN	2	Fügungen
unsers	PRP$	2	unsers
Pöbel	NN	2	Pöbel
würdigen	VB, PRP$	2	würdigen
herab	NN	2	herab
Pflichten	NN	2	Pflichten
entfernen	VB	2	entfernen
aufzugeben	NN	2	aufzugeben
unmöglich	JJ	2	unmöglich
Unterschied	NN	2	Unterschied
plump	NN, JJ	2	plumpe, plump
entfernet	NN	2	entfernet
Genusses	NN	2	Genusses
schrecklichsten	NN	2	schrecklichsten
umarmen	VB	2	umarmen
Verdacht	NN	2	Verdacht
töten	VB	2	töten
Gesellschaft	NN	2	Gesellschaft
Himmlisch	JJ	2	Himmlisches, Himmlische
balden	VBN	2	bald
gelass	JJ	2	gelassen
wiedergeben	VB	2	wiedergeben
Begreifen	VB	2	Begriffe
Beste	NN	2	Beste
erwerben	VB	2	erwerben
drücken	VB	2	drückt, drücken
Verlass	NN	2	Verlaß
ergreifen	VB	2	ergreifen
kindlich	JJ	2	kindlichen, kindliche
ernstlich	JJ	2	ernstlich
dürfte	VB	2	dürfte
Wesen	NN	2	Wesen
tadeln	VB	2	tadeln
Frechheit	NN	2	Frechheit
Wen	NN	2	Wen
Anstalt	NN	2	Anstalt
Wem	NN	2	Wem
völlig	JJ	2	völlige
Jammer	NN	2	Jammer
Ränke	NN	2	Ränke
bitt	JJ	2	bitter
ähnlich	JJ	2	ähnlichen
Ihrige	NN	2	Ihrige
gib	NN	2	gib
Verbindlichkeit	NN, NNS	2	Verbindlichkeit, Verbindlichkeiten
Feuer	NN	2	Feuer
Möglichkeit	NN	2	Möglichkeit
Bekenntnis	NNP, NNS	2	Bekenntnis, Bekenntnisse
getrieb	JJ	2	getrieben
unterdessen	NN	2	unterdessen
geht	VB	2	geht
bestehen	VB	2	bestehen
vertrauen	VB	2	vertrauen
sahen	NN	2	sahen
sag	NN	2	sag
Überlegenheit	NN	2	Überlegenheit
Hals	NN	2	Hals
antworten	VB	2	antworten
Halt	NN	2	Halt
Name	NN	2	Name
Furcht	NN	2	Furcht
befahl	NN	2	befahl
äussersten	NN	2	äußersten
Trennung	NN	2	Trennung
geb	NN	2	geb
süsse	NN	2	süße
rasen	VB	2	rasen
Rückkehr	NN	2	Rückkehr
liebsten	NN	2	liebsten
geheimste	NN	2	geheimste
fremden	PRP$	2	fremden
abstatten	NN	2	abstatten
Güter	NN	2	Güter
anbelangen	VBN	2	anbelangt
besorgt	JJ	2	besorgt
einfallen	VB	2	einfallen
Eigensinn	NN	2	Eigensinn
teilen	VB	2	teilen
Glücke	NN	2	Glücke
sichern	VB	2	sichert, sichern
betrüben	VB	2	betrüben
Vatermörderin	NN	2	Vatermörderin
Verschulden	NN	2	Verschulden
Verteidigung	NN	2	Verteidigung
siegen	VBN, VB	2	gesiegt, siegen
Höflichkeit	NN	2	Höflichkeit
fühl	JJ, NN	2	fühle, fühl
besorge	NN	2	besorge
wessen	WP	2	wessen
aufgebracht	NN, JJ	2	aufgebrachter, aufgebrachten
seufzet	NN	2	seufzet
Ankunft	NN	2	Ankunft
Abend	NN, NNS	2	Abend, Abende
Früchte	NN	2	Früchte
bereden	NN, JJ	2	bereden
Höre	NN	2	Höre
Bis	IN	2	Bis
begegnen	VB	2	begegnen
aufopfern	NN	2	aufopfern
Gegenstände	NN	2	Gegenstände
aufzusuchen	VB	2	aufzusuchen
wahres	NN	2	wahres
Ausgang	NN	2	Ausgang
Gebieterin	NN	2	Gebieterin
hör	NN	2	hör
hieher	NN	2	hieher
unangenehm	JJ	2	unangenehme
Gehet	NN	2	Gehet
nötigen	VBN	2	nötig
befreien	VB	2	befreien
Eile	NN	2	Eile
eitel	JJ	2	eitel
empfindet	NN	2	empfindet
Meinung	NN	2	Meinung
teilhaft	NN	2	teilhaft
Beruhigung	NN	2	Beruhigung
stark	JJ	2	stark
Zweck	NN	2	Zweck
Gefälligkeiten	NN	2	Gefälligkeiten
scharf	JJ	2	scharf
wütend	JJ	2	wütend
vergab	NN	2	vergab
schickt	NNP, NN	2	schickt
argwöhnisch	JJ	2	argwöhnisch
ängstlich	JJ	2	ängstlichen, ängstliches
neunte	CD	2	neunte
Feder	NN	2	Feder
worauf	WRB	2	worauf
verrät	NN	2	verrät
Wagen	VBN, NN	2	Gewagt, Wagen
Verdruss	NN	2	Verdruß
eign	JJ	2	eignen, eigne
höchste	NN	2	höchste
Fesseln	NN, JJ	2	Fesseln
Eltern	NN	2	Eltern
Stille	NN	2	Stille
erzürnt	NN	2	erzürnt
empfindlich	JJ	2	empfindliche, empfindlich
Heilige	NN	2	Heilige
darnachen	VB	2	darnach
wohin	RB, WRB	2	wohin
Salz	NN	2	Salz
Seine	PRP$	2	Seine
elend	NN, JJ	2	elenden, elend
Unvorsichtigkeit	NN	2	Unvorsichtigkeit
könnten	RB	2	könnten
Reise	NN	2	Reise
Kleinigkeit	NN	2	Kleinigkeit
Schreck	NN	2	Schreck
hervor	IN	2	hervor
abe	JJ	2	aber
Verzeihung	NN	2	Verzeihung
fehl	NN	2	fehl
hinaus	IN	2	hinaus
Türe	NN	2	Türe
stärksten	NN	2	stärksten
heben	VBN	2	gehoben, hebt
heeissen	VB	2	heißt, heißen
Gesichts	NN	2	Gesichts
betäubt	NN	2	betäubt
schweige	NN	2	schweige
Tor	NNS, NN	2	Toren, Tor
Aus	IN	2	Aus
Kräften	NN	2	Kräften
angehen	VB	2	angeht
taub	JJ	2	taub
halte	NN	2	halte
damien	VB	2	damit
hierauf	NN	2	hierauf
Schuldigkeit	NN	2	Schuldigkeit
reuende	NN	2	reuende
Grille	NN	2	Grille
Elenden	NN	2	Elenden
unmenschlich	JJ	2	unmenschliche
Erde	NN	2	Erde
beschlassen	VB	2	beschließen
Danke	NN	2	Danke
betreigen	VB, VBN	2	betriegt
leichte	NN	2	leichte
närrisch	JJ	2	närrisch, närrische
Tyrannen	NN	2	Tyrannen
besitzt	NN	2	besitzt
Verleumdung	NNS, NN	2	Verleumdungen, Verleumdung
entfernt	JJ	2	entfernt
gelebt	NN	2	gelebt
Hölle	NN	2	Hölle
ernsthaft	JJ	2	ernsthaft
hart	JJ	2	hart
manch	DT	2	manche, mancher
umarmt	NN	2	umarmt
Freuden	NN	2	Freuden
Betrug	NN	2	Betrug
valten	VBN	2	viel
schlüge	NN	2	schlüge
Hatte	NN	2	Hatte
Züge	JJ, NN	2	Züge
tötend	JJ	2	tötender
gütig	JJ	2	gütig
Mittel	NN	2	Mittel
überall	RB, IN	2	überall
Vergehungen	NN	2	Vergehungen
Vaterlande	NN	2	Vaterlande
Erfahrung	NN	2	Erfahrung
meinig	DT, JJ	2	meinige
Vorwande	NN	2	Vorwande
kam	JJ, VB	2	kam
schmachtenden	NN	2	schmachtenden
Stande	NN	2	Stande
küssen	VB	2	küssen
Grobheiten	NN	2	Grobheiten
Bestreben	NN	2	Bestreben
einziges	NN	2	einziges
zeitlich	JJ	2	zeitliche
Dolche	NN	2	Dolche
aussetzen	VB, RP	2	aussetzen, ausgesetzt
beruhigen	VB	2	beruhigen
treiben	VB, VBN	2	treiben, getrieben
Könnte	NN	2	Könnte
Furie	NN	2	Furie
stumm	JJ	2	stummen, stumme
arm	JJ	2	armen
sei	VB	2	sei
Seligkeiten	NN	2	Seligkeiten
Nichtswürdigen	NN	2	Nichtswürdigen
verborgensten	NN	2	verborgensten
verführte	NN	2	verführte
Bedingung	NN	2	Bedingung
müssigen	MD	2	müßig
Tode	NN	2	Tode
Für	IN	2	Für
wem	WP	2	wem
stürzen	RP, VB	2	gestürzt, stürzen
Lüge	NN	2	Lüge
länger	RB	2	länger
Schlimmste	NN	2	Schlimmste
verwundern	NN	2	verwundern
nachgebracht	NN	2	nachgebracht
Nach	IN	2	Nach
beleidigen	VB	2	beleidigen
Unterredung	NN	2	Unterredung
bekomme	NN	2	bekomme
urteilen	VB	2	urteilen
recht	VB, JJ	2	rechten, recht
andermal	RB, RP	2	andermal
unendlich	JJ	2	unendlich
geschwinder	NN	2	geschwinder
Absichten	NN	2	Absichten
stellen	VB	2	stellen, stellte
Kummer	NN	2	Kummer
Mellefonts	NN	2	Mellefonts
Traume	NN	2	Traume
vermuten	VB	2	vermuten
fesseln	VB, VBN	2	fesseln, gefesselt
Zeiten	NN	2	Zeiten
wollüstigen	MD	2	wollüstige
verändern	RP, VB	2	verändert, verändern
Weibchen	NN	2	Weibchen
umfassen	VB	2	umfassen
hinter	IN	2	hinter
durchstossen	NN	2	durchstoßen
Szene	NN	2	Szene
Grausame	NN	2	Grausame
gekostet	NN	2	gekostet
Arzenei	NN	2	Arzenei
Tugenden	NN	2	Tugenden
Ist	VB	2	Ist
Gefallen	NN	2	Gefallen
daraus	RB	2	daraus
verkennen	VBN, VB	2	verkannt, verkennen
schrecklichst	JJ	2	schrecklichsten
strengste	NN	2	strengste
Feind	NN, NNS	2	Feind, Feinde
Möchte	NN	2	Möchte
Begierde	NN	2	Begierde
bedacht	NN	2	bedacht
Erwarten	NN	2	Erwarten
Zur	IN	2	Zur
ehrfurchtsvolle	NN	2	ehrfurchtsvolle
Seligkeit	NN	2	Seligkeit
verschonen	VB	2	verschonen
Ah	NN	2	Ah
An	IN	2	An
holen	VBN, VB	2	holte, holen
unverzüglich	JJ	2	unverzüglich
liebten	NN	2	liebten
wiederkommen	NN	2	wiederkommen
dagegen	RB	2	dagegen
Familie	NN	2	Familie
Fassen	NN	2	Fassen
Nebenbuhlerin	NN	2	Nebenbuhlerin
süssen	NN	2	süßen
Liebste	NN	2	Liebste
Ort	NN	2	Ort
Vorsatz	NN	2	Vorsatz
traurigen	NN	2	traurigen
Seufzer	NN	2	Seufzer
ergeben	VB	2	ergeben, ergab
Wieder	IN	2	Wieder
sehnlich	JJ	2	sehnliches, sehnlich
Fleck	NN	2	Fleck
Qualten	VB	2	Qualen
entgehen	VB	2	entgehen
verwickeln	NN	2	verwickeln
Wohl	RP, RB	2	Wohl
begierigern	VB	2	begieriger
liebst	NN, JJ	2	liebste, liebster
Jugend	NN	2	Jugend
Geschenke	NN	2	Geschenke
erstarrt	NN	2	erstarrt
schmeichelt	VB, NN	2	schmeichelt
hindert	NN	2	hindert
zeitig	JJ	2	zeitig
rechtschaffnen	NN	2	rechtschaffnen
tief	JJ	2	tiefen, tief
ausdrücken	VB	2	ausdrücken
Stachel	NN	2	Stachel
sprichst	NN	2	sprichst
Vertraulichkeit	JJ, NN	2	Vertraulichkeit
Seiten	NN	2	Seiten
Sinn	NN	2	Sinn
zehn	CD	2	zehn
Notwendigkeit	NN	2	Notwendigkeit
Strahl	NN	2	Strahl
Mannsperson	NN	2	Mannsperson
Blicken	NN	2	Blicken
Flecken	NN	2	Flecken
Beleidigung	NN	2	Beleidigung
vergrösserten	NN	2	vergrößerten
Summen	NN	2	Summen
wanden	VB	2	wandte
Vergehen	NN	2	Vergehen
eifersüchtig	JJ	2	eifersüchtig
schämen	VB	2	schämen
Unwille	NN	2	Unwille
besess	JJ	2	besessen
erstaune	NN	2	erstaune
kaum	RB	2	kaum
Opfer	NN	2	Opfer
Ungetreuen	NN	2	Ungetreuen
Stärke	NN	2	Stärke
forschen	VB	2	forschen, forsche
aufgeben	VB	2	aufgeben
Annäherungen	NN	2	Annäherungen
Ewigkeit	NN	2	Ewigkeit
umsonst	IN, RB	2	umsonst
störest	NN	2	störest
gelten	VB	2	galt, gelten
überdrüssig	JJ	2	überdrüssig
Irrtume	NN	2	Irrtume
Umgange	NN	2	Umgange
Unwissenheit	NN	2	Unwissenheit
Rede	NN	2	Rede
aufrichtig	JJ	2	aufrichtig
zugezogen	NN	2	zugezogen
schlief	NN	2	schlief
melden	VB	2	melden
lasterhafte	NN	2	lasterhafte
Umarmungen	NN	2	Umarmungen
nied	JJ	2	nieder
bring	NN	2	bring
erwecken	VB	2	erwecken
stehet	NN	2	stehet
Kaum	NN	2	Kaum
Umfang	NN	2	Umfang
fertig	JJ	2	fertig
Haben	NN	2	Haben
gewürdiget	NN	2	gewürdiget
ganzes	NN	2	ganzes
Entschluss	NN	2	Entschluß
Gesetzt	NN	2	Gesetzt
Lasterhafte	NN	2	Lasterhafte
Gesetze	NN	2	Gesetze
gelungen	VBN	2	gelungen
Reichtümer	NN	2	Reichtümer
Stütze	NN	2	Stütze
Tadle	NN	2	Tadle
Wahrheit	NN	2	Wahrheit
zärtlichsten	NN	2	zärtlichsten
sollst	WRB	2	sollst
Begnügen	NN	2	Begnügen
begierig	JJ	2	begierig
hattest	RP, RB	2	hattest
wegbegeben	NN	2	wegbegeben
erinnerte	NN	2	erinnerte
Konnte	NN	2	Konnte
Entfernung	NN	2	Entfernung
Rechtfertigung	NN	2	Rechtfertigung
Unsinn	NN	2	Unsinn
bewundern	VB	2	bewundern
schw	JJ	2	schwer
Standhaftigkeit	NN	2	Standhaftigkeit
Euch	NN	2	Euch
sobald	CC, RB	2	sobald
letzen	NN, VB	2	letzte
fliehe	NN	2	fliehe
Kraft	NN	2	Kraft
Umständen	NN	2	Umständen
verhärten	NN	2	verhärten
Lebt	NN	2	Lebt
schallt	NN	2	schallt
Sampsons	NN	2	Sampsons
Vermutung	NN	2	Vermutung
aufgehört	NN	2	aufgehört
Beispiele	NN	2	Beispiele
Nennen	NN	2	Nennen
dreiden	VB	2	dritten, dritte
verschieden	JJ	2	verschiedenen
Um	IN	2	Um
neidisch	JJ	2	neidische, neidisch
betauern	NN	2	betauern
hiervon	RB	2	hiervon
Durch	IN	2	Durch
eins	CD	2	eins
aufhält	NN	2	aufhält
entdeckte	NN	2	entdeckte
Mundes	NN	2	Mundes
Entzückung	JJ, NN	2	Entzückungen, Entzückung
hasse	NNP	2	hasse
mehrer	JJ	2	mehrere
Vorzüge	NN	2	Vorzüge
Des	JJ	2	Des
erbrechen	JJ, VB	2	erbrochen, erbrechen
anfange	NN	2	anfange
Vertrauen	NN	2	Vertrauen
Stunden	NN	2	Stunden
Ihrigen	NN	2	Ihrigen
vorzuwerfen	VB	2	vorzuwerfen
erstarre	NN	2	erstarre
Reihe	NN	2	Reihe
Lust	NN	2	Lust
wären	VB	1	wären
frohlocken	VB	1	frohlocken
eingeschmiedet	NN	1	eingeschmiedet
Überschlag	NN	1	Überschlag
öfter	NNP	1	öfter
Ehe	NN	1	Ehe
beobachten	VB	1	beobachten
gesteh	NN	1	gesteh
niedersetzen	NN	1	niedersetzen
bemächtiget	NN	1	bemächtiget
zuckte	NN	1	zuckte
gänzlich	JJ	1	gänzlich
Charakter	NN	1	Charakter
zukömmt	NN	1	zukömmt
Erniedrigendes	NN	1	Erniedrigendes
herumgetragen	NN	1	herumgetragen
argwöhnten	NN	1	argwöhnten
überlästig	JJ	1	überlästig
nichtswürdigsten	NN	1	nichtswürdigsten
niederzufallen	FW	1	niederzufallen
stützte	NN	1	stützte
vertraut	JJ	1	vertraut
fragst	NN	1	fragst
ausgesehen	NN	1	ausgesehen
bemerkte	NN	1	bemerkte
Affekts	NN	1	Affekts
errieten	NN	1	errieten
dern	NN	1	dern
Umgang	NN	1	Umgang
wahrhaftig	JJ	1	wahrhaftig
ausgeschickt	NN	1	ausgeschickt
Mitternacht	NN	1	Mitternacht
zutrauten	NN	1	zutrauten
dennen	RB	1	denn
wiederschenkte	NN	1	wiederschenkte
besässen	NN	1	besäßen
Rufen	NN	1	Rufen
durchbohren	NNP	1	durchbohren
beraubet	NN	1	beraubet
Schwester	NN	1	Schwester
entwaffnen	VB	1	entwaffnen
Wirklichkeiten	NN	1	Wirklichkeiten
festesten	NN	1	festesten
Kindheit	NN	1	Kindheit
eigennütziges	NN	1	eigennütziges
Schritte	NN	1	Schritte
seinig	DT	1	seinige
Vorurteilen	NN	1	Vorurteilen
Larven	NN	1	Larven
kräftiger	NNP	1	kräftiger
Dankbarkeit	NN	1	Dankbarkeit
äusserlich	JJ	1	äußerlich
verwahren	NN	1	verwahren
Übereilt	NN	1	Übereilte
Überfluss	NN	1	Überfluß
entzückt	NN	1	entzückt
vorig	JJ	1	vorigen
bezahlen	VBN	1	bezahlt
rechtschaff	JJ	1	rechtschaffen
Ursachen	VB	1	Ursachen
drei	CD	1	drei
angeloben	NN	1	angeloben
Plauderer	NN	1	Plauderer
Verzehrend	JJ	1	Verzehrend
entstehend	JJ	1	entstehenden
Drückungen	NN	1	Drückungen
sinnlosen	JJ	1	sinnlosen
anstatt	IN	1	anstatt
Fülle	NN	1	Fülle
ausbleichet	NN	1	ausbleichet
Mangel	NN	1	Mangel
gewöhnen	VB	1	gewöhnen
Wünsch	JJ	1	Wünschen
Offenherzig	JJ	1	Offenherzig
müssten	VB	1	müßten
unleidlich	RB	1	unleidlich
vergleichen	VB	1	verglichen
Satan	NNP	1	Satan
Sich	PRP$	1	Sich
empfand	NN	1	empfand
drauf	RB	1	drauf
nachteilige	NN	1	nachteilige
anzusehen	VB	1	anzusehen
Ehern	VB	1	Eher
Erziehung	NN	1	Erziehung
gehorche	NN	1	gehorche
unvermutete	NN	1	unvermutete
sterb	NN	1	sterb
los	RP	1	los
unbedächtiges	NN	1	unbedächtiges
gährende	NN	1	gährende
Verleumderin	NN	1	Verleumderin
verschwendet	NN	1	verschwendet
bewusst	JJ	1	bewußt
bringt	VB	1	bringt
höllischer	NN	1	höllischer
hatte	RB	1	hatte
zweideutiges	NN	1	zweideutiges
Stube	NN	1	Stube
Erstarren	NN	1	Erstarren
aufbrechen	VB	1	aufbrechen
erreichten	NN	1	erreichten
wussten	NN	1	wußten
buhlerisch	JJ	1	buhlerische
Schläge	NN	1	Schläge
Vornehmern	NN	1	Vornehmern
zielet	NN	1	zielet
Sarch	JJ	1	Sarchen
Uneigennützigkeit	NN	1	Uneigennützigkeit
Vorbereitung	NN	1	Vorbereitung
Schlagen	NN	1	Schlagen
vorgezogen	NN	1	vorgezogen
satt	JJ	1	satt
sprech	JJ	1	sprechen
Schonen	VBN	1	Schon
voriger	NNP	1	voriger
Jetzt	NN	1	Jetzt
Legen	NN	1	Legen
Neugierde	NN	1	Neugierde
vorigen	NN	1	vorigen
prangte	NN	1	prangte
Abfoderung	NN	1	Abfoderung
überhaupt	RB	1	überhaupt
Gelegenheiten	NN	1	Gelegenheiten
gestrost	NN	1	gestrost
Weinen	NN	1	Weinen
Fieber	NN	1	Fieber
gleitete	NN	1	gleitete
hüten	VB	1	hüten
wegkommen	VB	1	wegkommen
Wünsche	VB	1	Wünsche
Winkel	NN	1	Winkel
anklagen	VBN	1	anklagt
hoffnungslos	NN	1	hoffnungslose
scheine	NN	1	scheine
suche	NN	1	suche
Abschiedsbriefe	NN	1	Abschiedsbriefe
bösen	NN	1	bösen
schneiden	VB	1	schneiden
stössen	VB	1	stößt
allzugern	NN	1	allzugern
Schuldigen	NN	1	Schuldigen
zerrüttete	NN	1	zerrüttete
Frage	NN	1	Frage
Wette	NN	1	Wette
ehrlosen	NN	1	ehrlosen
ausgebrauset	NN	1	ausgebrauset
Nichtswürdige	NN	1	Nichtswürdige
Mag	NN	1	Mag
erschöpft	JJ	1	erschöpft
erlaube	VB	1	erlaube
Gehorsams	NN	1	Gehorsams
beklagen	VB	1	beklagen
ruhten	NN	1	ruhten
aufrichtiges	NN	1	aufrichtiges
Willens	NN	1	Willens
Anverwandter	NN	1	Anverwandter
schreckhaftes	NN	1	schreckhaftes
behalte	VB	1	behalte
beklaget	NN	1	beklaget
Antrag	NN	1	Antrag
Sklaverei	NN	1	Sklaverei
Achselzucken	NN	1	Achselzucken
antut	NN	1	antut
Ziel	NN	1	Ziel
Liebeshändeln	NN	1	Liebeshändeln
wimmernd	JJ	1	wimmernden
Edlern	NN	1	Edlern
Desto	NN	1	Desto
Unterhaltung	NN	1	Unterhaltung
Angenehmes	NN	1	Angenehmes
abzutren	VB	1	abzutreten
zurückzukommen	VB	1	zurückzukommen
Ungehorsams	NN	1	Ungehorsams
Stirne	NN	1	Stirne
abziehen	VB	1	abziehen
überlegte	NN	1	überlegte
stutzig	JJ	1	stutzig
feindselige	NN	1	feindselige
unternehmen	VBN	1	unternommen
überschrieben	NN	1	überschrieben
untersagen	NN	1	untersagen
verleitet	NN	1	verleitet
begang	RP	1	begangen
verleiten	VB	1	verleiten
beunruhige	NN	1	beunruhige
enthielte	NN	1	enthielte
Ware	NNS	1	Waren
feurige	NN	1	feurige
geteilt	NN	1	geteilt
hülflose	NN	1	hülflose
Frag	NN	1	Frag
gemangelt	NN	1	gemangelt
hintergangen	JJ	1	hintergangen
Entreissen	NN	1	Entreißen
unterscheiden	VB	1	unterscheiden
Schmeicheleien	NN	1	Schmeicheleien
geworden	JJ	1	gewordenen
wegnimmt	NN	1	wegnimmt
feierlichst	JJ	1	feierlichste
tyrannisiert	NN	1	tyrannisiert
verhärteten	NN	1	verhärteten
sterbende	NN	1	sterbende
Richtschnur	NN	1	Richtschnur
verlierest	NN	1	verlierest
Donnerschlag	NN	1	Donnerschlag
Ernste	NN	1	Ernste
Strasse	NN	1	Straße
geliebet	NN	1	geliebet
schönen	VB	1	schönen
Schüchternheit	NN	1	Schüchternheit
irdisch	JJ	1	irdische
Daseins	NN	1	Daseins
armselig	JJ	1	armselig
Richtig	JJ	1	Richtig
Gegenstande	NN	1	Gegenstande
mürrisch	JJ	1	mürrisch
Gleichwohlen	RB	1	Gleichwohl
beimess	DT	1	beimessen
Testamente	NN	1	Testamente
Frau	NN	1	Frau
verbannen	NN	1	verbannen
brachten	NN	1	brachten
Schlüssen	NN	1	Schlüssen
freundschaftlichsten	NN	1	freundschaftlichsten
Ändre	NN	1	Ändre
tod	NN	1	tod
zerfliesset	NN	1	zerfließet
scheint	JJ	1	scheint
Hör	NN	1	Hör
gerat	JJ	1	geraten
Übertretungen	NN	1	Übertretungen
verhärtete	NN	1	verhärtete
nachdem	RB	1	nachdem
Greise	NN	1	Greise
unterschiedenes	NN	1	unterschiedenes
Gegenliebe	NN	1	Gegenliebe
unbekanntes	JJ	1	unbekanntes
erschrock	JJ	1	erschrocken
Schein	NNS	1	Scheine
See	NN	1	See
Feier	NN	1	Feier
vergrössre	NN	1	vergrößre
vieles	NN	1	vieles
leihen	VB	1	leihen
vorziehen	VB	1	vorziehen
eilt	NN	1	eilt
nachfolgen	VB	1	nachfolgen
mind	JJ	1	minder
aufgeb	JJ	1	aufgeben
unsträflicher	PRP$	1	unsträflicher
Reizen	NN	1	Reizen
zaudern	VB	1	zaudern
Williams	NN	1	Williams
wichtigst	JJ	1	wichtigsten
hingehen	NN	1	hingehen
bleib	NN	1	bleib
besuchen	VB	1	besuchen
nichtswürdigst	JJ	1	nichtswürdigsten
Vollkommen	NN	1	Vollkommen
Städtchen	NN	1	Städtchen
Sanftes	NN	1	Sanftes
langsam	JJ	1	langsame
Flattergeist	NN	1	Flattergeist
lächeln	VB	1	lächeln
Sicherheit	NN	1	Sicherheit
Schnell	NNP	1	Schnell
Räuber	NN	1	Räuber
schlüpfrigsten	NN	1	schlüpfrigsten
weine	NN	1	weine
geschlagen	NN	1	geschlagen
befiehlt	NN	1	befiehlt
Woran	NN	1	Woran
Prozess	NN	1	Prozeß
Wand	NN	1	Wand
Weigern	NN	1	Weigern
Wann	NNP	1	Wann
Händeringen	NN	1	Händeringen
schleunig	JJ	1	schleunige
Mutterteil	NN	1	Mutterteil
irrst	NN	1	irrst
desjenigen	NN	1	desjenigen
Ihrentwegen	NN	1	Ihrentwegen
Mache	NN	1	Mache
anzuklagen	VB	1	anzuklagen
brauchte	NN	1	brauchte
einfällt	NN	1	einfällt
ausgeben	VB	1	ausgeben
Verbindungen	NN	1	Verbindungen
Verlang	NN	1	Verlangen
eigensinnigen	NN	1	eigensinnigen
sies	RB	1	sies
Geschöpfe	NN	1	Geschöpfe
Erinnerst	NN	1	Erinnerst
Knie	NN	1	Knie
Besuchs	NN	1	Besuchs
Schrecklichkeit	NN	1	Schrecklichkeit
hundertmalten	VBN	1	hundertmal
kurzen	NN	1	kurzen
schlechtern	VBN	1	schlechter
Aufruhr	NN	1	Aufruhr
Giftpulver	NN	1	Giftpulver
verteidiget	NN	1	verteidiget
Sanftmut	NN	1	Sanftmut
Todbette	NN	1	Todbette
vorstelltest	RP	1	vorstelltest
sammeln	VB	1	sammeln
gönnte	NN	1	gönnte
Drücken	NN	1	Drücken
Betauern	NN	1	Betauern
büssen	NN	1	büßen
Aas	NN	1	Aas
nachkomme	FW	1	nachkomme
Höherm	NN	1	Höherm
fruchtlosen	NN	1	fruchtlosen
Betäubung	NN	1	Betäubung
saur	JJ	1	saurer
sinken	VBN	1	sank
Schaffe	NN	1	Schaffe
Zeug	NNS	1	Zeuge
zurücklassen	NN	1	zurücklassen
schroffsten	NN	1	schroffsten
blicken	VB	1	blicken
brechen	VB	1	brechen
Bedeutung	NN	1	Bedeutung
ertappen	NN	1	ertappen
nenn	JJ	1	nennen
plagen	NN	1	plagen
erbricht	NN	1	erbricht
Verstossene	NN	1	Verstoßene
Ehrgeiz	NN	1	Ehrgeiz
Hirngespinst	NN	1	Hirngespinst
rufen	VB	1	riefen
Geschicklichkeit	NN	1	Geschicklichkeit
rollen	VB	1	rollen
nachzudenken	NN	1	nachzudenken
Aufschrift	NN	1	Aufschrift
parteiisch	JJ	1	parteiisch
armseligen	NN	1	armseligen
genauer	RP	1	genauer
umschliessen	NN	1	umschließen
hätt	NN	1	hätt
Undankbar	VB	1	Undankbare
Geschenk	NN	1	Geschenk
Hütte	NN	1	Hütte
zueilen	NN	1	zueilen
unabsehlich	JJ	1	unabsehliches
verzerren	NN	1	verzerren
Wenigstens	NN	1	Wenigstens
vermache	NN	1	vermache
Gerechter	NN	1	Gerechter
Gerechten	NN	1	Gerechten
zweifelhaften	NN	1	zweifelhaften
frostiger	NN	1	frostiger
bedächtiger	NNP	1	bedächtiger
daranen	VB	1	daran
ungesäumt	NN	1	ungesäumt
glühen	VB	1	glühen
Unglücklichen	VB	1	Unglückliche
erleben	VB	1	erlebe
lern	NN	1	lern
Vertraute	NN	1	Vertraute
trostlosen	NN	1	trostlosen
Überzeugung	NN	1	Überzeugung
Herumführen	NN	1	Herumführen
Unter	IN	1	Unter
erstechen	VB	1	ersticht
gültig	JJ	1	gültig
unglücklicher	NN	1	unglücklicher
Fordern	NN	1	Fordern
eingeschlossen	NN	1	eingeschlossen
giessen	VBN	1	gegossen
ausdrücke	NN	1	ausdrücke
blutig	JJ	1	blutige
verwahrloset	JJ	1	verwahrlosete
Aufmerksamkeit	NN	1	Aufmerksamkeit
übereilte	NN	1	übereilte
ängstigen	JJ	1	ängstigen
Geschlecht	NN	1	Geschlecht
wünschte	VB	1	wünschte
belohnen	VB	1	belohnen
Erfindungskraft	NN	1	Erfindungskraft
aufschlugen	NN	1	aufschlugen
entfliehen	VB	1	entfliehen
Aufsicht	NN	1	Aufsicht
sittlich	JJ	1	sittlichen
geringeres	NN	1	geringeres
inneres	NN	1	inneres
Erlaubnis	NN	1	Erlaubnis
Willkommen	NN	1	Willkommen
verfluche	NN	1	verfluche
rühren	VBN	1	gerührt
Eroberung	NNS	1	Eroberungen
Ferse	NN	1	Ferse
Verräterin	NN	1	Verräterin
Massen	NN	1	Maßen
vergeb	NN	1	vergeb
Misstrauens	NN	1	Mißtrauens
nachgedacht	NN	1	nachgedacht
nachbrausen	NN	1	nachbrausen
erholten	NN	1	erholten
vernünftig	JJ	1	vernünftig
zärtlichern	NN	1	zärtlichern
Trunkenheit	NN	1	Trunkenheit
vornehmsten	NN	1	vornehmsten
Gönnen	NN	1	Gönnen
hitziges	NN	1	hitziges
geirret	NN	1	geirret
Anschläge	NN	1	Anschläge
kürzern	NN	1	kürzern
stelle	NN	1	stelle
Niemand	NN	1	Niemand
gedrohet	NN	1	gedrohet
Schlaf	NN	1	Schlaf
Vermaledeite	NN	1	Vermaledeite
ankommen	VB	1	ankommen
zornigen	NN	1	zornigen
weichen	VB	1	weichen
Danksagung	NN	1	Danksagung
Ungewissheit	NN	1	Ungewißheit
verlernt	NN	1	verlernt
ungewisser	NN	1	ungewisser
Bewunderung	NN	1	Bewunderung
Überraschungen	NN	1	Überraschungen
Unwillen	NN	1	Unwillen
Vereinigung	NN	1	Vereinigung
betreffen	VB	1	betrifft
Zukünftige	NN	1	Zukünftige
ausstehen	NN	1	ausstehen
wärest	RB	1	wärest
lasst	WRB	1	laßt
füge	NN	1	füge
Streit	NN	1	Streit
Beweis	NN	1	Beweis
beunruhiget	NN	1	beunruhiget
Wollte	NN	1	Wollte
Hebt	NN	1	Hebt
Obstand	NN	1	Obstand
Ausweichung	NN	1	Ausweichung
abgelaufen	NN	1	abgelaufen
himmlisch	JJ	1	himmlische
aufspringen	RP	1	aufspringt
nichtigen	NN	1	nichtigen
leichtgläubig	JJ	1	leichtgläubige
Flamme	NNS	1	Flammen
Anfangs	NN	1	Anfangs
zwaren	VB	1	zwar
Niederträchtige	NN	1	Niederträchtige
billiget	NN	1	billiget
ists	NN	1	ists
trocknet	NN	1	trocknet
freilichen	VB	1	freilich
Nichtige	NN	1	Nichtige
ausgeschlagen	NN	1	ausgeschlagen
angeheftet	NN	1	angeheftet
zorniger	NNP	1	zorniger
beunruhigen	VB	1	beunruhigen
unterworfen	NN	1	unterworfen
dankbar	JJ	1	dankbare
wegreiseten	NN	1	wegreiseten
hierher	RP	1	hierher
Verschwindung	NN	1	Verschwindung
Angesichte	NN	1	Angesichte
Orte	NN	1	Orte
Besänftigung	NN	1	Besänftigung
Wind	NN	1	Wind
unzertrennlich	RB	1	unzertrennlich
trauest	NN	1	trauest
reiche	NN	1	reiche
Vogel	NN	1	Vogel
blühend	NN	1	blühende
Tyrann	NN	1	Tyrann
Grades	NN	1	Grades
schwarz	JJ	1	schwarzen
Endlichen	VBN	1	Endlich
Ton	NN	1	Ton
verwünschet	NN	1	verwünschet
darausen	RB	1	daraus
Adern	NN	1	Adern
Erschlagenen	NN	1	Erschlagenen
auszuforschen	VB	1	auszuforschen
Anstand	NN	1	Anstand
liebreichste	NN	1	liebreichste
unselige	PRP$	1	unselige
Leb	JJ	1	Leben
entbrechen	VB	1	entbrechen
Höhe	NN	1	Höhe
sinnreich	NN	1	sinnreich
Etwa	NN	1	Etwa
Versprechen	NN	1	Versprechen
Schuld	NN	1	Schuld
He	NN	1	He
Palaste	NN	1	Palaste
durchdrungen	NN	1	durchdrungen
Unwürdigkeit	NN	1	Unwürdigkeit
vertraulich	JJ	1	vertrauliche
vertat	NN	1	vertat
Gram	NNP	1	Gram
Grab	NN	1	Grab
schriebe	NN	1	schriebe
Faser	NN	1	Faser
Bankozettel	NN	1	Bankozettel
Lichte	NN	1	Lichte
o	DT	1	o
seltner	JJ	1	seltner
geringst	JJ	1	geringsten
Bess	JJ	1	Besser
missbrauchen	VB	1	mißbrauchen
Beruhigendes	NN	1	Beruhigendes
beneidenswürdigsten	NN	1	beneidenswürdigsten
entfärbt	NN	1	entfärbt
Unser	PRP$	1	Unser
Geschichte	NN	1	Geschichte
Billigkeit	NN	1	Billigkeit
Unmensch	JJ	1	Unmenschen
strafend	NN	1	strafende
allzufrei	JJ	1	allzufreien
anzutun	VB	1	anzutun
wag	NN	1	wag
verdriesslich	JJ	1	verdrießlich
Wirkungen	NN	1	Wirkungen
bestrafen	VBN	1	bestraft
rühme	NN	1	rühme
Blüte	NN	1	Blüte
Übertreibungen	NN	1	Übertreibungen
Morgenröte	NN	1	Morgenröte
unentbehrlich	JJ	1	unentbehrlich
leiden	VB	1	leiden
demütigen	VB	1	demütigen
hieren	RP	1	hier
eile	NN	1	eile
Bloss	NN	1	Bloß
Nuren	RB	1	Nur
erbrich	NNP	1	erbrich
leider	RB	1	leider
Weiss	NN	1	Weiß
reichere	NN	1	reichere
Dunkle	NN	1	Dunkle
stammelnde	NN	1	stammelnde
unbiegsame	NN	1	unbiegsame
weckten	NN	1	weckten
gemacht	VBN	1	gemacht
erspart	NNP	1	erspart
lösen	VB	1	lösen
Vorbeigehn	NN	1	Vorbeigehn
Entdecken	NN	1	Entdecken
Gefährlich	JJ	1	Gefährlich
albernes	NN	1	albernes
verharret	NN	1	verharret
gelangen	VB	1	gelangen
vorgeschriebn	NN	1	vorgeschriebnen
zurückreisen	NN	1	zurückreisen
nachsehen	VB	1	nachsehen
einzigern	VB	1	einziger
vergrössern	VB	1	vergrößern
einfältiger	NN	1	einfältiger
Vergleiche	NN	1	Vergleiche
ungernsten	NN	1	ungernsten
Weibsbildern	NN	1	Weibsbildern
Falls	IN	1	Falls
Vergleichs	NN	1	Vergleichs
erwähnt	JJ	1	erwähnte
erscheint	VB	1	erscheint
Erbteil	NN	1	Erbteil
legte	NN	1	legte
stiess	NN	1	stieß
vergebne	NN	1	vergebne
Solch	DT	1	Solche
Künste	NN	1	Künste
vollkommenste	NN	1	vollkommenste
zurechte	NN	1	zurechte
fortdauernden	NN	1	fortdauernden
ergehen	VB	1	ergehen
Erniedrigung	NN	1	Erniedrigung
verdächtig	JJ	1	verdächtig
grossmütige	NN	1	großmütige
darnach	RB	1	darnach
Weisen	NN	1	Weisen
Unbedachtsamkeit	NN	1	Unbedachtsamkeit
ofen	VB	1	oft
sieht	VB	1	sieht
behutsamste	NN	1	behutsamste
herzlich	JJ	1	herzlich
dringendes	NN	1	dringendes
Wiedererstattung	NN	1	Wiedererstattung
macht	RB	1	macht
verschwenden	VB	1	verschwenden
drehend	JJ	1	drehend
verliebe	NN	1	verliebe
nachsagen	NN	1	nachsagen
Gastwirt	NN	1	Gastwirt
Bestürmen	NN	1	Bestürmen
Zutritt	NN	1	Zutritt
Versprechens	NN	1	Versprechens
tugendhafter	NN	1	tugendhafter
Abschied	NN	1	Abschied
gedauert	NN	1	gedauert
wählen	RP	1	gewählt
Schwachheiten	NN	1	Schwachheiten
schwerlich	JJ	1	schwerlich
sorgsam	JJ	1	sorgsame
tugendhaften	NN	1	tugendhaften
Ruhiges	NN	1	Ruhiges
Ruhiger	NNP	1	Ruhiger
Rang	NN	1	Rang
Wahl	NN	1	Wahl
Zittre	NN	1	Zittre
Kreaturen	NN	1	Kreaturen
Roman	NN	1	Roman
verhängtem	NN	1	verhängtem
zuvorkommen	NN	1	zuvorkommen
vertrauteste	NN	1	vertrauteste
Erhalten	NN	1	Erhalten
bestellen	VBN	1	bestellt
Sachte	PRP$	1	Sachte
Groll	NN	1	Groll
Göttlich	JJ	1	Göttliche
locken	VB	1	locken
verschmähet	NN	1	verschmähet
Teilen	NN	1	Teilen
zurückweisen	VBN	1	zurückgewiesen
wiederholen	VB	1	wiederholen
Zufall	NN	1	Zufall
einzigen	VB	1	einzige
zuziehen	NN	1	zuziehen
Sittenlehre	NN	1	Sittenlehre
zuziehet	NN	1	zuziehet
Sonne	NN	1	Sonne
gähling	NN	1	gähling
Gütigkeit	NN	1	Gütigkeit
losgehen	VB	1	losgeht
vernünftige	NN	1	vernünftige
Ihretwegen	NN	1	Ihretwegen
sterbendes	NN	1	sterbendes
bange	NN	1	bange
Unschuldige	NN	1	Unschuldige
Entschuldigung	NN	1	Entschuldigung
Göttern	NN	1	Göttern
schmerzhaft	JJ	1	schmerzhaft
schaden	VBN	1	geschadet
Gemälde	NN	1	Gemälde
Nachtluft	NN	1	Nachtluft
stören	VBN	1	gestört
Seel	NN	1	Seele
gefühlet	NN	1	gefühlet
gewinne	NN	1	gewinne
liebte	NN	1	liebte
bleibt	VB	1	bleibt
gesollt	NN	1	gesollt
zurückgehalten	NN	1	zurückgehalten
aufhör	JJ	1	aufhören
darein	RB	1	darein
rettete	VB	1	rettete
Entzücken	NN	1	Entzücken
Fels	NNS	1	Felsen
heimsucht	NN	1	heimsucht
regen	VB	1	regt
Vermählung	NN	1	Vermählung
bezeigen	NN	1	bezeigen
Retten	NN	1	Retten
donnre	NN	1	donnre
andr	JJ	1	andre
Zeitlang	NN	1	Zeitlang
worüber	RB	1	worüber
Banden	NN	1	Banden
darunter	RB	1	darunter
Beteurungen	NN	1	Beteurungen
neugierig	JJ	1	neugierige
versuche	NN	1	versuche
anstehen	NN	1	anstehen
würdiger	NNP	1	würdiger
Schweiss	NN	1	Schweiß
sieben	CD	1	sieben
Lieb	NN	1	Liebe
zweifle	NN	1	zweifle
gestern	RB	1	gestern
erwachte	NN	1	erwachte
grässlichste	NN	1	gräßlichste
Einwilligung	NN	1	Einwilligung
Vollendung	NN	1	Vollendung
stolz	JJ	1	stolz
vornehmen	PRP$	1	vornehmen
Betrachte	NN	1	Betrachte
Sorte	NNS	1	Sorten
Geisel	NN	1	Geisel
versprech	NN	1	versprech
Mir	NN	1	Mir
Bliebe	NN	1	Bliebe
zerfliesst	NN	1	zerfließt
Gäste	NN	1	Gäste
gerührten	NN	1	gerührten
gleichgültigen	NN	1	gleichgültigen
befunden	NN	1	befunden
Trauriger	NNP	1	Trauriger
Warnend	JJ	1	Warnend
unwidersprechlich	JJ	1	unwidersprechlich
tötenden	NN	1	tötenden
Glaube	NN	1	Glaube
Pferde	NN	1	Pferde
Galanterie	NN	1	Galanterie
zärtlicher	NN	1	zärtlicher
Bebung	NN	1	Bebung
dienlich	JJ	1	dienlich
Fasen	NN	1	Fast
allerersten	NN	1	allerersten
abzufertigen	VB	1	abzufertigen
bessres	NN	1	beßres
Probe	NN	1	Probe
beschliessen	VBN	1	beschlossen
Schritten	NN	1	Schritten
lässt	VB	1	läßt
armselige	NN	1	armselige
buhlerhaftesten	NN	1	buhlerhaftesten
unwiderstehlich	JJ	1	unwiderstehliche
äussern	PRP$	1	äußern
wirksam	JJ	1	wirksam
vorweg	NN	1	vorweg
vortrefflichste	NN	1	vortrefflichste
berechtiget	NN	1	berechtiget
Begleitung	NN	1	Begleitung
besorgen	VB	1	besorgen
Bitterste	NN	1	Bitterste
erneuern	VB	1	erneuern
meiste	NN	1	meiste
Unparteilichkeit	NN	1	Unparteilichkeit
Betrübe	NN	1	Betrübe
nichtswürdige	NN	1	nichtswürdige
liebet	NN	1	liebet
giftige	NN	1	giftige
tadle	NN	1	tadle
ringst	NN	1	ringst
Torheit	NN	1	Torheit
Stoss	NN	1	Stoß
schlau	JJ	1	schlau
Äusserste	NN	1	Äußerste
ersuche	NN	1	ersuche
trotzig	JJ	1	trotzig
lieber	RB	1	lieber
umzugehen	NN	1	umzugehen
Triebe	NN	1	Triebe
gnädig	JJ	1	gnädig
Erkennen	NN	1	Erkennen
Beding	FW	1	Beding
stolze	NN	1	stolze
vors	NN	1	vors
Gelassenheit	NN	1	Gelassenheit
Vollziehung	NN	1	Vollziehung
spielet	NN	1	spielet
voraussagen	VB	1	voraussagen
Müsste	NN	1	Müßte
Erwartung	NN	1	Erwartung
abschlagen	NN	1	abschlagen
Eilfertigkeit	NN	1	Eilfertigkeit
knirschende	NN	1	knirschende
auftragen	NN	1	auftragen
Suche	NN	1	Suche
Morgens	NN	1	Morgens
bekömmt	NN	1	bekömmt
Ordnung	NN	1	Ordnung
dulden	VB	1	dulden
Mässigung	NN	1	Mäßigung
Melden	NN	1	Melden
Vorsatze	NN	1	Vorsatze
abzuwehren	VB	1	abzuwehren
Vergnügens	NN	1	Vergnügens
Sachen	NN	1	Sachen
Verborgnen	NN	1	Verborgnen
Finsternis	NN	1	Finsternis
unanständig	JJ	1	unanständig
Segne	NN	1	Segne
Theater	NN	1	Theater
zärtlichste	NN	1	zärtlichste
Schicksals	NN	1	Schicksals
Menschlichen	VB	1	Menschliche
Lauf	NN	1	Lauf
Höflichkeiten	NN	1	Höflichkeiten
Stand	NN	1	Stand
tadelt	NN	1	tadelt
ungültiger	NN	1	ungültiger
krümmet	NN	1	krümmet
schämte	NN	1	schämte
Ansehen	NN	1	Ansehen
Begriff	NN	1	Begriff
Langmut	NN	1	Langmut
öde	JJ	1	öde
längste	NNP	1	längste
Erinnerung	NN	1	Erinnerung
umsehen	NN	1	umsehen
liefern	VB	1	liefern
blind	JJ	1	blinden
widerspricht	NN	1	widerspricht
Raten	NN	1	Raten
beleidigten	NN	1	beleidigten
freundschaftlichste	NN	1	freundschaftlichste
murren	VB	1	murren
entbrech	JJ	1	entbrechen
Stellung	NN	1	Stellung
eingeschläfert	NN	1	eingeschläfert
dünkt	NN	1	dünkt
geseufzet	NN	1	geseufzet
sterblich	JJ	1	sterblichen
Atem	NN	1	Atem
schlagen	VB	1	schlägt
Prüfungen	NN	1	Prüfungen
Barbar	NN	1	Barbar
doppeln	VBN	1	gedoppelt
aufwären	NN	1	aufwären
anvertrauet	NN	1	anvertrauet
Schanze	JJ	1	Schanze
stolzen	NN	1	stolzen
ansehnlich	JJ	1	ansehnliche
fordern	VB	1	fordern
dienest	NN	1	dienest
bemerken	VB	1	bemerken
anvertrauen	VB	1	anvertrauen
bewährte	NN	1	bewährte
Stehen	NN	1	Stehen
ermorden	VB	1	ermorden
abreisen	VB	1	abreisen
Bewenden	NN	1	Bewenden
versüsst	NN	1	versüßt
nunen	VBN	1	nun
Närrchen	VB	1	Närrchen
heftigst	JJ	1	heftigsten
verstattete	NN	1	verstattete
Anstrengung	NN	1	Anstrengung
Fliehen	NN	1	Fliehen
Berührung	NN	1	Berührung
Bein	NNS	1	Beine
Mich	NN	1	Mich
Verlust	NN	1	Verlust
Erleuchtung	NN	1	Erleuchtung
Bescheidenheit	NN	1	Bescheidenheit
abzulegen	VB	1	abzulegen
unerkannt	NN	1	unerkannt
zutrauen	NN	1	zutrauen
lebhaft	JJ	1	lebhaft
gekannt	NN	1	gekannt
Abschwächung	NN	1	Abschwächung
Mitteln	NN	1	Mitteln
Flieh	NN	1	Flieh
falle	NN	1	falle
erbrach	NN	1	erbrach
unterhalt	JJ	1	unterhalten
gutherzigen	NN	1	gutherzigen
anzukündigen	VB	1	anzukündigen
Treten	NN	1	Treten
Sünder	NN	1	Sünder
Geduld	NN	1	Geduld
vergesse	NN	1	vergesse
Steht	VB	1	Steht
Lande	NN	1	Lande
Auskommens	NN	1	Auskommens
wahrscheinlicher	NN	1	wahrscheinlicher
Versüssung	NN	1	Versüßung
gemachten	NN	1	gemachten
Weh	NN	1	Weh
aufzudringen	NN	1	aufzudringen
Raub	NN	1	Raub
weitern	VBN	1	weiter
Zerfleischt	NN	1	Zerfleischt
kindisch	JJ	1	kindischen
Tadel	NN	1	Tadel
eigen	JJ	1	eigenen
zitterndes	NN	1	zitterndes
bekümmert	NN	1	bekümmert
unheilige	NN	1	unheilige
Diensten	NN	1	Diensten
erleichtern	VB	1	erleichtern
beurteilen	VB	1	beurteilen
bringet	NN	1	bringet
Alters	NN	1	Alters
grässlich	JJ	1	gräßlichen
Juweln	VB	1	Juwelen
raset	NN	1	raset
ehemalig	JJ	1	ehemaligen
mörderisch	JJ	1	mörderischen
Befreiung	NN	1	Befreiung
verachten	VB	1	verachten
erzürnet	NN	1	erzürnet
aufbietet	NN	1	aufbietet
stürmisch	JJ	1	stürmische
gen	IN	1	gen
verziehen	VB	1	verziehen
gegefühlt	NN	1	gegefühlt
segne	NN	1	segne
schreibet	JJ	1	schreibet
Gewissensbisse	NN	1	Gewissensbisse
widerstanden	NN	1	widerstanden
Grunde	NN	1	Grunde
Wohltaten	NN	1	Wohltaten
schamhafte	NN	1	schamhafte
herabströmen	NN	1	herabströmen
Joch	NN	1	Joch
bekam	JJ	1	bekam
schickte	NN	1	schickte
Sturms	NN	1	Sturms
eifrig	JJ	1	eifriger
Verlassen	NN	1	Verlassen
erkundiget	NN	1	erkundiget
freies	IN	1	freies
behutsam	JJ	1	behutsam
erkundigen	VB	1	erkundigen
Hieren	VBN	1	Hier
edelste	NN	1	edelste
betäubten	JJ	1	betäubten
schreien	VB	1	schrie
Gegenwärtige	NN	1	Gegenwärtige
Vorstellung	NN	1	Vorstellung
Erhaltungen	NN	1	Erhaltungen
zerrütteten	NN	1	zerrütteten
zugestossen	NN	1	zugestoßen
fortbegeben	NN	1	fortbegeben
Bewegung	NN	1	Bewegung
Stillschweigen	NN	1	Stillschweigen
barbarisch	JJ	1	barbarische
Fällen	NN	1	Fällen
kostbarern	JJ	1	kostbarer
verzeih	JJ	1	verzeihen
erstrecken	VB	1	erstrecken
austoben	NN	1	austoben
barmherzige	NN	1	barmherzige
Sagte	NN	1	Sagte
unordentlich	JJ	1	unordentlich
Anspruch	NN	1	Anspruch
Schwärmerin	NN	1	Schwärmerin
teurer	NN	1	teurer
Schwindel	NN	1	Schwindel
Wofür	NN	1	Wofür
entweder	CC	1	entweder
zugegen	NN	1	zugegen
versichert	NN	1	versichert
bestürzt	NN	1	bestürzt
Ihm	PRP	1	Ihm
Anrede	NN	1	Anrede
Glücks	NN	1	Glücks
jemanden	NN	1	jemanden
verdammt	JJ	1	verdammt
Kummers	NN	1	Kummers
herabgestossen	NN	1	herabgestoßen
willen	IN	1	willen
verdammen	VB	1	verdammen
Werk	NN	1	Werk
Fühlen	NN	1	Fühlen
Kuss	NN	1	Kuß
Wahrheiten	NN	1	Wahrheiten
aufführen	VB	1	aufführen
Ausrufung	NN	1	Ausrufung
offenherzig	JJ	1	offenherzig
Bett	NN	1	Bett
gewann	NNP	1	gewann
Kannst	NN	1	Kannst
Hässlichkeit	NN	1	Häßlichkeit
sterbenden	NN	1	sterbenden
zustellen	NN	1	zustellen
genugsam	JJ	1	genugsam
Nunmehr	NN	1	Nunmehr
andrer	NN	1	andrer
andres	NN	1	andres
gewünscht	VB	1	gewünschte
hoffe	VB	1	hoffe
Unverschämte	NN	1	Unverschämte
Betriegerin	NN	1	Betriegerin
dergleichen	PRP	1	dergleichen
Unmöglich	JJ	1	Unmöglich
Unterdessen	NN	1	Unterdessen
Gewebe	NN	1	Gewebe
barmherzig	JJ	1	barmherzigen
benommen	NN	1	benommen
Wisse	NN	1	Wisse
Inbrunst	NN	1	Inbrunst
glaube	VB	1	glaube
Vorhaben	NN	1	Vorhaben
Marwooden	VB	1	Marwood
Verdriesslichers	NN	1	Verdrießlichers
Abreise	NN	1	Abreise
eig	JJ	1	eigen
Gemahl	NN	1	Gemahl
Bisse	NN	1	Bisse
weihen	VBN	1	geweiht
Glossen	NN	1	Glossen
Vorsprecherin	NN	1	Vorsprecherin
geliebteste	NN	1	geliebteste
Vollmacht	NN	1	Vollmacht
Tragen	NN	1	Tragen
Quäker	NN	1	Quäker
herannahende	NN	1	herannahende
vorzukommen	VB	1	vorzukommen
verwunden	VB	1	verwunden
betrognen	NN	1	betrognen
Führerin	NN	1	Führerin
versäumen	PRP$	1	versäumen
besitze	NN	1	besitze
Richters	NN	1	Richters
verehren	VB	1	verehren
Liebst	JJ	1	Liebster
Mörders	NN	1	Mörders
schwächer	NNP	1	schwächer
erwachen	VB	1	erwachen
beredt	NNP	1	beredt
Anlasse	NN	1	Anlasse
Unsere	PRP$	1	Unsere
Wichtigkeit	NN	1	Wichtigkeit
verehre	NN	1	verehre
bewaffnet	JJ	1	bewaffneten
erhaltenen	NN	1	erhaltenen
berühren	VB	1	berühren
anfechten	VB	1	anfechten
Vergleichung	NN	1	Vergleichung
Meineidiger	NN	1	Meineidiger
gebären	VBN	1	geboren
Befehl	NNS	1	Befehle
Verfahren	NN	1	Verfahren
vertauschen	VB	1	vertauschen
tobt	NN	1	tobt
Schwäche	NN	1	Schwäche
schönste	NN	1	schönste
lebhaftesten	NN	1	lebhaftesten
Können	NN	1	Können
entstehen	VB	1	entstehen
herausgerissenen	NN	1	herausgerissenen
meinst	JJ	1	meinst
summen	VB	1	summen
Lesung	NN	1	Lesung
finsterer	NN	1	finsterer
damals	RB	1	damals
marterten	NN	1	marterten
Einzige	NN	1	Einzige
dienstfertig	JJ	1	dienstfertig
hinterliess	NN	1	hinterließ
Gebäude	NN	1	Gebäude
Geister	NN	1	Geister
Weibern	NN	1	Weibern
Ausdrückungen	NN	1	Ausdrückungen
teilhaftig	JJ	1	teilhaftig
neuen	VB	1	neue
gestossen	VBN	1	gestoßen
neuem	NN	1	neuem
grausamsten	NN	1	grausamsten
unerwartet	JJ	1	unerwartet
Geschäfte	NN	1	Geschäfte
geschlossen	JJ	1	geschlossenen
Beurteilung	NN	1	Beurteilung
konnte	VB	1	konnte
unglaublich	JJ	1	unglaublich
Erbteile	NN	1	Erbteile
Fremde	NN	1	Fremde
ungeschehen	NN	1	ungeschehen
liessen	NN	1	ließen
willigte	NN	1	willigte
Lehnstuhl	NN	1	Lehnstuhl
verfluchten	NN	1	verfluchten
pflege	NN	1	pflege
befördert	NN	1	befördert
aufbringen	VBN	1	aufgebracht
gesinnet	NN	1	gesinnet
gebeugtes	NN	1	gebeugtes
Kindes	NN	1	Kindes
getreuste	NN	1	getreuste
wahren	PRP$	1	wahren
verschmäht	NN	1	verschmäht
Eigennützigen	NN	1	Eigennützigen
Unbekannter	NN	1	Unbekannter
Führe	NN	1	Führe
solltest	RP	1	solltest
flohe	NN	1	flohe
tiefern	VB	1	tiefer
anständig	JJ	1	anständigen
Medea	NN	1	Medea
bemühen	VB	1	bemühen
trennten	NN	1	trennten
Glosse	NN	1	Glosse
Verruchter	NN	1	Verruchter
erziehen	VB	1	erziehen
Verächtlich	JJ	1	Verächtlich
jagen	VBN	1	gejagt
schwerern	VB	1	schwerer
misslingen	VB	1	mißlingen
gelockt	NN	1	gelockt
Eilt	NN	1	Eilt
fein	RB	1	fein
erstere	NN	1	erstere
rührend	JJ	1	rührend
Verwirrt	NN	1	Verwirrt
Neigung	NNS	1	Neigungen
Retterin	NN	1	Retterin
vermutete	NN	1	vermutete
Übel	NN	1	Übel
unvermutet	JJ	1	unvermuteter
geistlich	JJ	1	geistlich
Vaterland	NN	1	Vaterland
einlassen	VB	1	einlassen
ungehorsam	JJ	1	ungehorsam
rühmen	NN	1	rühmen
Ade	NN	1	Ader
wankte	NN	1	wankte
bitte	VB	1	bitte
zürnen	VB	1	zürnen
Zerreisst	NN	1	Zerreißt
abziehn	NN	1	abziehn
zugeeilet	NN	1	zugeeilet
vorzulassen	VB	1	vorzulassen
täglich	JJ	1	täglichen
fodern	NN	1	fodern
überzeugt	JJ	1	überzeugter
herausgebracht	NN	1	herausgebracht
versüssen	NN	1	versüßen
Gemahls	NN	1	Gemahls
unvermuteter	NN	1	unvermuteter
Musst	WRB	1	Mußt
besucht	JJ	1	besuchte
Wurm	NN	1	Wurm
Muttermörderin	NN	1	Muttermörderin
wiederholte	NN	1	wiederholte
rechnen	VB	1	rechnen
schönes	NN	1	schönes
Grausamen	NN	1	Grausamen
bereichern	VB	1	bereichern
gehört	VBN	1	gehört
Aussöhnung	NN	1	Aussöhnung
langwierig	JJ	1	langwierig
Spielern	NN	1	Spielern
Tropfen	NN	1	Tropfen
Aufwartung	NN	1	Aufwartung
gütiger	NNP	1	gütiger
Grausamer	NN	1	Grausamer
Dessen	WDT	1	Dessen
Unentschlossenheit	NN	1	Unentschlossenheit
melancholisch	JJ	1	melancholische
vorrechneten	NN	1	vorrechneten
getrost	NN	1	getrost
erinnert	NN	1	erinnert
durchgegangen	NN	1	durchgegangen
jenes	NN	1	jenes
grausamste	NN	1	grausamste
gelinde	NN	1	gelinde
Vermögens	NN	1	Vermögens
Reichern	NN	1	Reichern
hinzu	RB	1	hinzu
eigentlich	JJ	1	eigentlich
aufwachen	VB	1	aufwachen
wagten	NN	1	wagten
untersuchen	VB	1	untersuchen
Mördereisen	NN	1	Mördereisen
Gottes	NN	1	Gottes
unschuldigste	PRP$	1	unschuldigste
Madame	NN	1	Madame
anzuhören	VB	1	anzuhören
zitternd	NN	1	zitternd
Hafen	NN	1	Hafen
unverschämte	NN	1	unverschämte
Glaubst	NN	1	Glaubst
Alsdann	NNP	1	Alsdann
begleitend	JJ	1	begleitenden
unvollendeten	NN	1	unvollendeten
vergeissen	VB	1	vergißt
Zuckungen	NN	1	Zuckungen
Entsagung	NN	1	Entsagung
Fräulein	NN	1	Fräulein
Moor	NN	1	Moor
Nachteil	NNS	1	Nachteile
dienen	VB	1	dienen
anständiger	NN	1	anständiger
müsste	RB	1	müßte
erboten	NN	1	erboten
erwünschen	VBN	1	erwünscht
Habe	NN	1	Habe
te	NN	1	te
Parallel	JJ	1	Parallel
geziemen	IN	1	geziemen
wichtigern	VB	1	wichtiger
tödlich	JJ	1	tödliche
vereiteln	NN	1	vereiteln
richtig	JJ	1	richtig
Muss	NN	1	Muß
Wachend	JJ	1	Wachend
hinein	IN	1	hinein
beredte	NN	1	beredte
fall	NN	1	fall
Bleiben	VB	1	Bleiben
Lebenssatt	NN	1	Lebenssatt
wenigstensen	RP	1	wenigstens
gewahr	NNP	1	gewahr
sprich	NNP	1	sprich
eingeben	VB	1	eingeben
Schrecklich	JJ	1	Schreckliche
einfältig	JJ	1	einfältigen
grössern	NN	1	größern
erbitten	VB	1	erbitten
Oklaff	NN	1	Oklaff
frühst	NN	1	frühsten
viert	JJ	1	vierten
unbemerkt	NN	1	unbemerkt
gehenden	NN	1	gehenden
schwächen	VBN	1	geschwächt
missgönnen	NN	1	mißgönnen
unerfahrne	NN	1	unerfahrne
Falsch	NN	1	Falsch
Mangels	NN	1	Mangels
unterstehen	NN	1	unterstehen
ausweichen	VB	1	ausweichen
Jedes	IN	1	Jedes
Frevlerin	NN	1	Frevlerin
leid	JJ	1	leid
Verstehest	NN	1	Verstehest
erschüttern	VBN	1	erschüttert
verzweifelt	JJ	1	verzweifelt
irrte	NN	1	irrte
ging	VB	1	ging
entdecke	NN	1	entdecke
Barmherzigkeit	NN	1	Barmherzigkeit
fühlbar	JJ	1	fühlbar
Jahren	NN	1	Jahren
Bessrung	NN	1	Beßrung
sparen	VB	1	sparen
Empfinden	NN	1	Empfinden
tobende	NN	1	tobende
Wozu	NN	1	Wozu
übern	JJ	1	übern
verbitte	NN	1	verbitte
Auchen	VB	1	Auch
Bestürzung	NN	1	Bestürzung
reizenden	NN	1	reizenden
Verweise	NN	1	Verweise
erhalt	JJ	1	erhalten
bleibe	NN	1	bleibe
heilen	VB	1	heilen
Male	NN	1	Male
unreine	NN	1	unreine
rächen	VB	1	rächen
tändelnde	NN	1	tändelnde
Kunstgriffe	NN	1	Kunstgriffe
Deswegen	NN	1	Deswegen
Glückseligkeiten	NN	1	Glückseligkeiten
Besten	NN	1	Besten
verlieret	NN	1	verlieret
schweig	JJ	1	schweig
Ader	NN	1	Ader
Seinem	PRP$	1	Seinem
Sterbende	NN	1	Sterbende
Zwecke	NN	1	Zwecke
betrogene	NN	1	betrogene
reizen	VB	1	reizen
komm	NN	1	komm
eindränge	NN	1	eindränge
beigefallen	VBN	1	beigefallen
anlag	NN	1	anlag
merke	VB	1	merke
Folter	NN	1	Folter
herunter	RB	1	herunter
gelehrt	JJ	1	gelehrte
sündige	NN	1	sündige
schmeichelst	NN	1	schmeichelst
Bester	NN	1	Bester
zerreeissen	VB	1	zerreißen
ermatteten	NN	1	ermatteten
ausgeschüttet	NN	1	ausgeschüttet
befürchten	VB	1	befürchten
entreissen	NN	1	entreißen
redte	NN	1	redte
Geblüts	NN	1	Geblüts
Bedenklichkeiten	NN	1	Bedenklichkeiten
trösten	VB	1	trösten
gesetzmässiges	NN	1	gesetzmäßiges
Betrübte	NN	1	Betrübte
entzücken	VB	1	entzücken
übergehen	VB	1	übergehen
flassen	VB	1	fließen
gesunden	VB	1	gesunden
Wünschen	VB	1	Wünschen
anhören	VB	1	anhören
Mörderinnen	NN	1	Mörderinnen
Elender	NN	1	Elender
verscherzen	NN	1	verscherzen
zügelloses	NN	1	zügelloses
willkomm	JJ	1	willkommen
Schwierigkeiten	NN	1	Schwierigkeiten
Armes	NN	1	Armes
hastig	JJ	1	hastig
Setze	NN	1	Setze
koste	NN	1	koste
Widerwille	NN	1	Widerwille
entheiligest	NN	1	entheiligest
verrieten	NN	1	verrieten
ferner	RB	1	ferner
Tausch	JJ	1	Tausche
Denken	NN	1	Denken
Unwillens	NN	1	Unwillens
verschlingen	VB	1	verschlingen
beschleuniget	NN	1	beschleuniget
eilte	NN	1	eilte
nachteiligen	NN	1	nachteiligen
dickste	NN	1	dickste
lasterhaften	NN	1	lasterhaften
heiraten	VB	1	heiraten
kräftig	JJ	1	kräftig
hielte	NN	1	hielte
zeugen	VB	1	zeugen
eigennützig	JJ	1	eigennützig
treulose	NN	1	treulose
Geschehene	NN	1	Geschehene
Zufriedenheit	NN	1	Zufriedenheit
ihrentwegen	PRP$	1	ihrentwegen
Ehegattin	NN	1	Ehegattin
voran	RP	1	voran
Darüber	RB	1	Darüber
ablegten	NN	1	ablegten
warte	NN	1	warte
Unglaublich	NN	1	Unglaubliches
musste	RB	1	mußte
Verlässt	NN	1	Verläßt
ruchloser	NN	1	ruchloser
gehörigen	NN	1	gehörigen
Besorget	NN	1	Besorget
erlasse	WRB	1	erlasse
Unempfindlich	JJ	1	Unempfindlich
unverbrüchlichsten	NN	1	unverbrüchlichsten
gehorsame	NN	1	gehorsame
Beschämen	NN	1	Beschämen
Käfig	NN	1	Käfig
Landmädchen	VB	1	Landmädchen
bequemen	VB	1	bequemen
nachgekommen	NN	1	nachgekommen
Winke	NN	1	Winke
rechtschaffner	JJ	1	rechtschaffner
Besserm	NN	1	Besserm
nichtswürdigen	NN	1	nichtswürdigen
niederwirft	NN	1	niederwirft
Rat	NN	1	Rat
Schmeicheln	NN	1	Schmeicheln
Bessers	NN	1	Bessers
Lippe	NNS	1	Lippen
bewundert	NN	1	bewundert
Schlimmers	NN	1	Schlimmers
Sympathie	NN	1	Sympathie
Verbrechens	NN	1	Verbrechens
verlernen	VB	1	verlernen
abzuhelfen	VB	1	abzuhelfen
sagtest	RP	1	sagtest
eingehändiget	NN	1	eingehändiget
treulos	NN	1	treulos
Wirtshause	NN	1	Wirtshause
sichrer	NN	1	sichrer
anwendet	NN	1	anwendet
Geliebt	NN	1	Geliebt
nimmermehr	NN	1	nimmermehr
auszusetzen	NN	1	auszusetzen
Friedensboten	NN	1	Friedensboten
allerliebst	NN	1	allerliebst
Buchstabe	NNS	1	Buchstaben
Vielleichen	VBN	1	Vielleicht
Witwe	NN	1	Witwe
Schatz	NNS	1	Schätze
gesichert	NN	1	gesichert
Besserung	NN	1	Besserung
Ei	NN	1	Ei
Flüchtling	NN	1	Flüchtling
verstellen	NN	1	verstellen
schüttelst	NN	1	schüttelst
irren	VB	1	irren
raten	VB	1	raten
Henker	NN	1	Henker
Endlich	JJ	1	Endlich
fromm	JJ	1	frommen
Kränkungen	NN	1	Kränkungen
Dorkas	NN	1	Dorkas
freudigern	NN	1	freudigern
äusserst	JJ	1	äußerstes
Eigentlich	IN	1	Eigentlich
Erzählung	NN	1	Erzählung
verfehlen	VB	1	verfehlen
Ansprüche	NN	1	Ansprüche
nähern	PRP$	1	nähern
schmerzhaftere	NN	1	schmerzhaftere
Vorrechte	NN	1	Vorrechte
Entschlage	NN	1	Entschlage
Unsinnig	DT	1	Unsinnige
Raum	NNP	1	Raum
zurückeilen	NN	1	zurückeilen
vernehmlich	JJ	1	vernehmlich
geantwortet	NN	1	geantwortet
anderm	NN	1	anderm
allzugewohnt	NN	1	allzugewohnt
Zügel	NN	1	Zügel
Rechten	JJ	1	Rechten
Geringschätzung	NN	1	Geringschätzung
Gutes	NN	1	Gutes
stirb	NN	1	stirb
Unglücklichste	NN	1	Unglücklichste
vollkommen	JJ	1	vollkommen
Kunstgriffen	NN	1	Kunstgriffen
Mitten	NN	1	Mitten
Törichte	NN	1	Törichte
freue	NN	1	freue
innerlich	JJ	1	innerlichen
erniedrigende	NN	1	erniedrigende
überredet	NN	1	überredet
Fleiss	NN	1	Fleiß
abtrocknet	NN	1	abtrocknet
unterstanden	NN	1	unterstanden
Sterbenden	NN	1	Sterbenden
ungehalten	NN	1	ungehalten
weggenommen	NN	1	weggenommen
Meinigen	NN	1	Meinigen
Lage	NN	1	Lage
aufrichtigste	NN	1	aufrichtigste
seln	VB	1	selten
Bruder	NN	1	Bruder
Witz	NN	1	Witz
Nie	NN	1	Nie
gerühret	NN	1	gerühret
Traumes	NN	1	Traumes
Rechne	NN	1	Rechne
Bringe	NN	1	Bringe
weichherziges	JJ	1	weichherziges
unrecht	JJ	1	unrecht
entflamme	NN	1	entflamme
Neuigkeit	NN	1	Neuigkeit
schläft	NN	1	schläft
eisern	JJ	1	eiserne
hoff	JJ	1	hoffen
Aufenthalte	NN	1	Aufenthalte
Gründen	NN	1	Gründen
siech	JJ	1	siechen
Arten	NN	1	Arten
frühsten	NN	1	frühsten
mach	JJ	1	machen
Kreisbewegung	NN	1	Kreisbewegung
verlässt	NN	1	verläßt
grausamere	NN	1	grausamere
unbeweglich	JJ	1	unbeweglich
edler	NN	1	edler
vorgegangen	NN	1	vorgegangen
weltlich	JJ	1	weltlich
unseres	PRP$	1	unseres
Erfolg	NN	1	Erfolg
ermüdet	NN	1	ermüdet
Verwahrung	NN	1	Verwahrung
reuet	NN	1	reuet
Kleinmut	NN	1	Kleinmut
frisch	JJ	1	frische
Nutze	NN	1	Nutze
nachdenklich	JJ	1	nachdenkliche
Schmerzhaftes	NN	1	Schmerzhaftes
versteckten	NN	1	versteckten
verschweigen	VB	1	verschweigen
Ermanglung	NN	1	Ermanglung
hülflos	NN	1	hülflos
ungestümen	NN	1	ungestümen
grossmütiger	NNP	1	großmütiger
vollends	NN	1	vollends
bedanke	NN	1	bedanke
Titel	NN	1	Titel
verruchte	NN	1	verruchte
beruhiget	NN	1	beruhiget
rechtschaffne	NN	1	rechtschaffne
entwandtest	NN	1	entwandtest
vollenden	VB	1	vollenden
Zorne	NN	1	Zorne
Fort	NN	1	Fort
zerfliesse	NN	1	zerfließe
Argwohn	NN	1	Argwohn
schmerzlicher	NN	1	schmerzlicher
Weibsbild	NN	1	Weibsbild
eignem	NN	1	eignem
hingeben	NN	1	hingeben
eigner	NN	1	eigner
arg	JJ	1	arg
schmerzlichen	VBN	1	schmerzlich
Gnädiger	NNP	1	Gnädiger
Unsinniges	NN	1	Unsinniges
Königreiche	NN	1	Königreiche
schuldigen	VBN	1	schuldig
Stuhle	NN	1	Stuhle
Nichtswürdigem	NN	1	Nichtswürdigem
bemeistern	NN	1	bemeistern
liebenswürdigsten	NN	1	liebenswürdigsten
Gang	NN	1	Gang
Bewundrung	NN	1	Bewundrung
Anstössige	NN	1	Anstößige
unschätzbarste	PRP$	1	unschätzbarste
Rollen	NN	1	Rollen
immerwährendes	NN	1	immerwährendes
niedrige	NN	1	niedrige
sehne	NN	1	sehne
stehst	NN	1	stehst
Knechte	NN	1	Knechte
fortsetzen	VB	1	fortsetzen
blutdürstig	NN	1	blutdürstige
Rachsucht	JJ	1	Rachsucht
Unschuldigen	NN	1	Unschuldigen
warnender	NN	1	warnender
wünscht	JJ	1	wünschte
Leutseligkeit	NN	1	Leutseligkeit
schwören	VBN	1	geschworen
schwatzhafte	NN	1	schwatzhafte
Besonders	IN	1	Besonders
eilig	JJ	1	eilig
Schlafe	NN	1	Schlafe
voraussehen	VB	1	voraussehen
Leibe	NN	1	Leibe
Sünde	NN	1	Sünde
vorzustellen	VB	1	vorzustellen
Zusammenkunft	NN	1	Zusammenkunft
Kehre	NN	1	Kehre
erhaben	NN	1	erhaben
verurteilter	NN	1	verurteilter
erschalle	NN	1	erschalle
süssesten	NN	1	süßesten
erraten	NN	1	erraten
heute	VB	1	heute
antun	NN	1	antun
elender	NN	1	elender
wenigern	RP	1	weniger
beständig	JJ	1	beständig
sehren	VBN	1	sehr
Nachwelt	NN	1	Nachwelt
gewöhnlich	JJ	1	gewöhnliche
furchtsame	NN	1	furchtsame
Widersprich	NN	1	Widersprich
Liebhabers	NN	1	Liebhabers
raubten	NN	1	raubten
ärger	NN	1	ärger
sicherer	NN	1	sicherer
zuvorgekommen	NN	1	zuvorgekommen
eingenommen	NN	1	eingenommen
fürchterlichen	VBN	1	fürchterlich
Bitterkeit	NN	1	Bitterkeit
Raserei	NN	1	Raserei
Verdienst	NN	1	Verdienst
bluten	VB	1	bluten
Vermehrung	NN	1	Vermehrung
opfern	VBN	1	geopfert
heutig	JJ	1	heutigen
feilen	VB	1	feilen
Entdeckung	NN	1	Entdeckung
ansehe	NN	1	ansehe
feurigsten	NN	1	feurigsten
auflegen	VB	1	aufgelegt
gezaudert	NN	1	gezaudert
Ankläger	NN	1	Ankläger
wehmütiges	NN	1	wehmütiges
verdiene	NN	1	verdiene
obschon	IN	1	obschon
erbarmt	NN	1	erbarmt
Heftiges	NN	1	Heftiges
Gunstbezeigungen	NN	1	Gunstbezeigungen
Rate	NN	1	Rate
ungewiss	JJ	1	ungewiß
Unselige	NN	1	Unselige
Kenntnis	NN	1	Kenntnis
rase	NN	1	rase
schleicht	NN	1	schleicht
aufwachsen	NN	1	aufwachsen
Fand	NN	1	Fand
eingewurzelte	NN	1	eingewurzelte
stärken	VB	1	stärken
vollziehen	VBN	1	vollzogen
brächten	NN	1	brächten
Schmerzes	NN	1	Schmerzes
zittre	NN	1	zittre
schwärmten	NN	1	schwärmten
stärker	JJ	1	stärkere
später	RB	1	später
weinst	NN	1	weinst
Dein	NN	1	Dein
Irrwegen	NN	1	Irrwegen
reizend	JJ	1	reizend
reiben	VB	1	reiben
sanft	JJ	1	sanften
Plötzlich	RB	1	Plötzlich
triumphierend	JJ	1	triumphierend
Rettung	NN	1	Rettung
Führung	NN	1	Führung
Last	FW	1	Last
Huld	NN	1	Huld
Komme	NN	1	Komme
verirrten	NN	1	verirrten
Ob	IN	1	Ob
Stimmen	NN	1	Stimmen
Schämen	NN	1	Schämen
seufze	NN	1	seufze
niedergeschlagen	NN	1	niedergeschlagen
unausbleiblich	JJ	1	unausbleiblich
Gemahlin	NN	1	Gemahlin
vermeiden	VB	1	vermeiden
teil	RP	1	teile
Geliebten	NN	1	Geliebten
Ziele	NN	1	Ziele
hältst	WRB	1	hältst
Kenne	NN	1	Kenne
überführen	NN	1	überführen
grösstes	NN	1	größtes
wiedersehen	VB	1	wiedersehen
Unglückliche	RB	1	Unglückliche
Schiff	NN	1	Schiff
Wahrlich	JJ	1	Wahrlich
sorgen	VB	1	sorgen
Wunder	NN	1	Wunder
zurücklässt	NN	1	zurückläßt
kannten	NN	1	kannten
Bosheit	NN	1	Bosheit
allgemein	JJ	1	allgemeinen
seinetwegen	NN	1	seinetwegen
Dame	NN	1	Dame
Nehmen	VB	1	Nehmen
entgegenrausch	JJ	1	entgegenrauschen
Brett	NN	1	Brett
entwendet	NN	1	entwendet
Temperament	NN	1	Temperament
Tagen	NN	1	Tagen
ungestüm	NN	1	ungestüme
Teile	NN	1	Teile
Bild	JJ	1	Bilder
vorige	NN	1	vorige
erhebt	NN	1	erhebt
hitzig	JJ	1	hitzig
Sprich	NNP	1	Sprich
eingeschifft	NN	1	eingeschifft
Bilder	NN	1	Bilder
Tröstlichesen	VB	1	Tröstliches
ausdrücklich	RB	1	ausdrücklich
Verfassung	NN	1	Verfassung
anwende	NN	1	anwende
verleugnet	NN	1	verleugnet
schlimmste	NN	1	schlimmste
Starken	NN	1	Starken
argwöhnen	NN	1	argwöhnen
verderben	VB	1	verderben
weitläuftige	NN	1	weitläuftige
gröss	JJ	1	größer
ablassen	VB	1	ablassen
Ehrenstellen	NN	1	Ehrenstellen
verfahren	VB	1	verführen
Unstern	NN	1	Unstern
liege	NN	1	liege
vergassen	VB	1	vergaß
flohen	NN	1	flohen
vorbringen	VB	1	vorbringen
unverfolgt	JJ	1	unverfolgt
liegt	RB	1	liegt
betrogen	NN	1	betrogen
besonders	RB	1	besonders
treuloser	NN	1	treuloser
geheimnisvollst	JJ	1	geheimnisvollsten
erhört	NN	1	erhört
grausamern	VB	1	grausamer
tobet	NN	1	tobet
erlangen	VB	1	erlangen
unverdienten	NN	1	unverdienten
jungesen	VB	1	junges
nachdenkend	JJ	1	nachdenkend
Ansehung	NN	1	Ansehung
Frauenzimmern	VB	1	Frauenzimmer
glücklichst	JJ	1	glücklichste
Beibehaltung	NN	1	Beibehaltung
gestrigen	NN	1	gestrigen
Massregeln	NN	1	Maßregeln
gesehn	NN	1	gesehn
Überdrusse	NN	1	Überdrusse
Gesichtern	NN	1	Gesichtern
Verlegenheit	NN	1	Verlegenheit
gedoppelt	JJ	1	gedoppelt
empfindlichste	NN	1	empfindlichste
Beschäftigungen	NN	1	Beschäftigungen
Böse	NN	1	Böse
freiwillig	JJ	1	freiwilligen
ohnedies	RB	1	ohnedies
ungeschickten	NN	1	ungeschickten
endlichen	VBN	1	endlich
Erscheinung	NN	1	Erscheinung
mächtig	JJ	1	mächtig
Neu	JJ	1	Neues
alsoen	VB	1	also
Kostbarste	NN	1	Kostbarste
bewegte	NN	1	bewegte
vorgestellet	NN	1	vorgestellet
Stuhl	NN	1	Stuhl
Werke	NN	1	Werke
Versicherung	NN	1	Versicherung
Nachdenkend	JJ	1	Nachdenkend
Mal	NN	1	Mal
gesandt	NNP	1	gesandt
ungelesen	NN	1	ungelesen
behalt	VB	1	behalten
Itzo	NN	1	Itzo
bestrebt	NN	1	bestrebt
Beklemmung	NN	1	Beklemmung
unseligen	PRP$	1	unseligen
darfst	VB	1	darfst
Dadurch	RB	1	Dadurch
ungebraucht	JJ	1	ungebraucht
dächten	NN	1	dächten
wird	RB	1	wird
Ritter	NN	1	Ritter
ungeneigen	VBN	1	ungeneigt
Balsam	NN	1	Balsam
gehet	FW	1	gehet
nochmaliges	NN	1	nochmaliges
verknüpft	NN	1	verknüpft
einschlassen	VB	1	einschließen
dannen	VBN	1	dann
Anmerkung	NN	1	Anmerkung
verlöscht	NN	1	verlöscht
bleibst	NN	1	bleibst
beladen	VB	1	beladen
ersehen	NN	1	ersehen
Verschmähung	NN	1	Verschmähung
reizet	NN	1	reizet
schwere	NN	1	schwere
Geringste	NN	1	Geringste
Abgrund	NN	1	Abgrund
stärkte	NN	1	stärkte
verraucht	NN	1	verraucht
beweisen	VB	1	beweisen
Augenblicken	NN	1	Augenblicken
abgemattet	NN	1	abgemattet
Hab	NN	1	Hab
streicht	NN	1	streicht
Schlange	NN	1	Schlange
Schwerter	NN	1	Schwerter
Angesicht	NN	1	Angesicht
Verzögerns	NN	1	Verzögerns
neigen	RP	1	geneigt
abgehen	NN	1	abgehen
bleibet	NN	1	bleibet
ungerner	NN	1	ungerner
beliebt	NN	1	beliebten
führe	VB	1	führe
Blitz	NN	1	Blitz
Hierauf	NN	1	Hierauf
reich	JJ	1	reich
getretner	NN	1	getretner
grossmütig	JJ	1	großmütig
Kunst	NN	1	Kunst
finstere	NN	1	finstere
stünde	NN	1	stünde
unglücklichsten	NN	1	unglücklichsten
verstummst	NN	1	verstummst
Fast	NN	1	Fast
Zornig	RB	1	Zornig
Gemüte	NN	1	Gemüte
Schilderung	NN	1	Schilderung
Wichtigerm	JJ	1	Wichtigerm
prahlen	VB	1	prahlen
wachen	VBN	1	wach
Vetter	NN	1	Vetter
Hilf	NN	1	Hilf
hierh	JJ	1	hierher
entgegen	IN	1	entgegen
vertragen	VB	1	vertragen
Wunsch	NN	1	Wunsch
leg	JJ	1	legen
deucht	NN	1	deucht
lockten	NN	1	lockten
Arzeneien	NN	1	Arzeneien
Tiere	NN	1	Tiere
Einig	JJ	1	Einige
vergraben	VB	1	vergraben
umsiehst	NN	1	umsiehst
abzutrotzen	VB	1	abzutrotzen
überhin	NN	1	überhin
schiehen	VB	1	geschieht
vertraulichen	VBN	1	vertraulich
zulässen	VB	1	zuläßt
Belford	NNP	1	Belford
vorausbezahlt	JJ	1	vorausbezahlt
Flüche	NN	1	Flüche
demjenigen	NN	1	demjenigen
nachsetzte	NN	1	nachsetzte
schnellen	PRP$	1	schnellen
übeln	NN	1	übeln
fortfährt	NN	1	fortfährt
Frankreich	NNP	1	Frankreich
Hut	NN	1	Hut
Neubegierde	NN	1	Neubegierde
künftiges	NN	1	künftiges
zornig	JJ	1	zornigen
verhinderte	NN	1	verhinderte
Ehmaligen	NN	1	Ehmaligen
schön	JJ	1	schön
Angriff	NN	1	Angriff
verberg	JJ	1	verbergen
kehre	NN	1	kehre
Lehren	NN	1	Lehren
hielt	JJ	1	hielt
begreifen	VB	1	begreifen
Eindruck	NN	1	Eindruck
Gegen	IN	1	Gegen
ausgestreckt	NN	1	ausgestreckt
schmeicheln	VB	1	schmeichelt
läuft	VB	1	läuft
sauern	NN	1	sauern
eigennützige	NN	1	eigennützige
unverletzt	JJ	1	unverletzt
Versöhnung	NN	1	Versöhnung
Beschreibung	NN	1	Beschreibung
abgehalten	NN	1	abgehalten
Sonst	NN	1	Sonst
Pfandes	NN	1	Pfandes
kenne	VB	1	kenne
liebenswürdig	JJ	1	liebenswürdig
begriffene	NN	1	begriffene
Narrheit	NN	1	Narrheit
Streich	NN	1	Streich
schieben	VB	1	schieben
andersen	RB	1	anders
empfehlen	VB	1	empfehlen
Lebendigen	NN	1	Lebendigen
zurückwarfen	NN	1	zurückwarfen
Leuten	NN	1	Leuten
dafüren	VB	1	dafür
Anbetern	NN	1	Anbetern
Dasmal	RB	1	Dasmal
holde	NN	1	holde
wagte	NN	1	wagte
fuhr	VB	1	fuhr
Dochen	RB	1	Doch
auspresste	NN	1	auspreßte
Verstand	NN	1	Verstand
genau	RB	1	genau
Freilich	JJ	1	Freilich
hingehört	NN	1	hingehört
überstehen	NN	1	überstehen
hätten	RB	1	hätten
Abgott	NN	1	Abgott
worin	WRB	1	worin
Übergang	NN	1	Übergang
Feierliche	NN	1	Feierliche
Seufzern	NN	1	Seufzern
befindest	RB	1	befindest
aufstehen	VB	1	aufstehen
Aufzuopfern	NN	1	Aufzuopfern
zugerechnet	NN	1	zugerechnet
Angelobungen	NN	1	Angelobungen
Folge	NN	1	Folge
erkannte	NN	1	erkannte
Einwendung	NN	1	Einwendung
Meines	NN	1	Meines
vorbeistreich	JJ	1	vorbeistreichen
häufen	VB	1	häufen
rühmlich	JJ	1	rühmliche
unschuldige	PRP$	1	unschuldige
erblasste	JJ	1	erblaßte
leugne	NN	1	leugne
hinreichte	NN	1	hinreichte
verteidigen	VB	1	verteidigen
vertilgen	VBN	1	vertilgt
Küsten	NN	1	Küsten
Fragen	NN	1	Fragen
aufhöre	NN	1	aufhöre
Sind	VB	1	Sind
erträglicher	NN	1	erträglicher
Beute	NN	1	Beute
Womit	NN	1	Womit
waren	VB	1	waren
Forderung	NN	1	Forderung
Weigerung	NN	1	Weigerung
längsten	NN	1	längsten
Vortrefflich	JJ	1	Vortrefflich
schätzbarer	NN	1	schätzbarer
Weibsbilder	NN	1	Weibsbilder
trat	JJ	1	trat
aufzubringen	NN	1	aufzubringen
unbekannt	JJ	1	unbekannten
fröhlich	JJ	1	fröhlichen
gedenkt	NN	1	gedenkt
lachen	VB	1	lachen
aufzuopfern	NN	1	aufzuopfern
ziemlich	JJ	1	ziemlich
vorzuschlagen	VB	1	vorzuschlagen
grässlichsten	NN	1	gräßlichsten
itzigen	NN	1	itzigen
zurückgeblieben	NN	1	zurückgeblieben
Gefangener	VB	1	Gefangener
ungeduldige	NN	1	ungeduldige
Erscheint	NN	1	Erscheint
solchem	NN	1	solchem
Tröste	NN	1	Tröste
Zimmers	NN	1	Zimmers
matt	JJ	1	matt
Liebkosungen	NN	1	Liebkosungen
werdet	NN	1	werdet
Tut	NN	1	Tut
bergen	VBN	1	geborgen
ungenossene	NN	1	ungenossene
Tun	NN	1	Tun
Abgeschickter	NN	1	Abgeschickter
unüberschwenglich	JJ	1	unüberschwengliche
Golde	NN	1	Golde
Verdammter	NN	1	Verdammter
Vieles	RB	1	Vieles
geraten	VB	1	geraten
Meer	NN	1	Meer
Geständnisse	NN	1	Geständnisse
Versprechung	NNS	1	Versprechungen
Landstreichern	NN	1	Landstreichern
wovon	WRB	1	wovon
erzwungene	NN	1	erzwungene
Folg	JJ	1	Folgen
abzukürzen	VB	1	abzukürzen
troen	NN	1	getrost
geruhige	NN	1	geruhige
vergangne	NN	1	vergangne
herauf	NN	1	herauf
Pause	NN	1	Pause
Propheten	NN	1	Propheten
Narr	NN	1	Narr
Hasse	NN	1	Hasse
unentschlüssig	JJ	1	unentschlüssig
wunderlich	JJ	1	wunderliche
Warnung	NN	1	Warnung
folge	NN	1	folge
kehrtest	NN	1	kehrtest
erstaunen	VB	1	erstaunen
gekränkt	NN	1	gekränkt
gründe	NN	1	gründe
Mochte	NN	1	Mochte
anlächelt	NN	1	anlächelt
schuldigern	NN	1	schuldigern
ausgelernt	NN	1	ausgelernt
Verflucht	NN	1	Verflucht
dünken	VB	1	dünken
euer	PRP$	1	euer
allerelendeste	NN	1	allerelendeste
Verfluche	NN	1	Verfluche
brachte	VB	1	brachte
gerüstete	NN	1	gerüstete
verbarg	NNP	1	verbarg
fehlte	VB	1	fehlte
wohlgemeinte	NN	1	wohlgemeinte
gehofft	NN	1	gehofft
Anspielungen	NN	1	Anspielungen
vergnügtesten	NN	1	vergnügtesten
Darzwischenkunft	NN	1	Darzwischenkunft
Umgangs	NN	1	Umgangs
erkaltende	NN	1	erkaltende
ungeduldig	JJ	1	ungeduldig
weises	NN	1	weises
weiset	NN	1	weiset
verpflichten	VB	1	verpflichtet
unbesonnene	NN	1	unbesonnene
gelitten	NN	1	gelitten
ichs	NN	1	ichs
gesättiget	NN	1	gesättiget
Scherz	NNS	1	Scherze
hättest	WRB	1	hättest
Geschehenen	NN	1	Geschehenen
abgeredeter	NN	1	abgeredeter
vorenthalten	NN	1	vorenthalten
breche	NN	1	breche
wandelte	NN	1	wandelte
Schmach	NN	1	Schmach
Überfalle	NN	1	Überfalle
gefühlte	NN	1	gefühlte
vergiss	NN	1	vergiß
Teuerste	NN	1	Teuerste
erquickende	NN	1	erquickende
Vergebens	NN	1	Vergebens
Innersen	VB	1	Innersten
jemand	DT	1	jemand
fesselnden	NN	1	fesselnden
Ernst	NNP	1	Ernst
Geschöpf	NN	1	Geschöpf
verantworten	VB	1	verantworten
verderbt	NN	1	verderbt
fähig	JJ	1	fähig
elende	NN	1	elende
gelegentlich	RB	1	gelegentlich
geleg	JJ	1	gelegen
unerbittlich	JJ	1	unerbittlich
Kniee	NN	1	Kniee
Kordialpulver	NN	1	Kordialpulver
theologisch	JJ	1	theologischen
Ruf	NN	1	Ruf
fühlenden	NN	1	fühlenden
Jenen	RB	1	Jene
Werkzeug	NNS	1	Werkzeuge
mechanisch	JJ	1	mechanische
stündlich	JJ	1	stündlich
einsprechen	VB	1	einsprechen
nachziehen	VB	1	nachzieht
widerstehen	VB	1	widerstehen
Buche	NN	1	Buche
bezeigte	NN	1	bezeigte
wundre	NN	1	wundre
unüberlegte	NN	1	unüberlegte
Brauchen	VB	1	Brauchen
Glanze	NN	1	Glanze
Abschiedskompliment	NN	1	Abschiedskompliment
Paroxysmo	NN	1	Paroxysmo
abgemessen	NN	1	abgemessen
weinenden	NN	1	weinenden
Anhalten	NN	1	Anhalten
keines	NN	1	keines
Gebet	NNS	1	Gebete
ganzen	VB	1	ganze
Lieber	NN	1	Lieber
verlorne	NN	1	verlorne
Abzuge	NN	1	Abzuge
Unvorsichtige	NN	1	Unvorsichtige
Aufs	NN	1	Aufs
Blutgericht	NN	1	Blutgericht
Trocknen	NN	1	Trocknen
Donner	NN	1	Donner
spotten	VB	1	spotten
empfindungsloses	JJ	1	empfindungsloses
beruhe	NN	1	beruhe
übersehenden	NN	1	übersehenden
entübriget	NN	1	entübriget
Zufriednes	NN	1	Zufriednes
Fusses	NN	1	Fußes
bezaubert	NN	1	bezaubert
schleichen	RP	1	geschlichen
abzuziehen	VB	1	abzuziehen
durchkreuzen	NN	1	durchkreuzen
verhindern	VBN	1	verhindert
gemeinschaftlich	JJ	1	gemeinschaftliche
sehn	NN	1	sehn
Auftritte	NN	1	Auftritte
Kleinigkeiten	NN	1	Kleinigkeiten
unaussprechlich	JJ	1	unaussprechlich
hergebracht	NN	1	hergebracht
eingebildete	NN	1	eingebildete
Kleide	NN	1	Kleide
Gewissens	NN	1	Gewissens
mündlich	JJ	1	mündlich
lebe	VB	1	lebe
beschimpft	NN	1	beschimpft
prächtigsten	NN	1	prächtigsten
Kaltsinn	NN	1	Kaltsinn
klang	NN	1	klang
möchte	VB	1	möchte
überleget	NN	1	überleget
Scheusal	NN	1	Scheusal
Lob	NNS	1	Lobe
zulegen	NN	1	zulegen
herausrissen	NN	1	herausrissen
lasterhaft	NN	1	lasterhaft
verklagende	JJ	1	verklagende
Augenlidern	NN	1	Augenlidern
besinnen	VB	1	besinnen
Anverwandtin	NN	1	Anverwandtin
Verbrecher	NN	1	Verbrecher
schmeichle	NN	1	schmeichle
Liebeshandel	NN	1	Liebeshandel
mitgebracht	NN	1	mitgebracht
vorwerfe	NN	1	vorwerfe
gebe	NN	1	gebe
Belohnung	NN	1	Belohnung
unglücklichern	NN	1	unglücklichern
besänftigen	VB	1	besänftigen
schwankendes	NN	1	schwankendes
erfodert	NN	1	erfodert
widersetzen	NN	1	widersetzen
langsamres	JJ	1	langsamres
teuerst	JJ	1	teuerste
scherzen	VB	1	scherzen
Hätt	VB	1	Hätten
Verrichtungen	NN	1	Verrichtungen
Gedächtnis	NN	1	Gedächtnis
besänftiget	NN	1	besänftiget
schwankenden	NN	1	schwankenden
Könnten	NN	1	Könnten
göttlicher	RP	1	göttlicher
Rechnung	NN	1	Rechnung
Gespräch	NN	1	Gespräch
sowohl	RB	1	sowohl
wütender	NN	1	wütender
Stadt	NN	1	Stadt
Verwünschtes	NN	1	Verwünschtes
Gefangen	NN	1	Gefangener
ehmaligen	NN	1	ehmaligen
verwundetes	NN	1	verwundetes
trostsuchende	NN	1	trostsuchende
Besinnen	NN	1	Besinnen
mühsam	JJ	1	mühsame
Wollen	MD	1	Will
lasen	NN	1	lasen
strahlte	NN	1	strahlte
sitzen	VB	1	sitzt
förmlich	JJ	1	förmliches
Gespenst	NN	1	Gespenst
Musste	NN	1	Mußte
jammernde	NN	1	jammernde
zitterte	NN	1	zitterte
Kopf	NN	1	Kopf
weisere	NN	1	weisere
begebe	NN	1	begebe
Muskel	NNS	1	Muskeln
Ehrfurcht	NN	1	Ehrfurcht
schliesse	NN	1	schließe
Zittern	NN	1	Zittern
Lall	JJ	1	Lallen
ausgestanden	NN	1	ausgestanden
allzuviel	IN	1	allzuviel
Zweifels	NNP	1	Zweifels
mördrisch	JJ	1	mördrische
schändlich	JJ	1	schändliche
bahnen	VB	1	bahnen
rebellisch	JJ	1	rebellische
Stricken	NN	1	Stricken
Errötendes	NN	1	Errötendes
sichersten	NN	1	sichersten
freudige	NN	1	freudige
vermehren	VB	1	vermehren
Schaudern	NN	1	Schaudern
toben	VB	1	toben
Einem	NN	1	Einem
plötzlicher	JJ	1	plötzlicher
vorübergehn	NN	1	vorübergehn
Tocht	JJ	1	Tochter
einflössen	NN	1	einflößen
verfluchen	VB	1	verfluchen
Wallungen	NN	1	Wallungen
scheuen	VB	1	scheuen
sträflicher	NN	1	sträflicher
Liebhaber	NN	1	Liebhaber
einzugehen	NN	1	einzugehen
vorschlagen	VB	1	vorschlagen
geweissen	VB	1	gewiß
bereuen	VB	1	bereuen
Eigentum	NN	1	Eigentum
Eindrucke	NN	1	Eindrucke
Drum	NN	1	Drum
niederträchtige	NN	1	niederträchtige
wehmütiger	NNP	1	wehmütiger
Hauf	NN	1	Haufen
tödlicher	NN	1	tödlicher
gereichen	VB	1	gereichen
Gefühls	NN	1	Gefühls
ersuchen	VB	1	ersucht
Gabe	NN	1	Gabe
womit	WRB	1	womit
Wespe	NN	1	Wespe
ohnmächtigen	NN	1	ohnmächtigen
starren	PRP$	1	starren
losen	VBN	1	los
Eingeschmiedet	NN	1	Eingeschmiedet
erschrecklicher	NN	1	erschrecklicher
Danken	NN	1	Danken
unmerklich	JJ	1	unmerklich
zusammen	RB	1	zusammen
dreist	JJ	1	dreist
Allerliebst	NN	1	Allerliebst
vermissen	VB	1	vermissen
zwei	CD	1	zwei
geschriebenen	NN	1	geschriebenen
Verschiebung	NN	1	Verschiebung
Falten	NN	1	Falten
stritt	PRP$	1	stritt
floss	NN	1	floß
Lichtes	NN	1	Lichtes
nachgeben	VB	1	nachgeben
nahend	NN	1	nahenden
betäuben	NN	1	betäuben
Rätsel	NN	1	Rätsel
Schalk	NN	1	Schalk
Beschimpfung	NN	1	Beschimpfung
feurig	JJ	1	feurige
dunkl	JJ	1	dunkle
rührte	NN	1	rührte
oben	RB	1	oben
Geld	NN	1	Geld
rechtfertigen	VB	1	rechtfertigen
abgenommen	NN	1	abgenommen
Besorgnis	NN	1	Besorgnis
betauert	NN	1	betauert
Gleichnis	NN	1	Gleichnis
Erbin	NN	1	Erbin
lingen	VB	1	gelingt
anhöre	NN	1	anhöre
Vorsorge	NN	1	Vorsorge
Finden	NN	1	Finden
ansteckende	NN	1	ansteckende
mehren	RP	1	mehr
feurigen	NN	1	feurigen
hasst	NN	1	haßt
geheim	JJ	1	geheim
Flatterhaftigkeit	NN	1	Flatterhaftigkeit
Folgerungen	NN	1	Folgerungen
auspressten	NN	1	auspreßten
verzeiht	NN	1	verzeiht
richtigsten	NN	1	richtigsten
hängen	VB	1	hängt
Dem	DT	1	Dem
ha	NN	1	ha
seist	RP	1	seist
gestrafte	NN	1	gestrafte
Kläglichesen	VB	1	Klägliches
Vorsicht	NN	1	Vorsicht
seid	NN	1	seid
benehmen	VB	1	benehmen
verweinten	NN	1	verweinten
müsse	RB	1	müsse
geweinet	NN	1	geweinet
armseligste	NN	1	armseligste
sehnlichst	NN	1	sehnlichsten
hält	VB	1	hält
verschlossnen	NN	1	verschloßnen
manchmal	RB	1	manchmal
fortdauern	NN	1	fortdauern
Vaterteil	NN	1	Vaterteil
schmeichelhafte	NN	1	schmeichelhafte
Schläg	JJ	1	Schläge
Anbeter	NN	1	Anbeter
Geschmack	NN	1	Geschmack
Welle	NN	1	Welle
freundlich	JJ	1	freundliches
heftig	JJ	1	heftig
versiegelte	NN	1	versiegelte
blendend	JJ	1	blendenden
niemalsen	VBN	1	niemals
Buhlerinnen	NN	1	Buhlerinnen
geweihten	NN	1	geweihten
verzieh	NN	1	verzieh
Regeln	NN	1	Regeln
vermisst	NN	1	vermißt
spiele	NN	1	spiele
Dover	NN	1	Dover
schloss	NN	1	schloß
notwendig	JJ	1	notwendig
würdigern	NN	1	würdigern
Verbrecherin	NN	1	Verbrecherin
Verräterei	NN	1	Verräterei
