Title: Nathan der Weise
Number of all lemmas: 11154
Nummber of different lemmas: 4126

Lemma	POS	Frequency	Tokens
wohl	RB, RP, IN, JJ, VB, DT, PRP, NN	121	wohl, wird, das, der, auch, du, ja, doch, nun, besondre, annoch, Tags, selber, wißt, Nathan, Schwerlich, ihn, Sei, wirklich, ist, Lebt, namentlich, Ja, als, seid, solls, sie, da, merke, Muß, recht, er, dir
Nathan	NN, NNP, RB, WP, IN, DT, JJ, CC, PRP, VB, RP	90	Nathan, Ist, Wer, mit, Auf, wider, diesen, Doch, wahrlich, Aber, in, nun, es, Ihm, hätte, Nathans, Herr, mir, wieder, guter, doch, wartet, fragen, mich, Euch, Unglück, ungut, Beste, Vater, Dich, ändert, Unstreitig, sagen, möglich, meinetwegen, Wie
Gott	NN, NNP, IN, JJ, PRP$, PRP, VB, DT, UH	89	Gott, wenn, preise, bei, lieber, meinem, wir, vor, mit, ist, zu, schluchzte, Bei, Euch, Bruder, löset, o, Vater, Nun, lassen, Nach, sich, hieß, mehr
Vater	NN, NNP, DT, JJ, PRP, IN, PRP$	88	Vater, dem, Der, weise, ihr, Den, Rechas, der, zum, einen, Mein, dein, diesen, Diesen, andrer, mein, meinen, den, deinem, guter, deinen, Dein, Euer
Al-Hafi	NN, NNP, VB, IN, WRB	80	Al-Hafi, AL-HAFI, bleibt, sogleich, wo
gut	RB, JJ, VB, WP, PRP, NNS, NN, PRP$, DT, IN, RP, CC, WDT	78	gut, guter, gute, guten, nur, so, welcher, du, Kohlen, Es, Recht, Ihr, Euer, Das, Der, Dem, deinen, ein, zu, nochmals, ists, die, und, Meine, diese, Die, meine, So
Bruder	NN, DT, PRP$, PRP, JJ, IN, RB, WDT	67	Bruder, Den, mein, arme, ich, frommer, Kommt, guter, als, ihr, Buche, nicht, ein, Ein, dieser, ihrem, den, Mein, Sittah, es, Ihr, Rechas, einen, keinen, Tochter
sagen	VB, VBN, RB, RP, PRP$, TO, WP, PRP, IN, NN	62	sagen, sagt, sage, gesagt, Zu, wohl, so, Wer, zu, mir, Er, wie, Ihr, noch, lassen, Euch, Ich
mussen	VB, VBN, PRP, NN, RB, DT, UH	61	muß, mußtet, suchen, Ich, vergleichen, tut, ich, Mädchen, Nathan, andrer, Nur, Du, weiter, scheinen, sein, sie, alles, es, So, Christin, Nun, Trotzkopf
Jude	NN, NNS, DT, IN, JJ, WDT, VB	59	Jude, Juden, Dem, ein, erst, gemeiner, keinem, diesem, alle, Zum, reichen, der
Saladin	NN, IN, DT, RP, MD, CC, PRP	59	Saladin, SALADIN, zum, Vor, die, also, Den, Will, als, Und, mich, daß, aber, alles, Halt, ich
gar	RP, RB, IN, CC, PRP, VB, NN, WP, NNS, JJ	55	gar, und, sich, ja, doch, einmal, ich, Doch, nur, etwa, vermeine, Was, Christen, es, wohl, ist, Wohl, Recha, Auch
lieb	VB, JJ, NN, DT, PRP, RB, IN	51	lieber, liebes, lieb, lieben, liebe, wackrer, der, Die, Mädchen, Ich, ein, so, Laßts, zu, errötest, guten, Komm
Patriarch	JJ, NN, VB, DT, IN, PRP$	48	Patriarchen, Patriarch, des, zum, der, Der, Vom, Die, Euern, Beim, kein, seinem, Zum, Dem
gern	RP, RB, IN, VB, WRB, NNS, PRP, NN	48	gern, Feinde, Er, nicht, Zu, zu, wie, Recht, auch, Sehr, so, Nicht, Ich, ausgehalten, ihm
weeissen	VB, PRP, WP, DT, NN, RB, CC	46	weiß, Ich, wer, Der, Wer, ich, Sache, viel, niemand, Er, Und, Noch, Munde
wär	NN, DT, JJ, PRP, NNS, IN, CC, WP, RB	46	wär, Das, möglicher, Mir, Es, Juden, So, Und, was, Lächeln, würdig, Sonst, Denn, anders, Verdacht, Bruder
Mann	NN, NNP, JJ, DT	44	Mann, junger, Ein, Den, offner, braver, einen
Christ	NN, NNS, IN, JJ, DT, RB, VB	44	Christ, Christen, Als, ruhig, der, den, Ruhig, ein, unter, Wenn, die, beßrer, zum, dem, einen, gefehlt
erst	VB, JJ, RP, RB, IN, PRP, NN, DT, VBN	43	erste, ersten, erst, ich, Seit, mir, Zutrauns, sich, erkunden, Mich, du, Tempelherrn, der, den, ein, Abulkassem, Das, Die, kam
sehn	NN, IN, JJ, PRP, VB	39	sehn, Armut, Doch, zu, selbst, ihn, Verschwenden, Zu, wandeln
Sultan	NN, JJ, DT, CC, VB, UH, IN, RB, RP	37	Sultan, den, Gefangner, Aber, Tochter, schämen, Nachricht, Freude, Nun, gewöhnen, zum, Der, lassen, Diensten, ja
Recha	NN, IN, PRP, NNS, NNP	36	Recha, für, liebt, Ich, Läßt, Arme, sich, dir, Füßen, Blanda, Eure
sonst	IN, RB, RP, NN, PRP, CC, WP, NNS, DT	36	sonst, wenig, Wohl, Wenn, Mädchen, oder, noch, ja, denn, jemals, es, Und, wohl, wer, Herzen, keiner, er, auch
hören	VB, PRP, RB, NN, TO	34	hören, hört, hörte, hörst, höre, er, ich, nur, Denn, Nathan, Laßt, du, Du, zu
bald	RB, IN, WRB, RP, NN	34	bald, So, so, blieb, Doch, viel, Augen, Himmel
wahr	RP, RB, JJ, DT, NN	33	wahr, wahre, nicht, viel, Nicht, die, ists, Sehr, Auch
hab	NN, PRP, IN, VB, WP, JJ, DT	33	hab, ich, so, Euch, Noch, darauf, Ich, Was, Patriarchen, Das, So
Ah	NN, RB, VB	33	Ah, Bruder, ausritt, allein, Mädchen, preßt, Tat, Vater, rufen, Geschwister, Geh, Buche
Herr	NN, NNP, DT, RP, PRP, JJ, PRP$	32	Herr, der, wahr, mich, Sogleich, itzt, Der, ein, lieber, unser
nie	IN, RB, RP, NN, PRP, VB, CC	31	nie, mirs, habe, Lande, mich, war, oder, es, ich, Bösen, Euch, besitzen, und, mir
allein	RB, RP, IN, CC, DT, MD, PRP, NN	31	allein, und, so, nicht, Dem, soll, mich, die, ich, Wert, du, ganz, bins, sie, Weg, Allein, Blut
kömmen	MD, PRP, RB, WP, NN, VB	30	kömmt, kömmst, er, So, Wer, es, Kahira, Was, melden, Bruder, Nathan
Sittah	NN, IN, VB, JJ, RP, PRP	30	Sittah, zu, unternommen, Gelt, Prinzessin, Nein, holen, sie, bei, Mich, gelesen, Auch, Vor, Vater, hier, Erlauben, halt, es
rechen	VB, VBN, JJ, RB, PRP, NN, CC	30	rechte, recht, so, schon, doch, mir, Ganz, und, Doch, ihm
Daja	RB, IN, PRP, JJ	29	Daja, Von, mir, böse, Denn
Geld	NN, NNP, DT	28	Geld, das, Dein
eben	RB, IN, RP, NN, PRP, CC	27	eben, Wohl, Brautkleid, Nicht, nun, nur, Auch, mir, und, Nur
Mädchen	NN, DT, JJ	27	Mädchen, Das, Ein, Dies, das, ein, fremde, arme, süßes, liebes
denken	VB, PRP$, RB, TO, NN, PRP	26	denken, dachte, denkt, denke, nicht, Ihr, zu, mir, noch, Euch, du
geh	NN, CC, NNP	26	geh, Aber, Und, Geh, Liebe
Menschen	NN, JJ, DT, PRP, WDT	26	Menschen, aller, Den, den, Es, denselben
Wohl	RB, IN, WRB, RP, NN, VB	26	Wohl, zurück, Mag, nun, war, wißt, nie, Stauffin, doch, ja, wähnt, genug, indes, kennst
sprechen	VB, VBN, NN, DT, PRP, RB, TO, IN	25	sprechen, sprach, gesprochen, möge, Aussicht, Man, Euch, Sie, selber, Zusammen, sie, zu, ihn, Er
Tempelherr	NN, JJ, DT, VB	25	Tempelherr, Tempelherren, der, Der, war, ein, Ein, Laienbruders
selb	DT, PRP, JJ, VB, NN, RB	25	selber, mich, ich, könnte, Vorsicht, sich, nicht
freilich	RB, RP, IN, WRB, UH, NN, PRP, PRP$	25	freilich, Nun, daran, Ei, nun, mich, Sich
seid	NN, PRP$, CC	25	seid, Ihr, Und
wenig	IN, RB, NNP, PRP, DT, VB, NN	24	wenig, so, dir, Nur, ein, von, daß, zu, Ein, Zu, Sittah, So, immer
kennen	VB, JJ, RB, WP, PRP$	24	kennen, kenne, kennt, besser, So, wer, zuverlässig, Wer, Ihr
Ritter	NN, NNP, JJ, PRP, RP	24	Ritter, Herr, zufrieden, es, Natürlich
Allein	NN, RP, VB, JJ, DT, WP, PRP	24	Allein, gern, kam, zürn, dem, Welt, Euch, Einfalt, was, Gegenteil, wahr, Geheiß, dir
glauben	VB, PRP, JJ, RB	24	glaubte, glaubt, glauben, glaube, glaubst, Ich, es, fromme, nie
ichs	NN, NNP, FW, RB, VB, IN, WP	24	ichs, kenn, bring, weil, kann, werd, gern, welchem, Warum, bin
Herz	NN, NNS, JJ, DT, NNP, PRP$	23	Herz, Herzen, ein, rasches, Sprich, Mein, dein, deinem, sein, Sein
sehen	VB, NN, RB	23	sahen, sehen, seht, sieht, sah, Ei, Denn, wohl
Liebe	NN, VB, PRP$, PRP, MD, IN	23	Liebe, brauchen, siebenfache, unsrer, dir, wollen, aus, deine, Komm, geh
Freund	NN, JJ, NNP, NNS, PRP$	23	Freund, Freunde, mein, meiner, Gestürzte, ihre, lieben, Euer
Schwester	NN, JJ, PRP$, DT, PRP	22	Schwester, ältern, Sultans, deine, albern, meiner, meine, eine, du
Zeit	NN, JJ, IN, PRP$	22	Zeit, ganze, kurze, immer, seiner, selben
wissen	VB, RB, PRP, IN, TO	22	wissen, bringen, nicht, Sie, zu, nun, Nicht, Noch
itzt	DT, PRP, JJ, CC, RB, NN	22	itzt, ich, einziger, mir, weder, eben, Verleitet
Dank	RP, IN, NN, JJ, RB, VB, CD, DT, PRP	22	Dank, Sultan, Besondern, stolz, Doch, Habt, sei, tausend, Habe, vielen, spät, Patriarchen, ihm, wofür
seiner	PRP$, NN, IN, RB	22	seiner, Schwester, Jüngling, nach, wohl, mit, zu, Auf, An
Geh	NN, VB, PRP, MD	22	Geh, weisen, dürfen, Klosterbruder, wäre, du, Liebe, wollen
Eure	NN, JJ, IN, VB, UH, DT, RB	21	Eure, einmal, ist, Nun, Denn, Dem, Nicht
soen	RB, VB, NN, PRP$	21	so, Hochehrwürden, weiß, Ha, Ihr, Euch, Mich, erhört, Rechts
habt	NN, PRP$, CC, IN	21	habt, Ihr, Und, Noch
Derwisch	NN, DT	21	Derwisch, Den
Ring	NN, NNS	21	Ring, Ringe
Euer	NN, JJ, IN, CC, VB	21	Euer, auf, als, und, Euch, schaffen, War
dochen	VB, RB, VBN, NN	21	doch, Sieh, aber, ichs, Steh, wiegte
ists	NN, WP, IN, PRP	21	ists, Tod, Was, Wie, so, Denn, Auch, Wer, So, Er
retten	VB, VBN, RP, NN, PRP, IN	21	rettete, retten, gerettet, Euch, du, zu
Sei	NN, UH, MD, JJ, VB, NNP, DT	20	Sei, Nun, sollen, ihm, rege, befragen, nötig, Mädchen, schüchtern, das, getauft, verspreche, Genug, heiter
Tochter	NN, PRP$, DT, JJ	20	Tochter, Nathans, seine, vermeinte, der, Der, Eure, meine, meiner
hätt	NN, WP, DT, PRP	20	hätt, Was, nachgegeben, das, Drohen, Er
Engel	NN, DT	20	Engel, einen
Recht	NN, IN, JJ, RP	19	Recht, für, Christentöchterchen, lauft, viel, erste, Vater, Gewünscht, Mit
Komm	NN, NNP, VB, IN, PRP, VBN, JJ	19	Komm, sprich, Wohlan, sprechen, Trotz, so, Hut, ihr, verspricht, gewesen, du, Mädchen, rechnen, Herz
Ei	NN, IN, RP, RB	19	Ei, allerdings, ein, mehr, wenig, Sultan
Kind	NN, NNP, CC, DT, PRP, PRP$	19	Kind, und, das, Das, arme, Luft, Gutes, dir, mein
Mensch	NN, JJ, DT	19	Mensch, gottergebne, Der
Lass	NN, JJ	18	Laß, Sittah, Bruder, Seele, hadern, Getrost, Erwerben
Wunder	NN, JJ, DT	18	Wunder, kein, manches
Leben	NN, NNP, DT, PRP$, JJ	18	Leben, das, mein, ganzen
Welt	NN, DT, JJ	18	Welt, der, ganzen, die
gewiss	NN, JJ, NNP, IN	17	gewiß, gewissen, nun, von, Nein, ganz
finden	VB, RB, VBN, NN, JJ, TO, PRP	17	finden, fand, gefunden, geht, Nathan, fleißig, zu, Bruder, sie
bloss	RB, IN, RP, JJ, NN, PRP	17	bloß, bloße, Feuerkohlen, ihm
nennen	VB, PRP$, NN	17	nennen, nennt, nannte, nennst, nennte, Drum, Meine
nuren	RB, RP, VB, VBN, NN	17	nur, Laß, Komm, gebe, Euch, fahr, Mutter
wahrlich	JJ, UH, NN, CC, PRP, RB	16	wahrlich, Nun, Nathan, Aber, mir, Doch, Ei
deiner	PRP$, IN, PRP, RB, NNP	16	deiner, An, Es, auf, nicht, spottest, daß
klein	JJ, RB, DT, NN, IN, PRP$	16	kleines, klein, kleinen, Den, Kein, Wie, so, deiner
Ha	NN, RP, VB	16	Ha, gefunden, Bote, Hause, Klosterbruder, verraten, kommen
Volk	NN, NNP	16	Volk
lange	RB, IN, PRP, NN, PRP$	16	lange, Wie, sie, Macht, ich, Ihr
nehmen	VB, VBN, PRP, NN, JJ, IN	16	nehmen, sich, mir, Hierbei, stehlen, ich, Nur, Zu
Sache	NN, DT, IN, PRP$	16	Sache, die, zur, Wes, deiner, der
weit	JJ, IN, RB, NN	16	weit, weitem, wie, zu, Weit
Gut	NN, JJ, VB, DT, IN	16	Gut, Gute, Guter, irren, Allein, Das, da, Gekommen
stehen	VB, RB, PRP, NN, IN, JJ, UH	16	stand, steht, stehe, stehen, Es, Auge, Ich, Da, Gang, Plötzlich, Nun
jung	JJ, DT, NN, RP, RB	16	junger, jung, junge, jungen, Dem, braver, Nein, willst, schöner, Ein, ein, So, wieder
willst	WRB, RP, RB, NN, VB, PRP	15	willst, Du, sein, nur, du
Hand	NN, JJ, DT, PRP$	15	Hand, die, zweite, Selbsteigner, Vaters, seine
Herrn	JJ, NN, DT	15	Herrn, braven, Euern, selgen, des
Schach	NN, JJ	15	Schach
Dajaten	RB, VB, NN	15	Daja, Mir, Närrin
Feuer	NN, JJ, IN	14	Feuer, ins, im
wisst	NN, PRP$, VB	14	wißt, Ihr, hatten
fragen	VB, RP, NN, IN, RB	14	fragen, fragt, gefragt, Dich, Zu, wohl
heuen	RB, VB, VBN, DT	14	heut, Erst, jemand, nur, auch
hast	NN, IN, VB	14	hast, Dus, Wie, begriffen, So, Da, Mansor, Du
heeissen	VB, TO, RB	14	heißen, heißt, heiße, heißet, zu, noch
Sieh	NN, VBN, VB	13	Sieh, Orten, Assad, worden, Geduld, sein, stünde, Sittah
Wort	NN, NNS, DT	13	Wort, Worte, Ein, Einem, ein
brauchen	VB, VBN, NN, RB	13	braucht, brauchen, Patriarch, Kinder, noch, dazu, nicht, Nicht
weniger	RB, VB, RP, IN	13	weniger, nicht
kurz	JJ, IN, PRP, NN, RB	13	kurz, Vor, Es, Mutter, zu, Zu, so, Sprach, Euch, Auf
leben	VB, VBN, RB, PRP, NN	13	lebt, leben, lebte, nicht, er, Wette
nimm	NN, IN, CC, RB, DT	13	nimm, Mach, So, Da, Und, Mansor, gern, beide
besser	RP, RB, IN, PRP, NN, DT	13	besser, viel, Es, Desto, alles
meines	NN, IN, PRP, JJ	13	meines, in, wenig, Er, Bruders, Ich, beide, Assad
Stauffen	NN, IN, JJ	13	Stauffen, von, kein
fromm	JJ, VB, NN, CC, DT, IN, RB	13	fromme, fromm, frommer, Diensten, und, Der, die, An, so
oft	IN, RB, WRB, CC, PRP	13	oft, und, mich, so
auchen	VB, RB, NN	13	auch, Schläft, nicht, Verliert, Lieb, Kerl
Euern	NN, IN, DT, JJ	13	Euern, zu, Ja, Vor, In, diesem, Der, schwerlich, auch
Hafi	NN	13	Hafi
kaum	RB, RP, IN, DT, PRP, VB, NN	13	kaum, selber, ich, kann, Kannst, macht
seines	PRP$, NNS	13	seines, Launen, Ihr
wem	WP, IN, RB, VB, CC	13	wem, mit, oder, wissen, Und, Was, Vor
lass	JJ, VB, PRP, CC, RB, NN	12	laß, lasse, ich, und, so, streiten, Gut
best	JJ, IN, DT	12	besten, beste, Im, am, die
genug	RP, RB, NN	12	genug, nicht, wert, Schlimm
weisen	VB, PRP$, NN, RP	12	wies, weisen, Dich, aus, Sei
ewig	JJ, IN, NN	12	ewig, ewige, ewigen, ins, auf, Abglanz
komm	NN, PRP	12	komm, Er
Tag	NN, DT, PRP, IN, CD	12	Tag, einen, ich, für, wenig, drei
andern	DT, JJ, IN	12	andern, dem, keiner, einem, jemand, Mit
Seele	NN, JJ	12	Seele, meiner, ganze
verlangen	VBN, VB, RB, PRP, NN	12	verlangt, verlangen, nie, dir, Königin, sein
Hört	NN, RP, IN, VB, DT, JJ	12	Hört, an, Wie, Sittah, Erlogen, können, bleiben, das, Gute
eins	CD, IN, PRP	12	eins, Mit, ihm
Gewiss	UH, JJ, VB, RB	12	Gewiß, Gewisse, gehört, ganz
Christin	NN, DT, IN	11	Christin, die, Als, eine, Die, Eine
niemand	DT, RB, CC	11	niemand, Nur, Und
Sohn	NN, NNS, PRP$	11	Sohn, Söhne, mein, Mein, Assads
deinen	NN, IN, VB	11	deinen, Zu, für, zu, habe
bitten	VB, PRP$, PRP	11	bittet, bitten, bitte, er, hören
läng	JJ, PRP, RB	11	länger, Ich, uns, noch
Sagen	VB, VBN, RB, WDT	11	Sagt, Gesagt, haben, was, behaupten
fort	RP, IN, RB, NN, CC	11	fort, Blume, und, Siebensachen, mit, eben, so
gehören	RP, VBN, VB, RB, PRP	11	gehört, schon, ihm, mir
fehlen	VB, VBN, WP, RB	11	fehlt, fehlen, fehlet, fehlte, Was, noch
Palmen	NN	11	Palmen
bitt	NN, JJ, PRP	11	bitt, bitter, Ich, ich
ins	IN, RB, CC, VB, WDT, NN	11	ins, zweitenmal, Und, heut, mit, der, stürzt, Geiz
gross	JJ, VB, PRP	11	große, groß, großen, ich, unverzeihlich
Rat	NN, WDT	11	Rat, diesen
lässen	VB, CC, NN, DT	11	läßt, denken, und, Sittah, holen, die
ruhig	JJ, NN, WP, VB	11	ruhig, Sei, Was, sei, Kalte
fühlen	VB, PRP, VBN	11	fühlen, fühlte, fühle, fühlest, fühlt, Ich, gedrungen, gehalten
holen	VB, VBN, PRP, NN	11	holen, holte, geholt, sie, lauft, sich, Recha, Sittah
reich	JJ, MD, RB	11	reich, reicher, wolltet, so
sollt	NN, PRP$, WP, DT, PRP	11	sollt, Ihr, Was, Das, Ich
Wahrheit	NN, DT	11	Wahrheit, die
andre	NN, NNP, IN	10	andre, für, nun, fürs
Weiss	NN, JJ	10	Weiß, weißt
deinem	NN, CC, IN, RB	10	deinem, oder, Von, zu, Wenn
drei	CD, PRP, NN	10	drei, ich, Macht, wir
wohlen	VB, RB, JJ, NN	10	wohl, Ja, Euch, erschrak, Recht
weiss	VB, RB, JJ, WP, PRP	10	weiß, Wer, so, Daja, Ich
lasst	RB, IN, RP, WRB, CC	10	laßt, Aber, und
kalt	JJ, RB, IN, DT	10	kalter, kalt, So, so, wie, als, Die
borgen	VB, RP, VBN	10	borgen, borgt
Muselmann	NNP, NN, IN, RB, DT	10	Muselmann, als, Und, auf, einen
schwerlich	JJ, RB, WP	10	schwerlich, auch, nun, Was
Tat	NN, DT, RB	10	Tat, eine, solche, Allerdings, einer, brauchts
führen	VB, PRP, JJ, TO	10	führen, führt, ihr, richtig, zu
Weg	NN, PRP$, WDT, DT	10	Weg, wahren, dieser, dem
einzig	JJ, NN, WDT, DT, VB	10	einziger, einzig, Tritt, dieser, die, Ein, den, allgemeinen
Assad	PRP$, DT, IN, NN	10	mein, Ein, Wie, Assad, deinem, Denn, meines, Mein
verlieren	VB, VBN, RB, TO, PRP, NN, IN	10	verlieren, verloren, gern, zu, ich, Du
jen	VB, DT, CC, NN, IN	10	je, jene, jenem, jenen, und, dirs, Daß, waren
seh	VB, PRP$	10	sehen, seh
Namen	NN, JJ, WDT	10	Namen, Euern, keinen, diesen
bin	RB, VB, PRP	10	bin, Ich, Leider
wenigstens	WRB, RB, RP, IN	10	wenigstens, Bis, nicht
danken	VB, PRP, TO	10	danken, danket, Er, zu, ihm
Gefahr	NN, DT	10	Gefahr, der
Rechas	NN, RB, JJ, CC	10	Rechas, bliebe, oder, Bruder, allen, Aber
Haus	NN, NNP, PRP$	10	Haus, Ins, seinem
ward	NNP, PRP, NN, IN	9	ward, Sie, erzogen, Wie
Augenblick	NN, NNP, JJ	9	Augenblick, ersten
Blut	NN, CC, JJ, DT	9	Blut, und, Mein, das
deines	NN, PRP	9	deines, mir, Schwärmern, meines, Ich
Lasst	NN, VB, JJ	9	Laßt, weiß, Geistlicher
Bleibt	NN, DT, VBN	9	Bleibt, die, eile, müßte
Vernunft	NN, DT, JJ	9	Vernunft, die, ruhige
Seid	NN, PRP, RP, VB	9	Seid, ich, nie, ruft, haben, Bruder
vielleicht	RB, IN, RP, VB	9	vielleicht, sein
Patriarchen	VB, JJ, RB, IN, DT	9	Patriarchen, zum, dem, Dem, den, des
Tempelherrn	NN, DT, JJ	9	Tempelherrn, dem, jungen, Dem, Die
werd	NNP, NN, RB, JJ, DT, PRP	9	werd, schenke, So, selbst, Das, Ich
sag	NN, PRP	9	sag, ihm, ich, Komm
Geduld	NN, IN, UH, RB	9	Geduld, nur, noch, Nun, nicht, Nur
fallen	VB, VBN, RB	9	fiel, fallen, so
Spiel	NN, DT	9	Spiel, das
darum	RB, VB	9	darum, Nur, erkennen
Fall	NN, JJ, DT	9	Fall, den
endlich	RB, IN, PRP$, PRP, NN, WDT	9	endlich, wohl, einmal, Sich, er, Unkraut, was
Soen	VBN, RB, PRP, NN	9	So, ihm, Tochter, Bluts
weis	JJ, NN, DT, RB	9	weise, weis, Der, So
Augen	NN, JJ, PRP$	9	Augen, Euern, Gottes, andern, nassen, seinen
zurück	RP, IN, RB, PRP, VB	9	zurück, viel, sie, fast
Glück	NN, IN, DT	9	Glück, weises, Zum, Ein
Jud	NN, IN	9	Jud, Wenn, auf
näh	JJ	9	näher
liebt	NN	9	liebt, Tempelherr, Vater
zwei	CD, PRP, CC, NN	9	zwei, du, oder, Väter
neu	JJ, VB, DT, NN	8	neue, neuen, neues, neu, einer, aufs
eh	RB, WRB, IN, CC	8	eh, und
sterben	PRP$, VB, NN, RB	8	sterben, stirbt, Lilla, Vorher, gar, nicht, nun
recht	JJ, VB, RB, PRP	8	rechter, recht, wohl, sich, nicht
übel	JJ, RB	8	übel, nicht, Nicht
frei	JJ, RB, IN	8	frei, freien, freier, alle, unter, so
Curd	RB, NNP, NN	8	Curd, Mädchen, Heißt, Hieß
Mantel	NN, PRP$	8	Mantel, weißen, Euern
jaten	RB, RP, NN	8	ja, Ja, Gehört, Kommt, dirs
unserm	PRP$	8	unserm
spielen	VB, NN	8	spielen, Christin
schlagen	VB, NN	8	schlagen, schlägt, schlagt, Vater
wert	RP, RB	8	wert, immer, so
andrer	NN, JJ, DT	8	andrer, kein, ein, Ein
suchen	VBN, VB, PRP	8	gesucht, sucht, suchen, kommen, Er, er, dich
Eurer	NN, JJ, VB	8	Eurer, Es, ihm, war
Auchen	VB, RB, NN	8	Auch, Freunds, wers, Woher, Frau
Tempelherren	NN, DT	8	Tempelherren, die, einem
tausend	CD, CC	8	tausend, Und
weisst	NN, JJ, DT, CC	8	weißt, Du, alles, Und
stehn	NN, JJ	8	stehn, Büchelchen
Natur	NN, PRP$	8	Natur, ihm
fällen	RP, VB, IN, PRP	8	gefällt, fällt, so, gönnen, Da, mir
Euerm	NN, NNP, IN	8	Euerm, Mit
Feind	NN, NNS, DT, PRP$	8	Feind, Feinde, der, meinem
leicht	JJ, NNP, RP, IN	8	leicht, wie
Himmel	JJ, NN, DT, IN	8	Himmel, der, freiem, gen, rauhen
voll	JJ, VB	8	volle, vollem, voll, voller, steht
hättet	NN, DT, IN, VB	8	hättet, Das, klüger, So, Gewürdigt
Hause	NN, PRP$	8	Hause, Bruders, seinem
Stelle	NN, IN, JJ	8	Stelle, Zur, meiner
setzen	VB, NN, TO	8	setzt, setzen, setzte, Spiel, Ohr, Zu, zu
sehe	PRP$, VB, PRP	8	sehe, komme, ich, Ich
Kopf	NN, DT	8	Kopf, den
bezahlen	VB, RP, RB, IN	7	bezahlen, bezahlt, davon, zu
tot	JJ, VB	7	tot, ist
Gewalt	NN, IN	7	Gewalt, mit
Königin	NN, JJ	7	Königin, Keine
Freilich	JJ, VB	7	Freilich, bestechen, haben, abzujagen
schämen	VB, PRP, NN	7	schämen, schämt, mich, Dich
Grund	NN, DT, IN	7	Grund, den, weiße, diesen, ohne, Dein
wüsste	NN, JJ, PRP, RB	7	wüßte, ich, Ich, nicht
Tugend	NN, PRP$	7	Tugend, unsre
lieben	VB, NN, PRP	7	lieben, liebt, liebe, mich
Ende	NN, JJ, DT	7	Ende, kein, ein, selig
Nuren	RB, VB, NN	7	Nur, Getäuscht, Einerlei
dünkt	NN, PRP	7	dünkt, Mich, mich
Kinder	NN, CC, PRP$	7	Kinder, Und, meine, Bruders
hör	NN, VB, WP	7	hör, höre, Was
Gottes	NN, JJ, IN	7	Gottes, Eifer, lieber, vor, auch
unser	PRP$, IN	7	unser, Daß
Habt	NN, RP, DT	7	Habt, auf, verläßt, den
Wär	NN, MD, NNS	7	Wär, wollen, Verständigen, Muskeln
Gutes	NN, WP, IN, PRP, NNP	7	Gutes, Was, viel, sie, stürzte
Mutter	PRP$, DT, NN	7	seiner, seine, die, Die, eine, Eure, Eurer
reden	VB, PRP	7	reden, rede, Ich
Händen	NN, JJ, PRP$, WP	7	Händen, leeren, meinen, wessen, gerungnen
arm	JJ	7	armen, arm, armer, armes
Bild	NN, DT	7	Bild, das, Ein
steh	PRP, UH, RB, MD, JJ	7	Ich, Nun, doch, kömmt, Steh
Stimme	NN, DT	7	Stimme, eine
indes	CC, RB, NN	7	indes, geh, Hat, straf
Wunsch	JJ, NN, IN, DT	7	Wunsch, Als, den
nochen	RP, VB, RB, NN	7	noch, hats, Ihn
bring	FW, RB, CC	7	bring, darum, Und
verlor	JJ, NN	7	verloren, verlor, früh
rufen	VB, WP, NN	7	rief, rufen, ruft, Wer, Hülfe
gebt	NN, IN, PRP	7	gebt, Recha, Also, Nathan, Sie
Christenkind	NN, JJ, DT	7	Christenkind, verzettelt, ein, Ein
Drum	NN, RB	7	Drum, auch
handeln	VB	7	handeln, handle, handelt
vergessen	VBN, RB, JJ, PRP	6	vergessen, doch, sehr, nicht, selbst, mich
Richter	NN	6	Richter
sicher	RB, PRP	6	sicher, Denn, so, Sie
spät	JJ, RB, IN	6	spät, zu, Zu
Taten	NN, IN, PRP$	6	Taten, Für, seinen, seine
Jüdin	NN	6	Jüdin
Gedanke	NNS, DT, NN, IN	6	Gedanken, der, dem, Mein, auf, den
Gern	NN, VB	6	Gern, bringen
Seit	IN, PRP$, NN	6	Seit, deiner, Schwester
fangen	VBN, VB, NN	6	gefangen, fängt, fingt
schenken	VB, NN, DT	6	schenken, geschenkt, Freiheit, alle
brav	JJ, NN, DT	6	brav, braven, Betrogen, ein, Der, Ein
Schuld	NN	6	Schuld
Kloster	NN, IN	6	Kloster, Im, Ins
erzählen	VB, IN	6	erzählen, erzählt, erzähle, erzählet, zu
Gehört	NN, RB	6	Gehört, nicht, Buch
ihrem	PRP$, IN, CC	6	ihrem, auf, bei, und
Ists	NN	6	Ists, Freund
Dochen	RB, NN, RP	6	Doch, Gesammelt, Vater, an
untern	JJ, NN	6	untern
nunen	VB, RB, NN	6	nun, Not, Nein, Haus
fassen	VB, VBN, TO, NN	6	faßt, gefaßt, fassen, zu, Sei
Tränen	NN, PRP, PRP$, IN	6	Tränen, mir, heißen, in
verstehen	VB, RB, PRP	6	verstehn, versteht, Wir
Weisen	NN	6	Weisen, sehn
Wem	NN, NNP	6	Wem, Gefangner
Dingen	NN, JJ	6	Dingen, allen
lesen	VB, RB, PRP, TO	6	lesen, nicht, Ich, kaum, zu, nichts
schaden	VB, RB	6	schadet, wenig, nicht
Filneck	NN, IN	6	Filneck, von, Von
stolz	JJ, IN, RB, CC	6	stolz, Zu, nicht, und
Bettler	NN	6	Bettler
Nathans	NN, IN	6	Nathans, von, Nathan, schone, Sei, Unsers
halt	IN, RP, RB, NN	6	halt, Doch, Saladin
schuldig	JJ, RB	6	schuldig, nicht
schlecht	JJ, RB	6	schlecht, schlechter, nicht, so
Nimm	NN, JJ	6	Nimm, dritten, verfällst
schnell	JJ	6	schnell, schneller
wessen	WP, IN, CC, VB	6	wessen, Von, Und, wissen
Sultans	JJ, NN, DT	6	Sultans, Des, des
gibts	NN, JJ, WP	6	gibts, Was
unsrer	PRP$, PRP	6	unsrer, sich
richtig	JJ, RB	6	richtig, schon, nur
Aug	NN, JJ, PRP$, DT	6	Aug, weiblich, mein, Ein
aufs	NN, IN, PRP, JJ	6	aufs, ihr, stolz, mich
mirs	NN, RB, JJ	6	mirs, hat, Tut, Nehmt
Stein	NNS, NN	6	Steine, Stein
Hast	NN, RP	6	Hast, sicher
edler	NN, JJ, VB	6	edler, guter, junger
Hab	NN, DT, VB	6	Hab, diesem, schämen
mind	JJ, PRP	6	minder, er
Auge	NN	6	Auge, Euer
verbrennen	RP, VB, RB	6	verbrannt, verbrennen, viel
Jerusalem	NNP, IN	6	Jerusalem, in
erwarten	VB	6	erwarten, erwartet
schaffen	VB, RB, TO	6	schaffen, schafft, Schon, Zu
Geheimnis	NN, DT, PRP	6	Geheimnis, Ein, ihr
Ihrs	NN, IN	6	Ihrs, Daß
Weit	NN, NNP, PRP	6	Weit, mir, andrer
Not	NN, IN, JJ	6	Not, wohl, keine
Weib	NN, IN, PRP$	6	Weib, Mit, mein
Feur	NN	6	Feur
Tut	NN, PRP$, VB	6	Tut, lesen, geht
Rede	NN, DT, IN	6	Rede, die, zur
etwa	RP, RB, IN, PRP	6	etwa, nicht, ich, doch
stets	RB, JJ, IN	6	stets
selten	RB, RP	6	selten, So, nur
ziehen	VB, VBN	6	zieht, ziehst, gezogen
Gelegenheit	NN, JJ, WDT	6	Gelegenheit, einzigen, was, Sünde
wünschen	VB, VBN	6	wünschte, gewünscht, wünsche
Bald	NN, IN	6	Bald, Christ, schon, schwärmt
Blick	NN, NNP	6	Blick
Brautkleid	DT, RP, NN, IN, WP	6	Ein, besser, Warum, Zum, wessen
Mach	NN, PRP, DT	6	Mach, mir, Ballen, keinen
treten	VB, RP, IN	6	trat, treten, getreten, Da
dennen	RB, VB	5	denn
Kindheit	NN, JJ, PRP$	5	Kindheit, meiner, meine
Wasser	NN, JJ	5	Wasser, voll
arme	NN, DT	5	arme, Der, Das, die
wart	NNP, PRP$, NN	5	wart, Ihr, beflissen
Wege	NN, NNP, JJ	5	Wege, gute
tragen	VB, RB	5	tragen, trägt, tragt, So
unterscheiden	VB	5	unterscheiden
heissen	PRP$, VB, TO	5	heißen, Mit
Eindruck	NN, DT	5	Eindruck, Dich, diesem
Kurz	NN, VB	5	Kurz, setzen, fasset
Ganges	NNP	5	Ganges
sieh	NN, IN	5	sieh, So
Bruders	NN	5	Bruders, meines, deines
kennst	NN, PRP	5	kennst, du
Kasse	NN	5	Kasse
könnt	VB, RB, IN	5	könnt, geben, Wie
Zweifel	NN	5	Zweifel
Schwert	NN, DT	5	Schwert, dem
plötzlich	JJ, NN	5	plötzlich, Gazza
stecken	VB, RB, WRB	5	steckt, stecken, dahinter, Wo
Beste	NN, DT	5	Beste, der
bestellen	VBN, VB, IN, RB	5	bestellt, bestellen, wie, hierher
liebern	VB, NN, PRP	5	lieber, ich
würdig	JJ, PRP$	5	würdig, ihrer
hoffen	VB	5	hoffen, hoffte, hofft
werfen	VB, JJ, TO, CC	5	wirft, geworfen, plötzlich, zu, Und
Euers	NN, PRP	5	Euers, Aufschluß, mich
Beutel	NN, DT	5	Beutel, einen, Der, dieser
zweit	JJ, DT	5	zweiten, zweiter, die, Den
König	NNP, NN	5	König
merken	VB, PRP	5	merken, merkt, Ich
geschwind	RB, PRP	5	geschwind, nur, ihn, mir
dergleichen	PRP, NN	5	dergleichen, Gelegenheit
drum	RP, RB, VB	5	drum, ist, Ist
krank	JJ	5	krank
Christenheit	NN, DT	5	Christenheit, Der
zugleich	RB, IN	5	zugleich
nah	JJ, RB, IN	5	nah, naher, zu, Wie
schicken	RP, VB, RB, TO	5	geschickt, schicken, zweimal, Zu
Bloss	NN	5	Bloß
erfahren	RP, VB, RB	5	erfahren, zuerst, davon
alt	JJ, PRP$, DT, RB	5	alter, mein, die, Eure
Glauben	NN	5	Glauben
Wolf	NNP, JJ, NN, PRP$	5	Wolf, jüdschen, Filneck, Sich
Kleinigkeit	NN, DT	5	Kleinigkeit, dieser
Jahren	NN, DT, CD	5	Jahren, vielen, achtzehn, solchen
Wozu	NN	5	Wozu
Gewissen	NN, PRP$	5	Gewissen, mein
Geckerei	NN	5	Geckerei
gnug	NN, IN	5	gnug, Tränen, lange
damien	VB, NN	5	damit, wärs, Euch, Wegs
gelehrt	JJ, RB, NN	5	gelehrt, schon, so, michs
Augenblicke	NN	5	Augenblicke
blieb	NN, PRP	5	blieb, Er
Füssen	NNP, VB	5	Füßen, meinen, deinen
hassen	VB, CC, TO	5	hießet, hieß, und, zu
Argwohn	NN, IN	5	Argwohn, Denn, Nathan, Ritter
Denkt	NN, VB	5	Denkt, käme
vernehmen	RP, VBN, VB, TO	5	vernommen, vernehmen, zu
stellen	VB, NN	5	stellen, stellt, O, Rede
Zeiten	NN, IN, RB	5	Zeiten, vor, zu, Bei
Kennt	NN	5	Kennt
fürcht	NN, DT	5	fürchte, fürcht, Assad, Die
sogleich	RB, MD, NN, VB	5	sogleich, soll, nimm, nur, mußt
Zug	NN, DT	5	Zug, Den, Der
Fast	NN	5	Fast
schön	JJ, NN, RB	5	schön, O, so
Sonst	NN, VB, RB	5	wachse, Willkommnen, muß, sonst, Eigentum
erkennen	PRP, RB	5	ihn, mir, nicht
möchen	MD	5	möcht
Zins	NNS, NN	5	Zinsen, Zins
Genug	NN, RB, JJ, PRP	5	Genug, davon, schlimm, uns
Ernst	NNP, IN	5	Ernst, Im, ganzem
Vielleicht	RB, NN	5	Vielleicht, ob, Kindesstatt
gefallen	VB, VBN, RP	5	gefallen
bessern	VB, PRP$, TO	5	besser, bessern, zu
Entschluss	NNS, NN, JJ	5	Entschlüsse, Entschluß, einzigen
Geist	NN, JJ	5	Geist, heilgen, guter
längst	IN, RB, PRP	5	längst, du
Welch	NN	5	Welch, Allein, Nathan
Arm	NN, DT, VB	5	Arm, die, meinen
Ohr	NN, IN	5	Ohr, ins
manch	RB	5	so, So
weder	CC, RB, PRP, NNP	5	weder, ich, Euch
würd	NNP, PRP	5	würd, Ich
loben	VB, RP	5	loben, gelobt
Ach	NN, IN	5	Ach, zugeschworen, Wie
drauf	RP, RB	4	drauf, bald, nur
dienen	VB, NN	4	dienen, Ende
ungefähr	IN, WRB, RP	4	ungefähr
reichen	VB, PRP$, DT	4	reiche, reichen, eines, des
welch	WDT, CC, NN	4	welch, Und, Sieh
ziemt	NN, PRP, VB	4	ziemt, dir, tun, wissen
Posse	NN	4	Posse
Seite	NN	4	Seite
Rechte	NN, DT	4	Rechte, die, größre
Geschwind	JJ, NN, VB	4	Geschwind, Büchelchen, kann
gehabt	NN, PRP, IN	4	gehabt, mir, viel
vorgehen	VB, PRP$	4	vorgeht, Ihr
Gang	NN, NNP, CC	4	Gang, Mein, und
Einfalt	NN, JJ, DT	4	Einfalt, frommen, Die
Conrad	NNP, NN	4	Conrad, Bruder
Spott	NN, DT	4	Spott, den
wirst	WRB, RP, NN	4	wirst, Du
vielmehr	RB	4	vielmehr, nicht
Prinzessin	NN, RB	4	Schwester, nicht, vertrauter
Gewesen	NN, IN, RB	4	Gewesen, nie, denn, nicht
gewinnen	VB, VBN, RP	4	gewinnen, gewonnen
Libanon	NNP, IN	4	Libanon, Auf, um
Springer	NN	4	Springer
Hauses	NN	4	Hauses
Spiele	NN	4	Spiele
frisch	RB, PRP, NN	4	so, ich, jeder, nimm
Versprechen	NN, PRP	4	Versprechen, mir
He	NN	4	He, Gott
Gekommen	NN, RB, IN	4	Gekommen, nicht, herüber
Fenster	NN, JJ	4	Fenster
nu	IN, NN	4	Je, Nu
Bettlern	NN	4	Bettlern
entdeckt	VB, RB, DT	4	ist, nicht, itzt
Wahn	NN	4	Wahn
warst	RP, WRB, IN, VB	4	warst, gewisser
Absicht	NN	4	Absicht
Seel	NN, IN, CC	4	Seel, Seele, Mit, und
Sehen	VB, VBN, NN	4	Seht, Reichtums
unsers	PRP$, RB, NN	4	unsers, Doch, Verstärkung
Glaube	NN	4	Glaube
Unruh	NN, IN	4	Unruh, Für
fasen	VB, NN	4	fast, fasten, Rührung
erweisen	RP, RB, IN, NN	4	erwiesen, erweisen, zu, ausgemacht
drücken	VB, NN	4	drücken, Hand
Verbrannt	NN	4	Verbrannt
gilts	NN, WP	4	gilts, Was
Eur	NN, JJ	4	Eure, Eurer
doppelt	RB, JJ	4	doppelt
ähnlich	JJ, RB	4	ähnlich, So, nur
gib	CC, RP, NN, IN	4	Aber, Doch, Komm, So
gehn	NN	4	gehn, Richte
vertrauen	VB, TO, RB	4	vertrauen, zu, nie
Diensten	NN	4	Diensten, deinen, Euern
unsre	PRP$, NN	4	unsre, Fehlern
Hieren	VBN, NN, PRP	4	Hier, Bonafides, schicke, du
Ägypten	NN, IN	4	Ägypten, aus
Fällen	JJ, PRP, DT, VB	4	allen, mir, beiden, dürfe
Wert	NN, DT	4	Wert, Den, höhern
Dennen	RP, VB, RB	4	Denn
Pfand	NN, DT	4	vertrautes, Das, vertraute
kämpfen	VB, TO	4	kämpft, kämpfen, zu
siegen	VB, DT	4	siegen, siegt, der
Munde	NN, PRP$	4	Munde, ihrem, seinem
begegnen	VB	4	begegnet, begegnen
Hats	NN, JJ, NNP	4	Hats, Saladin, sehn, bezaubert
wahren	VB, PRP$, JJ, DT	4	wahren, einzig, Des
verschmäht	NN, PRP	4	verschmäht, säete, dich
Eures	NN, JJ	4	Eures, Kindchen
Nehmt	NN, VB, MD	4	Nehmt, wissen, soll
schöner	NN, DT, IN	4	schöner, Ein, Wohl, noch
ohn	NN	4	ohn
Erst	RB	4	Erst, nur
Söhnen	NN	4	Söhnen, hoffnungsvollen
treffen	VB, VBN, NN, RB	4	treffen, getroffen, Ziele, ja
treibt	NN, NNP	4	treibt, Mich
Tod	NN, DT	4	Tod, Der
schweig	JJ	4	schweig
Ins	NN, IN	4	Ins, Sittah, aus
vorbei	IN	4	vorbei
Guten	NN, DT	4	Guten, dem
Mönch	NN	4	Mönch
bekommen	VB, IN	4	bekommen, zu
wagen	VB, PRP	4	wagen, es
Märchen	NN	4	Märchen
Vaters	NN, DT	4	Vaters, des, meines
Mansor	NN, VB, JJ	4	Emir, gegangen, Mansor, guter
dank	IN, DT	4	dank, Das
Nie	NN	4	Nie
stürzte	NN, DT, NNP	4	stürzte, der, Füßen
find	NN	4	find
irgend	JJ, IN, WDT	4	irgend, daß, der, auf
Sorge	NN, MD	4	Sorge, wolle
sei	VB, JJ, PRP	4	sei, ihm
klug	JJ, RB	4	klug, so
Richards	NN, JJ	4	Richards
Tage	NN, IN	4	Tage, wenig
Sünde	NN, JJ, DT	4	Eure, wahre, die, großen
Ding	NN, JJ, DT	4	Ding, jedes, ein
Verstehen	VB, RB	4	Versteht, allein
Manne	NN	4	Manne
bös	JJ	4	böser, böse, gute
Wahrlich	JJ	4	Wahrlich
hinter	IN, VB	4	hinter, werde
allgemein	JJ, RB, DT	4	allgemeine, ganz, Den
helfen	VB	4	helfen, hilft, bilden, vollziehen
gesehn	NN, IN	4	gesehn, einmal
lang	JJ	4	langer, lang
Erlaubt	NN	4	Erlaubt
Steh	RP, NN, PRP$	4	willst, Nimmermehr, bins, bewundern
wiedern	VB, NN	4	wieder, Ihn
sprichst	NN	4	sprichst, Brautkleid
warten	VB, RB, PRP$, NN	4	warten, lange, ihrer, He
bilden	VBN, NN, PRP, PRP$	4	gebildet, Beispiel, Ich, Ihr
echt	JJ, NN	4	echten, echt, echte
umsonst	RB, RP	4	umsonst, nicht, ganz
denk	NN	4	denk, Christendirne
Kaum	NN, VB	4	Kaum, lenken
ganzen	RB, VB, NN	4	ganz, So, Assad
mags	NN, UH	4	mags, Nun
wärs	NN, CC	4	wärs, Bald, Und
Rechnung	NN	4	Rechnung
sollst	RB, WRB, VB, NN	4	sollst, werden, Du
Stadt	NN, NNP, DT	4	Stadt, Die
tu	IN, NN, PRP	4	viel, tu, so, ihn
Unsinn	NN	4	Unsinn
weg	NN, DT, RB	4	Blieb, alle, nimm, Fällt
Kraft	NN	4	Kraft
Lebt	NN, RB	4	Lebt, nicht
Ohn	NN	4	Ohn
Vorsicht	NN, DT, IN	4	Vorsicht, Die, Aus
kenn	JJ, IN, DT, PRP	4	kenne, Auch, diesen, Ich
Klosterbruder	NN, DT, PRP$	4	Klosterbruder, Ein, meinem, der
Kindern	NN, JJ	4	Kindern
Ehr	NN	3	Ehr
hats	NN, IN	3	hats, Christentume, so
Wünsch	JJ, NN	3	Wünsche, Wünsch
Kleid	NN	3	Kleid
Sach	PRP$, JJ	3	Sach, Sache
Tieres	NN, JJ, DT	3	Tieres, wilden, eines
Vorteil	NN	3	Vorteil
vermögen	VB, RB	3	vermag, vermögen, allein
Judenmädch	JJ, DT	3	Judenmädchen, ein
grösst	VB, JJ, NN	3	größte, größten, Sünden
erzähl	NN	3	erzähl, Allein
gelass	JJ, MD, PRP	3	gelassen, soll, sie
Schwerlich	RB, VB, NN	3	Schwerlich, könnte, Namen
fleissig	JJ, RB	3	fleißig, so, doch
Himmels	NN, JJ	3	Himmels
Hülfe	NN	3	Hülfe, Sonst
hierher	NN, RB	3	floh, Weg, noch
trefflich	JJ, DT	3	trefflich, Den
Wills	RB, VB	3	Wills, gern, kann
Weise	NN	3	Weise
Gestalt	NN, JJ	3	Gestalt, göttliche
erzogen	NN, CC	3	erzogen, Euch, und
wenigen	NN, JJ, DT	3	Nichts, wahrlich, Ein
Versteh	NN	3	Versteh
Fürst	JJ, NN	3	Fürsten, Fürst
konnt	JJ, NN	3	konnten, konnt
verfolgen	VB	3	verfolgen
beschwor	NN, PRP	3	beschwor, mich
sonen	RB, VB	3	sonst
Geschlechts	NN, IN	3	Geschlechts, für
Vergnügen	NN	3	Vergnügen
eilt	NN	3	eilt
eile	NN, PRP	3	eile, Ich
lächeln	VB, PRP	3	lächelt, sie
Lächeln	NN, PRP	3	Lächeln, ihr
Geburt	NN	3	Geburt
Dienste	NN	3	Dienste
Verschmäht	NN	3	Verschmäht, warb
Jahre	NN	3	Jahre
verbinden	VB, VBN, PRP	3	verbunden, sich
Wohlan	NN, DT	3	Wohlan, das
Boten	NN, DT, JJ	3	Boten, die, guten
Treu	NN	3	Treu
Volke	NN	3	Volke
sanft	JJ, IN	3	sanfte, mit, Als
wider	RB, VB, NN	3	Nicht, habe, Sünde
müsst	VB	3	müßt, müßte, werben
mehren	VB, RP, NN	3	mehr, Hände
stehlen	VB, VBN, NN	3	stehlen, gestohlen, Ärmern
hoff	NN, PRP	3	hoff, Ich, ich
Reichtum	NN	3	Reichtum
meinern	VB, JJ, IN	3	meiner, bitte, in
dächte	NN	3	dächte
Wink	NN, JJ	3	Wink, erster
Leidenschaft	NN, DT	3	Leidenschaft, der, dieser
Brüderchen	NN, DT	3	Brüderchen, Das, das
Stolz	NN	3	Stolz
gönnen	VB, TO, RB	3	gönnen, zu, nicht
bereit	RP, VBN	3	bereit, bin
Stell	NN, PRP$	3	Stell, seiner
Heisst	NN, RB	3	Heißt, denn
Grab	NN, IN	3	Grab, ins
Bubenstück	NN	3	Bubenstück
Orten	NN, JJ	3	Orten, aller
Deutschland	IN	3	in, nach, Aus
drüber	NN, JJ	3	drüber, Sie
trug	NN	3	trug
Erinnern	NN, PRP	3	Erinnern, dich, Pfand
wisse	NN	3	wisse
dacht	RB, DT	3	dacht, So, Das
leeren	PRP$, VB, TO	3	leeren, Mit
warm	JJ	3	warm, minder
Pferd	NN, JJ	3	Pferd, Vom
Phantasie	NN, PRP$	3	Phantasie, meine
gehorchen	VB	3	gehorchen
überrasch	NN	3	überrasch
Hm	NN, VB	3	Hm, lassen
versuchen	VB, NN	3	versucht, Sogleich, Eitelkeit
Fort	NN, VB	3	Fort, helfen
nachgeschickt	NN	3	nachgeschickt
bleibe	NN	3	bleibe
Entzücken	NN	3	Entzücken
Heraus	IN, NN, VB	3	Heraus, Geträumt, muß
Lieb	NN, JJ	3	Lieb, aller, Tieres
schlassen	VB	3	schließt
Glut	NN	3	Glut
Neugier	NN, JJ	3	Neugier, meiner
schlimm	JJ, RB	3	schlimm, schlimmes, Schon
annehmen	VBN, JJ, NN	3	angenommen, lieber, Euch
Verderben	NN, IN, JJ	3	Verderben, ins, ewige
bessrer	NN, IN, DT	3	beßrer, mit, Ein
hol	NN	3	hol
Geck	NN	3	Geck
keines	NN, PRP	3	keines, er
stimmen	NN, CC, TO	3	Beteuern, weder, zu
freilichen	VB, VBN, NN	3	freilich, Tempelherren
Münze	NN	3	Münze
Überschuss	NN	3	Überschuß
hübsch	JJ, IN	3	hübsch, Bei, Auf
legen	VB, NN	3	legen, Etwas
freuen	VB, VBN	3	freuen, freut, gefreut
Verlust	NN, JJ	3	Verlust, kein
Bescheidenheit	NN, IN	3	Bescheidenheit, aus
sonderbar	JJ, NN	3	sonderbar, Ganz
Name	NN	3	Name
gekannt	NN, PRP$	3	gekannt, Ihr
Kerl	NN	3	Kerl, edler
schweigen	VB	3	schweigt
Oft	NN, DT	3	Oft, die
ohnedem	RB, VB	3	ohnedem, ja
Lande	NN, RB, IN	3	Lande, zu
Bitte	NN	3	Bitte
Kömmt	NN	3	Kömmt
Erhalten	NN, JJ	3	Erhalten, frisch
Krone	NN	3	Krone
Wohin	NN, VB	3	Wohin, mußte
verlegen	VB	3	verlegen
geb	NN	3	geb
Krank	NN	3	Krank
Alles	NN	3	Alles, Ritter
Babylon	NN	3	Babylon
lösen	VB, DT	3	lösen, selber
Güte	NN, RB	3	Güte, Und
falsch	JJ	3	falsch, falschen
Mund	NN	3	Mund
Freundin	PRP$, JJ	3	deine, meiner, meine
schonen	VB, NN	3	schon, Hunde
Luft	DT, MD	3	der, will
besondre	NN, IN	3	besondre, ins
fein	VB, JJ	3	feine, fein
Itzt	NN, IN	3	Itzt, zu
Meinung	NN, PRP$	3	Meinung, seine
sterbend	JJ, PRP$, NN	3	sterbend, es, Gar
los	RB, RP	3	los
euer	PRP$	3	euer
welchem	WP, IN	3	welchem, In, von
einander	PRP, VB	3	einander, sind
sagst	NN, WP	3	sagst, was, Was
Warte	NN	3	Warte
gebot	JJ	3	geboten
Traun	NN	3	Traun
brauch	NN, RB	3	brauch, Darüber
grössern	NN, DT	3	größern, Gelder, einer
laut	JJ, RB	3	lauter, endlich
überlegt	JJ	3	überlegt
Wisst	NN, VBN	3	Wißt, gewesen
nenn	NN, DT	3	nenn, Das
Hirn	NN	3	Hirn
Fleck	NN	3	Fleck
Gnade	NN, VB	3	Gnade, hat
Europa	NNP	3	Europa
Besinn	NN	3	Besinn
kaufen	RP, PRP	3	gekauft, ihn
Armen	NN, DT	3	Armen, den
ferner	RB, PRP, DT	3	ferner, ich, diese
Schwesterchen	NN, DT	3	Schwesterchen, das, Ein
Leib	NN, CC, IN	3	Leib, und, mit
lernen	VB, VBN, RB	3	lernen, gelernt, So
wofür	NN, IN	3	Euch, Dank, Wofür
Blanda	NN	3	Schwester, Filneck, Blanda
Schatz	NN, NNS	3	Schatz, Schätze
Eh	NN, IN	3	Eh, auf
versteh	NN, UH	3	versteh, Nun
Sinai	NN	3	Sinai
Raub	NN, JJ	3	Raub, kleinen, kleiner
abern	NN, DT	3	Muß, Euch, Die
überall	RB	3	überall
Wegs	NN, WDT	3	Wegs, graden, dieses
Berge	NN	3	Berge
Berg	NN	3	Berg
verschweigen	VB, PRP$, RB	3	verschweigt, verschweigen, nicht
nehmt	NN	3	nehmt, Nathan
Wohlen	RB	3	Wohl
ersen	VB, DT	3	ersten, der
Schurken	NN, DT	3	Schurken, einen
Ursach	NN, DT	3	Ursach, Die
Assads	VB, IN, NN	3	wird, über, meines
leihen	VB	3	leihen
zusammen	RB, RP	3	zusammen, doch
zwingen	VB	3	gezwungen, zwingen, führen
Ibrahim	NN, VB, RB	3	Brav, geben, aber
Freundschaft	NN	3	Freundschaft
valten	VB, IN, NN	3	viel, wie, Bald
Betrieger	NN, VB	3	Betrieger, Herz, denken
ansehn	NN	3	ansehn
Vielmehr	RP, RB	3	Vielmehr
Rate	NN	3	Rate
Streich	NN	3	Streich
Dienst	NN	3	Dienst
Staat	NN	3	Staat
Horch	NN	3	Horch
Rettung	NN	3	Rettung
Persisch	NN, NNP	3	liebsten, Persisch
weinen	VB, CC, NN	3	weinen, und, hast
Blumen	NN	3	Blumen
Kamele	NN	3	Kamele
Gefallen	NN, PRP	3	Gefallen, mir
Gesicht	NN, PRP	3	Gesicht, dir
auferzogen	NN	3	auferzogen
Gründe	NN	3	Gründe
dringen	VBN, VB, PRP	3	drang, drängen, sich
herrlich	JJ, DT	3	herrlicher, herrlich, alles
Vermutlich	JJ, RB	3	Vermutlich, besser
Fittiche	NN	3	Fittiche
taugen	VB, VBN	3	taugt
letzt	JJ, DT	3	letzter, letzten, der
tuts	NN, WP	3	tuts, was
Indes	NN, VB	3	Indes, finden
Saladins	NN	3	Saladins
gestehen	VB	3	gestanden, gestehen
jagen	VB, VBN, NN	3	jagt, Feuer
entgegen	RP, RB	3	entgegen, doch, denn
Geboren	NN	3	Geboren
Hut	NN, JJ, PRP$	3	Hut, meiner, deiner
begreifen	VB, RB, TO	3	begreife, längst, zu
tat	VB, DT	3	tat, das
zwischen	IN	3	zwischen
Verzeih	NN, RP	3	Verzeih, Unentschlossenheit, fort
frag	NN	3	frag, Geh
Philipp	NNP	3	Philipp
darumen	VB	3	darum
Ehgemahl	NN	3	Ehgemahl
Seiten	NN, JJ, DT	3	Seiten, manche, vielen
Womit	NN, WP, NNS	3	Womit, was, Träume
Beispiel	NN, PRP$	3	Beispiel, mein
matt	JJ	3	matt
wandeln	VB, DT	3	wandeln, kann, andern
geheim	JJ	3	geheimes, geheime, geheim
Verdacht	NN, DT, JJ	3	Verdacht, der, niedriger
Frau	PRP$, NN	3	meine, Muselmannes, arme
lauft	NN, VB	3	lauft, Geht, Eilt
Staub	NN, NNS, RB	3	Staub, Staube, Und
Kleidung	NN, IN	3	Kleidung, mit
Melek	NN	3	Melek
zufried	JJ, RB	3	zufrieden, doch
Judenmädchen	VB	3	Judenmädchen
solls	RB, PRP	3	solls, Er
Geschwister	NN, PRP	3	Geschwister, Bruder, Sie
jemand	DT, PRP	3	jemand, ihm, Sie
Reichen	VB	3	Reichen
bins	PRP, RB	3	Ich, ja
Wollt	NN	3	Wollt
nied	JJ	3	nieder
rechnen	VB, JJ, NN	3	rechnen, du, andre
Könnt	NN	3	Könnt
erhalten	JJ, PRP, RB	3	so, sich, auch
zeigen	VBN, VB	3	zeigen, zeigt
Kundschaft	NN	3	Kundschaft
Gebet	VB, PRP, JJ	3	sind, ihr, manch
still	JJ, PRP	3	still, Sie
fremd	JJ, RB, NN	3	fremd, so, einzge
Gebt	PRP, VB	3	mir, nehmen, schalten
Gesetz	NN	3	Gesetz
sparen	PRP$, VB	3	sparen
Verloren	NN	3	Verloren
Haupt	NN	3	Haupt, Euer
mitgebracht	NN	3	mitgebracht, Recha
betreten	VB	3	betreten
ah	UH	3	ah
schwärmt	NN	3	schwärmt, Enden
Gespräch	NN, IN	3	Gespräch, in
wild	VB, JJ, DT	3	wilden, eines
ändern	VB, DT	3	ändern, Das
Orden	NN	3	Orden
verlernen	VB	3	verlernen, sein
schw	JJ, NN	3	schwer, Mir, wahrlich
untersuchen	VBN, VB	3	untersucht, untersuchen
Mags	NN	3	Mags
womit	WRB	3	womit
sinds	NN, PRP	3	sinds, Sie
fahren	VB	3	fuhr, fahren
Genannt	NN, RB	3	Genannt, nicht
seit	IN, RP	3	seit, auch
stürzt	NN, DT	3	stürzt, der, Verderben
Laienbruder	NN, IN, DT	3	Laienbruder, als, der
Lebens	NN, JJ	3	Lebens, Des
Nachricht	NN	3	Nachricht, Erwünschte
genau	RP, RB	3	genau, so
ungeachtet	IN, DT	3	ungeachtet, Dem
scheiden	VB, VBN	2	geschieden
hatt	NN	2	hatt, kamt
fragst	NN	2	fragst
steigen	VB, NN	2	steigen, Pferde
schöne	NN, JJ	2	schöne, sanfte
euerm	NN	2	euerm
Christus	NNP	2	Christus
vertraut	JJ, NN	2	vertraut, Mir
betteln	VB	2	betteln
Sollt	NN	2	Sollt
Schritte	NN, DT	2	Schritte, diesem
Vorurteilen	NN	2	Vorurteilen
irrst	NN	2	irrst
hilfts	NN	2	hilfts
blossen	VB, NN	2	bloß, bloßen
vorgesetzt	NN, PRP	2	vorgesetzt, mir
Gestehen	VB	2	Gesteht
offn	JJ	2	offne, offnes
Acht	NNP, NN	2	Acht
schmerzt	NN, DT	2	schmerzt, Das
auszubeugen	NN	2	auszubeugen, Mir
Dinge	NN	2	Dinge
wars	NN	2	wars
Person	NN	2	Person
sieben	IN, VB	2	Mit, meine
Geschäft	NN	2	Geschäft
Gewinst	NN	2	Gewinst
lohnen	VB	2	lohnt, lohnen
ers	NN, NNP	2	ers, sandt
wovon	WRB	2	wovon
hundert	CD	2	hundert
darnachen	RB, NN	2	darnach, klang
hört	JJ, VB	2	hörte, hört
gönnt	DT, PRP	2	Die, Ihm
lau	IN, RB	2	wie, denn
versprechen	VB, RB	2	versprechen, nicht
anklagen	JJ, NN	2	Patriarchen, Euch
Christentum	IN, JJ	2	als, ganze
verstellt	NN	2	verstellt
erkunden	NN, IN	2	erkunden, erst
erwägen	VBN, NN	2	erwogen, Herr
Antwort	NN, PRP$	2	Antwort, Ihr
Verzeihet	NN	2	Verzeihet
erboten	NN, RB	2	erboten, nicht
Ward	NNP, NN	2	Ward
Ware	NNS	2	Waren
Gedacht	NN	2	Gedacht
verschont	NN	2	verschont
Durchs	NN	2	Durchs
Gleichwohl	RB	2	Gleichwohl
Geldes	NN, JJ	2	Geldes, baren
Herzens	NN, PRP$	2	Herzens, weichen
Mannes	NN, DT	2	Mannes, solchen
Närrin	NN, DT	2	Närrin, Die
Deswegen	NN, RB	2	Deswegen, ist
albern	JJ	2	albern, kleinen
nahe	IN	2	nahe
verweilt	NN	2	verweilt
Bereit	NN	2	Bereit
Hunde	NN	2	Hunde, Schafpelz
angenehm	JJ	2	angenehm
inzwischen	RB, VB	2	inzwischen, hieß
bst	NN	2	bst
Gemach	NN	2	Gemach
menschlich	JJ	2	menschlich, menschliche
Räuber	NN, DT	2	Räuber, Der
Hecke	NN	2	Hecke
Woran	NN	2	Woran
Wand	NN	2	Wand
gestand	JJ, VB	2	gestanden, sei
schleunig	RP, IN	2	schleunig
Sättigen	VB, VBN	2	Gesättigt
Miene	NNS	2	Mienen
Schlecht	NN	2	Schlecht
laufe	NN	2	laufe
höchstens	RB, WRB	2	höchstens
Büchelch	DT	2	diesem, das
spitz	JJ	2	spitz, spitze
erröten	RB, WP	2	nicht, wem
Gönnts	NNP, VB	2	Gönnts, brauchen
Bekommen	NN	2	Bekommen
Stehen	VB	2	Steht
bar	JJ, DT	2	baren, des
blicken	VB	2	blicken, kämpfen
ausführen	VBN, RB	2	ausgeführt, Zusammen
Wolfs	NN	2	Wolfs
wiederkommt	NN	2	wiederkommt
bess	NN	2	Nathan, Gassen
Hinzufügen	VB	2	Hinzugefügt
irr	NN, JJ	2	irr, irre
weiten	PRP$, TO	2	weiten, Bei
eren	RB, VB	2	erst
höchstes	NN	2	höchstes
Wenigstens	NN, VB	2	Wenigstens, erbarmen
zuverlässig	JJ	2	zuverlässig, ziemlich
ungesäumt	NN	2	ungesäumt
Laune	NN, DT	2	Laune, allen
mehrer	JJ, NN	2	mehrere
Frevel	NN	2	Frevel
selig	JJ, PRP$	2	selig, mein
Gestiegen	NN	2	Gestiegen
fest	RP, DT	2	fest, den
Salomons	NN	2	Salomons
erkennt	NN, JJ	2	erkennt, sie
Hälfte	DT	2	die
Gross	NN	2	Groß
Kostbarkeiten	NN, DT	2	Kostbarkeiten, die
Halt	NN, DT	2	zusammenpassen, nichts
Bewunderung	NN	2	Bewunderung
anderm	NN	2	anderm
schäme	NN, PRP	2	schäme, Ich
Nimmermehr	NN, JJ	2	Nimmermehr, ruhig
Verkennt	NN	2	Verkennt
frage	NN	2	frage
Gar	NN, VB	2	Gar, fühlte
Mädchens	NN	2	Mädchens
Art	NN, PRP$	2	Art, seiner
füllen	VB	2	füllen
Ton	PRP$, NN	2	sein, Assads
Beifall	NN	2	Beifall
Punkt	NN	2	Punkt
weiblich	JJ, DT	2	weibliche, ein
verschwinden	VB, RP	2	verschwand, verschwunden
binden	VB, NN	2	band, Mädchen
übrige	NN, DT	2	übrige, das
Ichs	NN, RB	2	Ichs, ob
Geschichte	NN	2	Geschichte
heitre	NN	2	heitre
Topf	NN	2	Topf
verdienen	VB	2	verdienen
Schulden	NN, JJ	2	Schulden
Wärs	NN	2	Wärs, Liebe
leiden	VB	2	litt
Guen	DT	2	das
Franke	NN, NNP	2	Franke
reiten	NN, PRP	2	Ihn, ihn
Schwärmerinnen	NN, DT	2	Schwärmerinnen, den
dritt	DT	2	ein, Den
Schwachheit	NN, DT	2	Schwachheit, diese
ergründet	NN	2	ergründet
ergründen	NN	2	ergründen
Sogleich	DT, NN	2	das, Pfand
Eben	NN	2	Eben, vollends
Vergessen	NN, PRP	2	Vergessen, ich
geschehn	NN	2	geschehn
trennen	VB, PRP$	2	trennen, Ihr
herzlich	JJ, NN	2	herzlich, herzlicher
Botschaft	JJ, NN	2	Botschaft
rot	JJ, VB	2	rote, roter
Dings	NN, JJ	2	Dings, Des
mache	NN	2	mache
Grossmut	NN	2	Großmut
hattet	NN	2	hattet, Engel
Wahl	NN	2	Wahl
Religion	NN	2	Religion
Kalt	NN	2	Kalt
Milde	NN	2	Milde
gefangner	NN	2	gefangner
Stimm	JJ, CC	2	sanfter, und
michs	RB, PRP	2	Wenn, er
Worten	NN, IN	2	kurzen, mit
Kniee	NN, VB	2	Kniee, meine
bange	PRP, RB	2	mir, nicht
verbergen	TO, RB	2	zu
Verlangen	VB, NN	2	Verlangt, Verlangen
springen	VB, PRP	2	springt, ich
Preis	NN	2	Preis, Pöbels
Wirst	WRB	2	Wirst
gestillt	NN	2	gestillt
bleibt	VB	2	bleibt
Retter	NN	2	Retter
glücklich	JJ, VB	2	glücklich, Ist
schleppen	VB, NN	2	schleppen, Kloster
Rauch	NN	2	Rauch
Brav	NN, NNP	2	Brav, Nils
unsern	PRP$	2	unsern
Angesicht	NN	2	Angesicht
Unterschied	NN	2	Unterschied
gewohnt	JJ	2	gewohnt
Tabor	IN	2	auf
Freunds	NN	2	Freunds, Eures
mag	VB	2	mag
tötet	NN, IN	2	tötet, schon
verachten	VB	2	verachten
töten	VB	2	getötet, töten
Glaubt	NN	2	Glaubt
ungern	NN	2	ungern
Menge	NN	2	Menge
Stauffin	DT	2	eine
weissen	PRP$, IN	2	weißen, Im
Buch	DT, NN	2	Das, Euerm
Begreifen	VB	2	Begriffe
Unkraut	NN, DT	2	Unkraut, das
erwerben	VB	2	erwerben
bezahl	NN	2	bezahl
Gerechtigkeit	JJ	2	Gerechtigkeit, ewiger
Mild	NN	2	Mild
Kette	NN, PRP$	2	Kette, ihrer
verzeiht	NN	2	verzeiht
ungewohnt	NN	2	ungewohnt
wackrer	NN	2	wackrer, Ah
Davids	NN, JJ	2	Davids
reif	JJ, RB	2	reif, Sehr
Datteln	NN	2	Datteln
drohen	NN, RB	2	Schicksal, nicht
Wesen	NN	2	Wesen
Schicksal	NN, PRP	2	Schicksal, ihr
quitt	JJ	2	quitt
Böses	IN, NN	2	viel, Erwiesen
wirken	VB	2	wirken, wirkt
Eue	JJ	2	Euer
entbrech	JJ	2	entbrechen
unternehmen	RB, TO	2	erst, Zu
Problema	DT	2	ein, Ein
Rings	NN	2	Rings
Möglichkeit	NN	2	Möglichkeit
Elend	NN	2	Elend
and	JJ, DT	2	ander, ein
Obs	NN	2	Obs
vollends	UH, IN	2	Nun, Wenn
sau	JJ	2	sauer
Hiess	NN, DT	2	dünkt, Der
Hals	NN, DT	2	Hals, den
Unschuld	NN, DT	2	Unschuld, der
liebsten	NN, IN	2	liebsten, am
Schlinge	NN	2	Schlinge
entspräche	NN	2	entspräche
Ringes	NN	2	Ringes
Furcht	NN, DT	2	Furcht, diese
Netze	NN	2	Netze
Schwerd	NN, NNP	2	Schwerd
aufzudringen	NN	2	aufzudringen, Euch
weitern	RB, VBN	2	weiter
betrachten	VB	2	betrachten, darf
ehrwürdger	NN	2	ehrwürdger
Männer	NN	2	Männer
fliessen	VBN, VB	2	geflossen, fließen
Gebrauch	VB	2	wird, machen
Männern	NN, JJ	2	Männern, gewissen
verzeih	NN, PRP	2	Ah, Ich
Christendamen	JJ	2	hübschen, hübsche
brauchst	NN, PRP	2	Taten, du
solltet	NN	2	solltet
bekam	JJ	2	bekam
väterlich	JJ, NN	2	väterlichen, ganzes
einst	RB, IN	2	einst
Boden	NN	2	Boden
tut	VB	2	tut
Askalon	IN	2	bei
Kirch	NN, PRP$	2	Kirch, ihre
Darun	IN	2	in, zu
Büchern	IN	2	von
Ansehn	NN, NNP	2	Ansehn
Stich	NN, NNS	2	Stich, Stiche
Höchsten	NN	2	Höchsten
Geträumt	JJ, IN	2	mir, so
glaube	VB, PRP	2	glaube, Ich
Väter	DT	2	der, Der
nächst	JJ, DT	2	nächsten, Des
Besten	NN, IN	2	Besten, Zum
voraus	RP, NN	2	voraus, Schurkerei
ehedemen	VB	2	ehedem
zwanzig	CD	2	zwanzig
Eisen	NN	2	Eisen
zittern	VBN, VB	2	gezittert, zittern
Schatzes	NN	2	Schatzes
lehren	VB	2	lehrt, lehren
Geleiten	VB, NN	2	Geleitet, Geleiten
Stolzes	NN	2	Stolzes
Nochen	RB, NN	2	Noch, Grab
erstenmal	IN, RP	2	erstenmal
neuem	NN	2	neuem
Vergesst	NN, RB	2	Vergeßt, wohl
goldnen	IN, DT	2	mit, die
wozu	WRB, NN	2	wozu, Gelegenheit
Verächtlich	JJ, IN	2	Verächtlich, wie
wärst	NN	2	wärst, Sonst
nötig	JJ, RB	2	nötig, Sehr
sichs	JJ, PRP	2	er, Er
Eilt	NN, RB	2	Eilt, dazu
Hass	RB, NN	2	Wenn, unversöhnlichsten
kosen	NN, WP	2	Künste, Was
öfters	RB	2	öfters
rühmen	PRP, NN	2	mich, Mamelucken
essen	VB	2	essend, gegessen
bergen	VB	2	bergen
Stirn	NN, PRP$	2	Stirn, seiner
strich	NNP, JJ	2	strich, striche
gesagt	VB, RB	2	gesagt, nichts
fühlte	RB, VBN	2	fühlte, verbunden
schönen	PRP$	2	schönen
Zeichen	NN	2	Zeichen
Schurkerei	DT	2	der, Die
Künstler	NN	2	Künstler
horch	NN	2	horch
erinnern	VB	2	erinnern
kleiden	VB	2	kleiden
erinnert	NN	2	erinnert
zanken	NN	2	zanken, Dir
Bücher	UH, DT	2	Nun, Die
gleichwohl	IN	2	gleichwohl, Wenn
Schmerz	NNS, NN	2	Schmerzen, Mein
Mühe	NN	2	Mühe
wiedersehn	NN	2	wiedersehn
Erzogen	NN	2	Erzogen
sodann	NNP, VB	2	sodann, bin
Briefchen	VB	2	Briefchen
Eltern	PRP$, NN	2	seinen, Eure
Gelds	NN	2	Gelds
Mauer	NN	2	Mauer
Traum	DT, IN	2	jene, als
wohin	RP, RB	2	wohin
elend	JJ	2	elend
begnadigen	VBN	2	begnadigt
liebste	NN	2	liebste
Gefangner	PRP$, NNP	2	dein, Mein
Schreck	NN	2	Schreck
Eräugnet	NN	2	Eräugnet
teu	JJ, CC	2	teuer, und
Bedeckung	JJ, DT	2	frische, die
hinauf	IN	2	hinauf
Türe	NN	2	Türe
daraufen	NN	2	Zug, verfehlt
heben	VBN, VB	2	gehoben, hebt
Zusammen	RB, DT	2	dort, beide
Gespielt	NN	2	Gespielt
geliebt	NN, RB	2	geliebt, nicht
wacht	NN, RB	2	wacht, da
quälen	RB, NN	2	so, Liebe
Wirds	NN	2	Wirds
alsdann	NNP, NN	2	alsdann
lautern	NN, DT	2	lautern, den
verfügen	VB	2	verfügt, verfügen
rächen	VB	2	rächen
ertragen	VB, RB	2	ertragen, nicht
allemal	RB, IN	2	allemal, für
widersprechen	VB	2	widersprechen
Fleisch	NN	2	Fleisch
Betrogen	NN, DT	2	Betrogen, nichts
Grille	NN	2	Grille
Gräber	NN	2	Gräber
deutlich	JJ	2	deutlich
Erde	NN	2	Erde
Emir	IN, NN	2	Daß, Willkommen
abe	JJ, NN	2	aber, Filneck
Armes	NN	2	Armes
bestimmen	VB, PRP$	2	bestimmen
wärmster	NN	2	wärmster
Nenn	NN	2	Prinzessin, Schwester
schaudert	NN	2	schaudert
Unglaublich	JJ	2	Unglaublich, Unglaubliche
Verschlingen	NN	2	Verschlingen
zerstreut	NN	2	zerstreut
würdet	NN	2	würdet
nötigen	VBN	2	nötig
erlauben	RB	2	nur, nicht
Feste	NN	2	Feste
hart	JJ, RB	2	harten, endlich
nimmermehr	NN, IN	2	nimmermehr, wohl
borge	NN	2	borge
dirs	NN	2	sag, verschmäht
unterschlagen	IN, PRP	2	Doch, sich
willkomm	JJ, RB	2	willkommen, so
weisse	NN, DT	2	weiße, Der
stutzt	NN, PRP$	2	stutzt, Ihr
bedenken	VB	2	bedenken
Religionen	NN	2	Religionen
Leier	JJ	2	alte
Pflicht	NN	2	Pflicht
freue	NN, PRP	2	freue, Ich
Neubegier	NN, JJ	2	Neubegier, liebe
aufgewachsen	PRP$, NN	2	wir, Augen
erschaffen	VB	2	erschaffen, sein
Darumen	RB, NN	2	Darum, Leben
denkst	PRP, DT	2	mir, Das
erlügen	VB	2	ist
Unrecht	NN, IN	2	Unrecht, sehr
gabt	NN	2	gabt
Freiheit	NN, DT	2	Freiheit, die
Stande	NN, IN	2	Stande, Im
Freude	NN	2	Freude, Sultan
Reich	JJ, NNS	2	Reichen, Reiche
Knall	NN	2	Knall
Kennst	NN, MD	2	Kennst, will
schüchtern	JJ, RB	2	schüchtern, so
Vermuten	NN	2	Vermuten
treiben	VB	2	treiben
eignet	NN	2	eignet
zusammenpassen	PRP, JJ	2	sie
Stuhle	NN	2	Stuhle
Fleiss	NN	2	Fleiß
Mohren	NN	2	Mohren
Tode	NN	2	Tode
kamt	NN, PRP$	2	kamt, Ihr
Ergebenheit	NN	2	Ergebenheit
Versichert	NN, IN	2	Transports, ganz
liess	VB	2	ließ
Umsonst	NN	2	Umsonst
dus	NN	2	dus, Bist
bliebe	NN, PRP	2	bliebe, Ich
Ehrwürdger	NN	2	Ehrwürdger
sonder	JJ, PRP	2	sonder, Sie
aufgedrungen	NN	2	Vater
Galle	NN	2	Galle
abzuwenden	VB	2	abzuwenden
nützen	VB	2	nützen
sichtbar	JJ	2	sichtbar
verlassen	VB, RB	2	verlassen, hier
Hunger	NN	2	Hunger
Wette	NN, DT	2	Wette, die
Wahne	NN	2	Wahne
mangeln	WDT, PRP	2	was, ihr
bemerken	VB, JJ	2	bemerken, reif
Getäuscht	NN, JJ	2	Getäuscht, Phantasie
Geht	JJ, VBN	2	Geht, erwünscht
Anschlag	NN	2	Anschlag
ungewiss	JJ	2	ungewiß
rechts	RP, RB	2	rechts
Kummer	NNP	2	Kummer
brechen	VBN, NN	2	gebrochen, Hals
Oh	VB, RB	2	haben, immer
Bote	NN	2	Bote, willkommner
sitzen	VB, PRP$	2	sitzen
Gelernt	NN	2	Gelernt
schützen	VB	2	schützen
Siegel	NN	2	Siegel
Koch	NN	2	Koch
Tritt	NN, VB	2	Tritt, erhielt
Faktum	NN	2	Faktum
schwört	NN, RB	2	schwört, nicht
Feld	NN	2	Feld
traf	NN, CC	2	traf, Und
Verlegenheit	NN	2	Verlegenheit
endlichen	NN, RB	2	Ha, Nicht
Einsicht	NN	2	Einsicht
Neu	JJ	2	Neu, Neues
Erwarten	NN, NNP	2	Erwarten
Gegenteil	NN, JJ	2	Gegenteil, aufs
Hände	DT, NN	2	Die, Paar
Gerettet	NN	2	Gerettet
wenigstensen	NN, PRP	2	unterwegens, er
Lilla	PRP$, NN	2	seiner, Ah
Gib	NNP, JJ	2	Gib, behutsam
wiederkommen	NN	2	wiederkommen
meiner	RB, PRP	2	meiner, mich
Ruhm	NN	2	Ruhm
fühlt	RB, VB	2	fühlt
gemein	JJ, DT	2	gemeinen, ein
beliebt	JJ	2	beliebt
Aberglauben	NN, DT	2	Aberglauben, Der
stünde	NN, VB	2	stünde, erweisen
süssen	NN, DT	2	süßen, dieser
Gelt	NN, JJ	2	Gelt, sonderbar
Vorsatz	RP, JJ	2	Vorsatz, festen
Bin	NN	2	Bin
leb	NN	2	leb
lee	JJ, DT	2	leer, eine
Bezahl	NN	2	Bezahl
bereuen	VB, RB	2	bereuen, nie
Ströme	NN	2	Ströme, goldnen
Finger	NN, DT	2	Finger, die
verwickeln	NN, IN	2	verwickeln, zu
Hui	NN, JJ	2	Hui, übel
wenigst	JJ	2	wenigsten
Reitknecht	DT	2	ein, Der
Land	NN	2	Land
verbrannte	NN	2	verbrannte
links	RP, RB	2	links
Zahl	NN	2	Zahl
kennt	RB, VB	2	kennt
Gebracht	NN, JJ	2	Gebracht, selbst
langen	VB, NNP	2	lange, Uns
geschmeichelt	NN	2	geschmeichelt
Verstand	NN	2	Verstand
spottest	NN	2	spottest, Du
Opfer	NN	2	Opfer
irren	VB, IN	2	irren, Zu
Euertwegen	NN	2	Euertwegen
Held	DT	2	Der, ein
horchen	VB	2	horchen
Fehlern	WP, PRP$	2	welchen, seinen
gesteckt	NN, DT	2	gesteckt, nichts
Titel	NN	2	Titel
tus	NN, DT	2	O, o
Blicken	NN, IN	2	Blicken, mit
Spenden	NN, DT	2	Spenden, Die
Deutscher	JJ, NN	2	kein, geborner
beginnen	VB	2	beginnt, beginn
umgekehrt	RP	2	umgekehrt
wandelt	NN	2	wandelt
reg	JJ, RB	2	rege, wieder
Teil	NN, JJ	2	Teil, größern
Wovon	NN	2	Wovon
verächtlich	JJ	2	verächtlich
unbegreiflich	JJ	2	unbegreiflichen, unbegreiflich
Defterdar	NN	2	Defterdar
Vorrecht	NN	2	Vorrecht
Volkes	NN	2	Volkes
verwünscht	JJ, NN	2	verwünschten, Welt
gebären	VB	2	geboren
Paar	NN, DT	2	Paar, ein
umgekommen	NN	2	umgekommen
Ewigkeit	NN, IN	2	Ewigkeit, In
hiess	VB, DT	2	hieß, Das
Fassung	NN	2	Fassung
Blatt	NN	2	Blatt
Verzeiht	VB	2	war, sein
hättest	IN, WRB	2	hättest
Gekannt	NN	2	Gekannt
Hinein	NN	2	Hinein
Geschöpf	PRP$, NN	2	solch, Geschöpf
Karawane	DT	2	Die, die
geleg	JJ, NN	2	gelegen, Gott
wirklicher	NN	2	wirklicher
Werkzeug	NN, JJ	2	Werkzeug, Des
empfangen	NN, PRP	2	Hiermit, mich
Augenbraunen	NN	2	Augenbraunen
Lieber	NN	2	Lieber
rein	RB	2	rein
Aufs	JJ, NN	2	Aufs, Christentum
Dufte	NN, NNP	2	Dufte
seht	VB, RB	2	seht
Gesetzt	NN, IN	2	Gesetzt, aus
Gefühl	NN	2	Gefühl
Stoff	NN, JJ	2	Stoff
vergebens	RP, RB	2	vergebens, sollst
Weisheit	NN	2	Weisheit
Zugleich	RP, PRP	2	Zugleich, ihnen
Hätt	NN	2	Hätt
Erraten	NN, PRP	2	Erraten, dich
stumpfen	NN	2	stumpfen
Wichtigkeit	NN	2	Wichtigkeit
Schickt	NN	2	Schickt, Sittah
Überlegung	NN, RB	2	Überlegung, nicht
Funken	NN	2	Funken, einzger
allmählig	JJ, NN	2	allmählig, Vernunft
Denk	NN, VB	2	Denk, werde
Sturm	NN, IN	2	Sturm, Im
melancholisch	JJ	2	melancholisches, melancholisch
eur	NN, JJ	2	eur
brauche	NN	2	brauche
schenkte	NNP, NN	2	schenkte
schelten	VB, IN	2	schelten, zu
Wohltat	NN, DT	2	Wohltat, eine
Bösewicht	NN, DT	2	Bösewicht, den
kleinst	NNP, VB	2	kleinst, kleinste
getauft	NNP, VB	2	getauft, sei
Osten	NN	2	Osten
wen	WP	2	wen
Töchterch	DT, JJ	2	Ein, eigen
Pflegen	NN, RB	2	Pflegen, so
Eigentum	NN, PRP$	2	Eigentum, dein
schwören	VB	2	schwören
Schatzmeister	NN	2	Schatzmeister
Gabe	NN	2	Gabe
dennoch	IN, RB	2	dennoch
dreist	JJ, NNP	2	dreist, Sprich
Geniessen	NN	2	Genießen, Muße
Rätsel	NN	2	Rätsel
rasch	JJ, PRP$	2	rasch, mein
Reichtums	NN, DT	2	Reichtums, des
Erziehen	NN, JJ	2	Christenkind, Töchterchen
Willen	NN, JJ	2	Willen, guten
neidisch	JJ	2	neidisch
hiervon	RB	2	hiervon
bescheid	JJ	2	bescheiden
Gelder	DT	2	die, der
Gestürzte	DT	2	der
Todes	NN	2	Todes
übrig	JJ, WDT	2	übrig, was
Brüder	IN, NN	2	Brüder
Zudem	RB	2	Zudem, weg
Eifer	NN, DT	2	Eifer, der
Erzählt	NN, JJ	2	Erzählt, allgemein
auserlesen	NN, DT	2	auserlesen, alles
drin	IN, NNS	2	drin, Gebete
Heer	NN, NNS	2	Heer, Heere
spielt	NN	2	spielt
Jüngling	NN, DT	2	Jüngling, einem
Wüste	NN	2	Wüste
spiele	NN	2	spiele
alleinen	VBN, RB	2	allein
öfter	NN	1	öfter
wäret	NN	1	wäret
Betreiben	JJ	1	selbst
zöge	NN	1	zöge
Abschach	NN	1	Abschach
Brandmal	RB	1	Brandmal
Aberglaub	DT	1	Der
euern	NN	1	euern
Charakter	PRP$	1	meinem
hinterbracht	NN	1	hinterbracht
abgelegnen	NN	1	abgelegnen
Platz	NN	1	Platz
Erfüllet	NNP	1	Erfüllet
Zelle	PRP$	1	meine
Farbe	NNS	1	Farben
Ruine	NN	1	wankenden
jemals	RB	1	Noch
Pflegevater	DT	1	einem
Zusprach	NN	1	Zusprach
getobt	NN	1	Gezürnt
wich	NN	1	wich
pflegen	PRP	1	mich
Beräuchern	PRP	1	sich
Roche	NN	1	Roche
Wuchs	NN	1	Wuchs
Sack	NN	1	Sack
Bestimmt	NN	1	Bestimmt
wahrhaftig	JJ	1	wahrhaftig
launig	JJ	1	launigen
garstger	NN	1	garstger
Sermon	JJ	1	trefflichen
Frisch	JJ	1	Frisch
Wach	JJ	1	Wachen
Solls	NN	1	gewiß
deutsch	JJ	1	deutscher
Wunderbaren	NN	1	Wunderbaren
Verlängert	NN	1	Verlängert
Eigensinn	PRP$	1	meinen
bürg	NNP	1	bürg
Hängts	NN	1	Hängts
Willkommen	RB	1	ja
Forscher	NN	1	Forscher
Moses	NNP	1	Moses
entgegensetzen	DT	1	nichts
Barschaft	NN	1	Barschaft
contraten	VBN	1	contra
Besondersen	VB	1	sind
üben	IN	1	zu
zugeschworen	NN	1	Haß
trotzt	NN	1	Wohltat
Alten	DT	1	einem
Schlimm	JJ	1	wahrlich
toll	JJ	1	toll
brauchts	IN	1	Hier
Spur	NN	1	Spur
Pflegetochter	JJ	1	meine
Asien	NN	1	Asien
Stürzt	NN	1	Stürzt
fördern	VB	1	fördern
schänden	VB	1	schänden
Braut	IN	1	Denn
erschreckest	NN	1	erschreckest
bedünkt	NN	1	Geist
Mittelgut	NN	1	Mittelgut
nannt	VB	1	nannt
ungesittet	JJ	1	ungesittet
verspreche	PRP	1	ich
willkommner	DT	1	ein
Hierher	PRP	1	ihn
Entläuft	NN	1	Entläuft
worauf	WRB	1	worauf
Allgerechter	VB	1	müssen
wundersüchtges	NN	1	wundersüchtges
klemmt	NN	1	klemmt
grenzt	NN	1	Schlimmes
erfreut	VB	1	erfreut
trugs	NN	1	Kind
Länder	NN	1	Länder
allzeit	NN	1	allzeit
Mantels	NN	1	Mantels
solcherlei	NN	1	solcherlei
Hättst	NN	1	Hättst
sprengte	VB	1	waren
innigst	JJ	1	innigster
Torheit	NN	1	Torheit
müd	JJ	1	müde
Nackter	NN	1	Nackter
Teufels	NN	1	Teufels
desselben	JJ	1	Wert
vergleichen	NN	1	Tempelherrn
Gefälligkeit	NN	1	Gefälligkeit
Wirt	NN	1	Wirt
gossen	VB	1	goß
aufgebunden	NN	1	Vater
Stacheln	NN	1	Stacheln
vertieft	NN	1	Gespräch
empfang	NN	1	empfang
Unterschleif	NN	1	Unterschleif
sandte	NN	1	sandte
geraten	VB	1	irgendwo
schiehen	VB	1	geschieht
Jung	JJ	1	Junger
Licht	NN	1	Licht
Fuchses	NN	1	Fuchses
gehorche	PRP	1	ich
bevölkern	VB	1	bevölkern
hieren	NN	1	Ihn
Kindch	DT	1	das
allzustreng	NN	1	allzustreng
Zwaren	RP	1	Zwar
Blume	DT	1	diese
stellt	RB	1	So
bewusst	JJ	1	bewußt
herein	RB	1	nur
verkenn	NN	1	verkenn
brannte	NN	1	brannte
warf	PRP	1	es
warb	IN	1	nun
Christenmensch	DT	1	ein
Willkür	NN	1	Willkür
Rache	NN	1	Rache
Erklärt	NN	1	Erklärt
Gräbern	NN	1	Gräbern
entgelten	PRP	1	sie
drosseln	VB	1	drosseln
Vorteile	NN	1	Vorteile
schäm	NN	1	schäm
Schwächsten	DT	1	dem
unterhalten	VB	1	unterhalten
gesund	RB	1	sonst
sond	JJ	1	sonder
befehl	NN	1	befehl
hochgepriesner	JJ	1	hochgepriesner
Engelschwärmerin	NN	1	Engelschwärmerin
betrogen	PRP	1	mich
Erwiesen	NN	1	Böses
erdacht	NN	1	erdacht
Delk	NN	1	Delk
Jordan	NNP	1	Jordan
gebieten	VB	1	gebieten
Buhler	IN	1	an
ergreifen	VBN	1	ergriffen
heilsamer	NN	1	heilsamer
lad	NN	1	lad
Fieber	NN	1	Fieber
Bessres	NN	1	Beßres
unterstützen	VB	1	unterstützen
Konnt	NN	1	Schurken
Berichten	NN	1	Brief
Seht	NNS	1	Träume
Winkel	NN	1	Winkel
Stunde	NN	1	Stunde
Ungewissheit	NN	1	Ungewißheit
Verschwunden	RB	1	Verschwunden
bösen	DT	1	einen
gesteht	VB	1	gesteht
frostig	JJ	1	frostig
Enden	DT	1	beiden
Geraumer	NN	1	Geraumer
blind	JJ	1	blind
Wohltun	NN	1	Wohltun
eigen	JJ	1	eigenen
Frage	NN	1	Frage
Getauft	NN	1	Getauft
Ausdruck	NN	1	Ausdruck
Hiernieden	NN	1	Hiernieden
Wille	NN	1	Wille
ungetreuen	NN	1	ungetreuen
sprächst	JJ	1	Du
schone	IN	1	Nur
Ahnenprobe	NN	1	Ahnenprobe
Wolke	NN	1	Wolke
Behandeln	NN	1	Behandeln
Gesichter	NN	1	Gesichter
schüttelt	NN	1	schüttelt
Bande	NN	1	Bande
Gefangnen	NN	1	Gefangnen
verhüllen	VB	1	verhüllen
Äsern	NN	1	Äsern
bestechen	TO	1	zu
filzig	JJ	1	filzig
Strassen	NN	1	Straßen
Ziel	DT	1	das
Gehabt	NN	1	Gehabt
umschatten	NN	1	umschatten
geweissen	VB	1	gewiß
Darübern	NN	1	entdeckt
Setz	NN	1	Setz
Töte	NN	1	Töte
süsses	PRP$	1	deiner
ausser	RP	1	außer
klingen	VB	1	klingt
Rechts	WP	1	was
Verhungern	NN	1	Verhungern
garstgen	NN	1	garstgen
abzugehen	VB	1	durften
vermuten	VB	1	vermuten
unverzeihlich	DT	1	dieser
verschlissen	NN	1	verschlissen
Christlichste	DT	1	Der
Bewusstsein	NN	1	Bewußtsein
rauhen	DT	1	dem
christlichem	IN	1	Aus
Transport	DT	1	der
Saumti	JJ	1	Saumtier
glaublicher	NN	1	glaublicher
wahrscheinlich	JJ	1	wahrscheinlich
Uralte	NN	1	Uralte
nisten	JJ	1	tiefer
Schiehen	WDT	1	was
hergeschickt	NN	1	hergeschickt
Stirne	NN	1	Stirne
tolerante	DT	1	Der
Lassts	VB	1	gestorben
Kält	NN	1	Kält
Besitzt	NN	1	Besitzt
glaublichen	JJ	1	glaubliche
ungleich	IN	1	Wie
Kostbares	NN	1	Kostbares
Erkenntlichkeit	NN	1	Erkenntlichkeit
Entdeckung	DT	1	die
werdt	RB	1	So
Wart	MD	1	wollen
Wars	RB	1	nicht
Dürft	NN	1	Dürft
zweimal	RB	1	Nicht
überflüssig	JJ	1	überflüssig
Schien	NN	1	Schien
Bemerkte	DT	1	Man
geteilt	NN	1	geteilt
Beschwören	NNP	1	Beschwören
errötest	IN	1	sehr
wenigem	NN	1	wenigem
unterscheidet	NN	1	unterscheidet
Nächst	JJ	1	Nächster
getrau	NN	1	getrau
unendlich	JJ	1	unendlich
Bunde	NN	1	Bunde
gebettelt	NN	1	gebettelt
vertrau	NN	1	vertrau
Stoffen	NN	1	Stoffen
freu	WP	1	Was
Betret	NNP	1	Betret
Gezürnt	NN	1	gerechtet
Dankbarkeit	PRP$	1	deine
Farb	NN	1	Farb
vorbereiten	NN	1	Sultan
lüstern	JJ	1	lüstern
Hofen	VB	1	Hofe
richten	TO	1	zu
begleite	PRP	1	sie
Seiner	PRP$	1	Seiner
Seines	PRP$	1	Seines
Ihmen	VBN	1	Ihm
grade	NN	1	grade
Richtig	NN	1	Filneck
sandt	RB	1	So
zankt	NN	1	zankt
fern	VB	1	War
Aushöhlen	NN	1	Aushöhlen
Gesandte	NN	1	Gesandte
gefährlich	JJ	1	gefährlich
Versteht	DT	1	das
bürget	NN	1	bürget
raten	VB	1	raten
mindsten	IN	1	zum
ratet	NN	1	ratet
Errätst	RP	1	bestellt
verflossenen	NN	1	verflossenen
bürgen	VBN	1	bürgt
Woher	NN	1	wüßte
wussen	PRP	1	Er
weinst	NN	1	Du
naht	NN	1	naht
bescheidne	NN	1	bescheidne
wähnen	VB	1	wissen
flüchten	PRP	1	sie
Such	NN	1	geh
gestrenger	JJ	1	gestrenger
vielem	NN	1	vielem
Sonderlings	NN	1	Sonderlings
Lüge	JJ	1	keiner
Geschützt	NN	1	Geschützt
klebt	NN	1	klebt
verraten	RB	1	schon
windet	NN	1	windet
Feier	NN	1	Feier
herüber	RB	1	auch
tret	NN	1	tret
Apostasie	NN	1	Apostasie
Gebaut	NN	1	Gebaut
durchaus	VB	1	muß
Strafe	NN	1	Strafe
Abraham	NNP	1	Abraham
Entdeckt	VB	1	haben
arabisch	VB	1	kam
vorüber	NN	1	vorüber
Reisst	RB	1	Reißt
Geblüte	NN	1	christlichem
entschuldigen	VB	1	entschuldigen
laden	VB	1	laden
horcht	NN	1	horcht
bleib	CC	1	und
Eins	NN	1	Eins
gestehn	NN	1	gestehn
Sofort	RB	1	nicht
besuchen	VB	1	besuchen
ladet	NN	1	ladet
Vollkommen	NN	1	Vollkommen
ergiessend	JJ	1	ergießend
Brauch	RP	1	wieder
einzge	DT	1	dies
gegriffnen	NN	1	Luft
Verklagen	VB	1	Verklagten
geizig	JJ	1	geizig
verzettelt	DT	1	ein
verwebt	NN	1	verwebt
Schnell	NNP	1	Schnell
eingeplaudert	NNP	1	eingeplaudert
dahinter	DT	1	nichts
Liess	NN	1	Ließ
Sinns	NN	1	Sinns
Zipfel	NN	1	Zipfel
Behutsam	JJ	1	Behutsam
Menschlichkeit	NN	1	Menschlichkeit
singen	VBN	1	gesungen
verstopft	NN	1	verstopft
Weile	NN	1	Weile
Gurt	NN	1	Gurt
Begleitet	NN	1	Begleitet
Andächtig	IN	1	Andächtig
Weils	NN	1	Weils
tiefgeprägte	NN	1	tiefgeprägte
Gimpel	NN	1	Gimpel
Zurück	NN	1	Zurück
fehl	PRP	1	einander
födert	NN	1	födert
mengen	VB	1	mengt
Asch	IN	1	in
Deucht	NN	1	Deucht
Ohrgehenke	NN	1	Ohrgehenke
Knie	DT	1	die
kurzen	IN	1	Mit
Satz	NN	1	Satz
zurückgekommen	NN	1	zurückgekommen
Possen	NN	1	Possen
Fuchse	NN	1	Fuchse
hinab	NN	1	hinab
umkehrt	NN	1	umkehrt
lauscht	NN	1	lauscht
Knochen	NN	1	Knochen
ermessen	NN	1	ermessen
Wartung	NN	1	Wartung
Ehen	VB	1	müssen
saur	PRP	1	es
klügeln	NN	1	klügeln
eingebornen	NN	1	eingebornen
Transports	DT	1	des
sinken	NN	1	Kniee
Filze	NN	1	deinem
Christentume	IN	1	Zum
Beleidigte	NN	1	Beleidigte
Gewandtheit	NN	1	Gewandtheit
schwach	RB	1	zu
rund	RB	1	rund
Konnts	PRP	1	ich
Dacht	NN	1	Dacht
blindlings	RB	1	blindlings
schreibet	NN	1	schreibet
raubt	NN	1	raubt
zahlen	VB	1	zahlt
untersteh	NN	1	untersteh
graute	VB	1	werden
Zuweilen	NN	1	Zuweilen
unschätzbarem	PRP$	1	unschätzbarem
machst	DT	1	Das
Heiland	NN	1	Heiland
auszubitten	NN	1	Plätzchen
wiederkomme	NN	1	wiederkomme
schick	RB	1	So
fürchtet	PRP$	1	verlieren
jüngern	NN	1	jüngern
verlauten	VB	1	verlauten
Vorn	NN	1	Boten
Ruf	NN	1	Ruf
bekannt	JJ	1	bekannt
Nimmt	NN	1	trotzt
beschleuniget	PRP	1	ich
gelänge	NN	1	gelänge
bied	JJ	1	bieder
schenkst	NN	1	schenkst
empfangnen	NN	1	empfangnen
Mittags	NN	1	Mittags
dankt	VB	1	dankte
brausend	RB	1	so
genauer	RB	1	genauer
Geschenk	NN	1	Geschenk
Auferstandnen	NN	1	Auferstandnen
Gesammelt	JJ	1	Haupt
Weissem	NN	1	Weißem
Brust	NN	1	Brust
zweitenmal	IN	1	zum
einverstand	JJ	1	einverstanden
verlange	CC	1	und
zweifelhaften	NN	1	zweifelhaften
versprich	NN	1	versprich
Brechen	VB	1	Brach
Wendung	NN	1	Wendung
stiehlt	NN	1	stiehlt
Geheiss	PRP$	1	dein
Spiels	NN	1	Spiels
erfüllen	VB	1	erfüllten
Arabisch	VB	1	ist
drückts	NN	1	drückts
edle	NN	1	edle
Majestät	NN	1	Majestät
Dankes	NN	1	Dankes
schwächsten	NN	1	schwächsten
Unglücklichen	VB	1	habe
Platze	NN	1	Platze
erleben	RB	1	noch
Regen	NN	1	Regen
schicktet	NN	1	schicktet
Wunders	NN	1	Wunders
Aberwitz	IN	1	an
abgebrannt	NN	1	abgebrannt
Plötzlich	NN	1	Christentempel
zeigt	VB	1	zeigt
betrifft	VB	1	betrifft
Puls	NN	1	Puls
Unglaublichers	NN	1	Unglaublichers
Gefunden	NN	1	Gefunden
Fetze	NN	1	Fetze
Versucher	RP	1	fort
Lustig	RB	1	Lustig
sparts	NN	1	sparts
nachgewirkt	NN	1	nachgewirkt
Trank	NN	1	Trank
ungefälligst	JJ	1	ungefälligsten
nennens	PRP	1	Wir
sendet	PRP$	1	sendet
Kleinigkeiten	NN	1	Kleinigkeiten
fürs	CD	1	eins
Versichrung	DT	1	die
Argwohnen	NN	1	Argwohnen
entfliehen	VB	1	entfliehen
Erzürnt	NN	1	Frevels
Vorurteil	NNS	1	Vorurteile
Nebenzimmer	NN	1	Nebenzimmer
Schutzengel	NN	1	Schutzengel
Schachbrett	NN	1	Ans
Sterben	NN	1	Sterben
Verträglichkeit	NN	1	Verträglichkeit
rühren	VB	1	bin
säh	RB	1	nur
Ohm	RB	1	oder
gewöhnen	IN	1	zu
geliebtesten	NN	1	geliebtesten
eilet	NN	1	eilet
verharren	NN	1	verharren
Nam	WDT	1	jener
Begreifst	NN	1	Begreifst
pfäffisch	JJ	1	pfäffisch
unbedeckt	NN	1	unbedeckt
innigster	NN	1	innigster
traun	NN	1	traun
freuet	NN	1	freuet
vergeb	NN	1	Gott
brenne	NN	1	brenne
nachgedacht	NN	1	nachgedacht
Wünsche	NN	1	Wünsche
aussen	RB	1	außen
Dolch	NN	1	Dolch
Verschwand	NN	1	Verschwand
untergräbst	NN	1	untergräbst
Vorwurfs	JJ	1	Des
brennt	NN	1	brennt
wurmisch	PRP	1	mich
Wünscht	NN	1	Wünscht
Gerechnet	NN	1	Gerechnet
Erliegen	RB	1	oft
Opal	NN	1	Opal
gerechnet	JJ	1	gerechnet
siebenfache	PRP	1	mich
ähneln	VB	1	ähneln
neubegieriger	NNP	1	neubegieriger
verlorner	NN	1	verlorner
äussern	VB	1	äußern
scheu	JJ	1	scheu
ohnehin	VB	1	stand
Strumpf	NN	1	Strumpf
ähnelt	NN	1	ähnelt
weichen	PRP$	1	seines
annochen	NN	1	Euch
anzugehnen	VB	1	anzugehn
Narren	NN	1	Narren
verlernt	NN	1	verlernt
Gleichsam	JJ	1	Gleichsam
wankenden	DT	1	die
Mangel	NN	1	Mangel
angekommen	NN	1	angekommen
prallen	NN	1	prallen
trugt	JJ	1	trugt
entlockt	NN	1	Wunsch
belegen	VB	1	belegen
ausgeliefert	IN	1	sicher
just	JJ	1	just
Streit	NN	1	Streit
setze	NN	1	setze
graden	NN	1	gehe
Handwerk	NN	1	Handwerk
Gärtner	NN	1	Gottes
brennen	VB	1	brennen
wüsst	PRP	1	er
entschliess	NN	1	Geschwind
Flamme	NN	1	Flamme
Garaus	NN	1	Garaus
Schachgesell	NN	1	Schachgesell
weisr	JJ	1	weisrer
gerechtet	IN	1	wohl
besehn	NN	1	besehn
sagtet	IN	1	damals
Blicks	NN	1	Blicks
gierig	JJ	1	gierig
Verwandte	WDT	1	diese
hochbeladenen	NN	1	hochbeladenen
Sidon	NN	1	Sidon
umgesehn	DT	1	einem
Blutbegier	DT	1	der
Versprochne	NN	1	Versprochne
unten	RB	1	unten
Geier	NN	1	Geier
Kohle	IN	1	auf
Zuversicht	NN	1	Zuversicht
erstenmale	NN	1	erstenmale
Gärung	DT	1	dieser
gnügen	VB	1	gnügt
darausen	RB	1	daraus
schirmen	NN	1	schirmen
undankbaren	NN	1	undankbaren
beneidet	NN	1	beneidet
Bedenklich	JJ	1	Bedenklich
Geschmeide	JJ	1	alt
Putz	IN	1	mit
Freuden	NN	1	Freuden
verschossen	NN	1	verschossen
kannen	RB	1	Denn
borg	NNP	1	borg
verwünschte	NN	1	verwünschte
wirft	VB	1	wirft
Geführt	NN	1	Karawane
erhört	NN	1	Gebet
Bäumen	JJ	1	allen
Kahira	IN	1	von
ums	IN	1	ums
dehnen	VB	1	dehnen
sinnreich	NN	1	sinnreich
grauen	PRP$	1	grauen
wachend	JJ	1	mir
Leu	JJ	1	Heißt
mehrern	VB	1	mehrere
zeihen	VB	1	zieh
Ziele	IN	1	Zum
Verschwenden	NN	1	Buhler
hundertmal	RB	1	wohl
aufbehalten	NN	1	aufbehalten
bricht	NN	1	bricht
hineingestossen	NN	1	hineingestoßen
Jericho	IN	1	unweit
zogs	PRP	1	Ich
nahte	NN	1	nahte
vertraulich	JJ	1	vertraulicher
entwöhnen	NN	1	entwöhnen
Euphrat	NN	1	Euphrat
Einerlei	NN	1	Hineingeschrieben
Grad	NN	1	Grad
Nerve	NN	1	Nerve
besoldet	NN	1	besoldet
auszuspüren	NN	1	auszuspüren
Eigennützigste	NN	1	Eigennützigste
Erborgen	NN	1	Erborgen
aufgesucht	NN	1	aufgesucht
drückt	VB	1	drückte
Christendirne	IN	1	als
abgemessen	IN	1	wie
obs	NN	1	obs
erkenn	DT	1	die
Treibt	NN	1	Neubegier
woran	WP	1	woran
Allwo	NN	1	auszubitten
sinnt	NN	1	sinnt
Oheim	NN	1	Oheim
Schwärmer	NN	1	Schwärmer
mocht	NN	1	mocht
dürfte	VB	1	dürfte
vermählt	NN	1	vermählt
rätselhaften	NN	1	Euers
tragend	JJ	1	tragend
Geschadet	NN	1	Geschadet
leerer	NN	1	leerer
verbittet	NN	1	sichs
Hältst	NN	1	Hältst
wag	NN	1	wag
verhält	PRP	1	sich
trüge	NN	1	trüge
geschieht	RB	1	geschieht
unters	NN	1	unters
unterliegen	VB	1	unterliegt
Verbindlichkeit	NN	1	Verbindlichkeit
verbitten	NN	1	verbitten
Kosten	NN	1	Kosten
vorgelogen	NN	1	vorgelogen
Wärt	NN	1	Wärt
zählen	VB	1	zählen
liesse	NN	1	ließe
unentbehrlich	JJ	1	unentbehrlich
Nagel	NN	1	Nagel
erfahr	NN	1	erfahr
Zerstreuung	NN	1	Zerstreuung
Besitzer	NN	1	unrechtmäßigen
Freudigkeit	NN	1	Freudigkeit
Gesucht	NN	1	Gesucht
Bauer	NN	1	Bauer
ausgeworfen	NN	1	ausgeworfen
woher	RP	1	woher
Weges	JJ	1	nächsten
Kräfte	NN	1	Kräfte
Voll	JJ	1	Voll
vertrautes	NN	1	Euch
Hiernächst	NN	1	Hiernächst
Verdirb	NN	1	Verdirb
Sklav	NN	1	Sklav
Stück	NN	1	Stück
schlauen	NN	1	schlauen
prüfen	VB	1	prüfen
Feldzug	NN	1	Feldzug
sträuben	VB	1	sträubt
erscheinen	VB	1	erscheinen
unwert	NN	1	Reizes
nochmalsen	NN	1	Habt
Dergleichen	JJ	1	selbst
selgen	IN	1	vom
angst	RB	1	so
einmalten	IN	1	als
Willst	WRB	1	Willst
bekehren	VB	1	bekehren
feierlich	JJ	1	feierlich
Neuste	NN	1	Neuste
niedrig	RB	1	so
Betaur	JJ	1	Betaur
morgens	IN	1	morgens
Falle	NN	1	Falle
stutzen	VB	1	stutzen
entlassen	VB	1	entlassen
Geärgert	IN	1	oft
Weiberkopf	NN	1	Weiberkopf
enträtsln	RB	1	enträtsle
vollziehn	NN	1	vollziehn
bestehn	NN	1	bestehn
Künste	IN	1	Solls
geschwebt	VB	1	geschwebt
Waisen	NN	1	andre
Aufrichtig	RP	1	Aufrichtig
beschrieben	NN	1	beschrieben
scharf	JJ	1	scharfen
ersetzen	VB	1	ersetzen
drumen	RP	1	drum
Davonen	RB	1	Davon
angeraten	IN	1	schon
Gütern	NN	1	Gütern
dicht	JJ	1	dicht
gesät	PRP$	1	Ihr
Baum	NN	1	Baum
gröss	JJ	1	größer
leidet	NN	1	leidet
knickerte	PRP$	1	er
seitwärts	IN	1	hier
emsig	JJ	1	emsig
Verlieren	JJ	1	neue
sollts	NN	1	sollts
setzt	VB	1	setzt
Brett	NN	1	Brett
Gewonnen	NN	1	Gewonnen
hierzu	NN	1	hierzu
lächelnd	NN	1	lächelnd
Getrieben	NN	1	Getrieben
Kluge	NN	1	Kluge
Bär	NN	1	Bär
Hinauf	NNP	1	Hinauf
Vornehmlich	JJ	1	Vornehmlich
Burg	NN	1	Burg
entdecke	JJ	1	selbst
Angehörigen	DT	1	die
schweige	NN	1	schweige
Adern	JJ	1	allen
deswegen	RB	1	deswegen
Gepriesner	NN	1	Gepriesner
weils	NN	1	weils
Gassen	DT	1	Die
Gegeben	NN	1	Gegeben
spielte	NN	1	spielte
stiften	RB	1	nun
Erlogen	JJ	1	Gunst
Wen	VB	1	holen
belohn	PRP	1	ihr
fahr	NN	1	Gut
Stufen	NN	1	versunknen
wenns	NN	1	wenns
entreisst	NN	1	entreißt
Schwerte	NN	1	Schwerte
faulen	NN	1	faulen
Ehrlichkeit	NN	1	Ehrlichkeit
Ergiessung	NN	1	Ergießung
offner	NN	1	edler
liesset	NN	1	ließet
Nächt	CC	1	und
Gebe	NN	1	Gebe
fasset	IN	1	freilich
Grabe	DT	1	dem
Antlitz	NN	1	Sultans
wähnt	PRP$	1	Ihr
mächtiger	NNP	1	mächtiger
mächtiges	NN	1	mächtiges
Gebiete	NN	1	Gebiete
Buchgelehrsamkeit	JJ	1	kalte
tröstender	NN	1	tröstender
Kindes-Kindeskindern	NN	1	Kindes-Kindeskindern
Bonafides	JJ	1	Bruder
Vermögen	NN	1	Tempelherren
Brauchts	NN	1	Brauchts
Pfiffigkeit	NN	1	Pfiffigkeit
schrecklich	JJ	1	schrecklich
besetzen	VB	1	besetzt
Teilen	VBN	1	Teile
unmild	NN	1	unmild
wiederholen	VB	1	kannst
Morgen	NN	1	Morgen
Tempelritter	NN	1	Tempelritter
Pfaffen	NN	1	Pfaffen
Form	NN	1	Form
Zufall	NN	1	Zufall
einzigen	VB	1	einzige
Tauf	NN	1	Tauf
Sittahs	WP	1	welchen
vermieden	NN	1	vermieden
gefang	JJ	1	gefangen
erdulden	NN	1	erdulden
Stempel	NN	1	Stempel
harret	NN	1	harret
grössen	VB	1	größte
meld	NN	1	meld
Krallen	NN	1	Krallen
geheimnisvoll	JJ	1	geheimnisvoll
Erwerben	IN	1	zu
Bot	NN	1	Bot
süss	JJ	1	süß
losgehen	VB	1	losgeht
unweit	NN	1	Quarantana
Briefch	JJ	1	Briefchen
Schlechte	NN	1	Schlechte
funden	NN	1	Gnade
Denkender	NN	1	Denkender
begnadet	NN	1	begnadet
kanns	NN	1	kanns
Verlanget	NN	1	Verlanget
Gram	IN	1	Vor
verändern	VB	1	verändert
gepflanzt	NN	1	gepflanzt
hinüber	RP	1	hinüber
Verfallnen	DT	1	einem
gewinnt	NN	1	gewinnt
aufhör	JJ	1	ich
Bildet	NN	1	Bildet
ausgegattert	NN	1	ausgegattert
zusammenhängen	VB	1	zusammenhängt
reget	NN	1	reget
mischen	VB	1	mischen
neubegierig	JJ	1	neubegierig
Lehrern	JJ	1	Lehrern
andr	JJ	1	andrer
worüber	RB	1	worüber
Herum	NN	1	Herum
würdiget	NN	1	würdiget
ergiebiger	NNP	1	ergiebiger
würdiger	NNP	1	würdiger
Vorfahr	NN	1	Vorfahr
Begleiten	NN	1	Begleiten
Fürwahr	VB	1	schrie
Gewährt	NN	1	Gewährt
Hülf	NN	1	Hülf
gestern	RB	1	gestern
wallen	NN	1	wallen
unmöglich	JJ	1	unmöglich
Vetter	IN	1	Als
gelingt	VB	1	gelingt
Fremden	NN	1	Fremden
Abulkassem	PRP$	1	dein
Gleichviel	NN	1	Gleichviel
Schafpelz	JJ	1	philosophschen
ängstlich	JJ	1	ängstlich
Kaufmann	NN	1	Kaufmann
Wassereimer	NN	1	Wassereimer
lockt	NN	1	lockt
gerungn	IN	1	mit
schrecken	VB	1	schrecken
Entlasst	NN	1	Entlaßt
sauersüssem	NN	1	sauersüßem
Einsamkeit	IN	1	in
atmet	JJ	1	atmet
befremdet	NN	1	befremdet
lediglichen	NN	1	Gottes
machtet	NN	1	machtet
kocht	NN	1	kocht
Gerührt	NN	1	seid
Junge	JJ	1	lieber
Göttlichen	DT	1	der
geziemte	VB	1	tun
vorzugreifen	VB	1	vorzugreifen
Rückhalt	NN	1	Rückhalt
zerbricht	NN	1	zerbricht
gründen	VB	1	gründen
namentlich	RB	1	nun
Geblüt	NN	1	Geblüt
säume	NN	1	säume
Geschickter	NN	1	Geschickter
fortgehn	IN	1	nur
Vermöge	NN	1	Vermöge
verborgen	VB	1	verborgen
dumm	DT	1	die
Drängen	VB	1	Drängt
such	NN	1	such
vorenthalten	RB	1	nicht
Spart	VB	1	betrachten
neueren	JJ	1	neuer
Stosst	NN	1	Stoßt
schlägst	NN	1	schlägst
Bst	RB	1	Bst
innern	VB	1	innern
Empfang	NN	1	Empfang
Verzeihe	NN	1	Verzeihe
Wartet	NN	1	Wartet
Thebais	IN	1	in
Druck	NN	1	Druck
weissem	NN	1	weißem
Beschreib	VB	1	Beschreiben
Erzähl	NN	1	Erzähl
küsst	NN	1	Lager
Innersten	NN	1	Innersten
Tribut	NN	1	siebenjährigem
Falt	NN	1	Falt
trage	NN	1	Liebe
Fahret	NN	1	Fahret
doppeltes	NN	1	doppeltes
Larve	PRP$	1	seine
entbehren	PRP	1	uns
entscheiden	VB	1	entscheiden
Bestand	NN	1	Bestand
Häuser	NN	1	Häuser
gebracht	JJ	1	Töchterchen
wohinen	NN	1	Bleibt
Geistlichen	VB	1	Geistlichen
überkoch	VB	1	überkochen
unterrichtet	NN	1	unterrichtet
quält	NN	1	quält
bunt	JJ	1	bunten
versunknen	DT	1	den
durchschlängeln	NN	1	Grund
Schwäch	NN	1	Schwäche
Schweizern	VB	1	Schweizer
beih	DT	1	beiher
nahten	PRP	1	Wir
Erkläre	NN	1	Erkläre
halb	RB	1	ja
verliess	IN	1	da
Nähern	JJ	1	Näher
Innern	NN	1	Innern
Schlimmer	NN	1	Schlimmer
vorgespreiztem	NN	1	vorgespreiztem
Stärk	NN	1	Stärk
Sag	NN	1	Sag
Erteilet	NN	1	Erteilet
Milz	NN	1	Milz
Nuss	NN	1	Nuß
stolze	NN	1	stolze
Feu	NN	1	Feuer
Lecker	DT	1	der
drob	NN	1	drob
besorglich	VB	1	besorglichen
Parsi	NNP	1	Parsi
bedienen	VB	1	bedienen
Verstosst	RB	1	wieder
entschossen	NN	1	entschossen
Vorhang	NN	1	Vorhang
Zuckung	NN	1	schöne
Beruf	JJ	1	Beruf
Wucher	NN	1	Wucher
Morgens	DT	1	eines
Ordnung	NN	1	Ordnung
spür	NN	1	spür
Verlorst	NN	1	Verlorst
Verräter	NN	1	Verräter
Spezereien	NN	1	Spezereien
Sachen	NN	1	Sachen
tadeln	VB	1	tadeln
gewissern	RB	1	nicht
Theater	NN	1	Theater
schri	NN	1	Feuer
Kaiserlich	JJ	1	Kaiserlichen
Schmeichler	IN	1	an
Stand	PRP$	1	meinem
Rinde	DT	1	Eine
Bösen	DT	1	des
Hafis	NN	1	Hafis
wandle	NN	1	wandle
Fuss	NN	1	Fuß
dürf	NN	1	dürf
Abenteuer	DT	1	Ein
desgleichen	PRP$	1	Ihr
Würd	NNP	1	Würd
Schlug	NN	1	Schlug
ausgepackt	NN	1	ausgepackt
siehst	RB	1	ja
schweift	JJ	1	Auge
Stricke	NN	1	Stricke
unternehmet	NN	1	unternehmet
hilft	VB	1	hilft
widerspricht	NN	1	widerspricht
Entgegen	IN	1	Entgegen
wirds	NN	1	wirds
Eurigen	NN	1	Eurigen
Anstalt	NN	1	Anstalt
Pöbels	NN	1	deines
Standes	NN	1	Standes
Trocknen	NN	1	Trocknen
Kanäle	NN	1	Kanäle
Pfort	NN	1	Pfort
Entwürf	JJ	1	Entwürfe
behalten	VB	1	behält
geizigen	NN	1	geizigen
entblösst	NN	1	entblößt
zürn	PRP	1	Ich
Glaubenshelden	NN	1	Glaubenshelden
verflattern	IN	1	zu
Hingehn	NN	1	Hingehn
Flügeln	NN	1	Flügeln
dachtet	PRP$	1	Ihr
Stammbaum	NN	1	Stammbaum
Post	NN	1	Post
gefund	PRP	1	sich
Sparung	NN	1	Sparung
stolzen	NN	1	stolzen
unterlassen	VB	1	unterlassen
schlängeln	VB	1	schlängeln
scheuchte	NN	1	scheuchte
unrein	NN	1	unrein
gesprächiger	VB	1	sei
besondr	JJ	1	besondre
holdes	NN	1	holdes
wers	NN	1	tue
bauen	NNP	1	Judentum
Erweislich	JJ	1	Erweislich
verwirrt	JJ	1	verwirrt
einzeln	JJ	1	einzeln
schärfen	VB	1	schärft
geht	VB	1	geht
nachgegeben	IN	1	Auch
ermordet	NN	1	Kind
stärk	JJ	1	stärker
Sait	NN	1	Sait
pro	IN	1	pro
spenden	VB	1	spenden
ausgeweinet	NNP	1	ausgeweinet
Beinah	VB	1	kann
vertrauet	NN	1	vertrauet
gehe	CC	1	Und
ausschlug	JJ	1	Mannes
abzulohn	NN	1	Worten
Gelesen	VB	1	mußt
sprach	NN	1	sprach
betrög	PRP	1	mich
wachse	JJ	1	Rinde
beizukomm	RB	1	erst
Kern	NN	1	Kern
beschön	NN	1	beschönen
leiht	NN	1	leiht
stracks	NNS	1	Juden
wartst	WP	1	Was
gewirkt	NN	1	gewirkt
Hätts	NN	1	Hätts
entkömmst	NN	1	entkömmst
hingeworfen	NN	1	hingeworfen
Naschwerk	IN	1	Mit
berg	VB	1	bergen
Hochehrwürden	NN	1	Eurer
Gipfelchen	NN	1	Gipfelchen
Wochen	IN	1	wenig
Tulban	IN	1	Im
Stillstands	NN	1	Stillstands
bezaubert	IN	1	auch
Tretet	NN	1	Tretet
höhern	WDT	1	diesen
Setzt	NN	1	Setzt
befand	NN	1	befand
gewann	NN	1	gewann
abzuwägen	VB	1	abzuwägen
Kenn	NN	1	Kenn
vermache	NN	1	vermache
laben	NN	1	laben
Wes	VB	1	vermögen
ausüben	VBN	1	ausgeübt
Gath	IN	1	in
eingeleuchtet	NN	1	eingeleuchtet
Bezeichnen	NN	1	Bezeichnen
daselbst	RB	1	daselbst
Heiliger	VB	1	Heiliger
schassen	VB	1	schießt
dazuen	VB	1	dazu
bekümmert	NN	1	bekümmert
nunmehr	WDT	1	was
Lektion	NN	1	Lektion
erleichtern	VB	1	erleichtern
Verwehen	VB	1	Verweht
Alters	NN	1	Alters
Silberstoff	DT	1	der
Darunter	RB	1	Darunter
auszuschlagen	VB	1	werden
bittern	JJ	1	bittern
edeln	NN	1	edeln
Erbarmte	NN	1	Erbarmte
süsse	NN	1	süße
Beteuern	IN	1	zu
gen	RB	1	bald
wiederfodert	NN	1	Vorsicht
mindern	NN	1	mindern
schwer	VB	1	üben
Kindesstatt	IN	1	an
Fragst	NN	1	Fragst
rauscht	NN	1	rauscht
sagest	PRP	1	mir
wiederfodern	NN	1	wiederfodern
Sünd	JJ	1	größte
Weigerung	PRP$	1	seine
Kundschafterei	NN	1	Kundschafterei
Gesehn	NN	1	Gesehn
brennts	NN	1	brennts
behutsam	NN	1	Geh
erkundigen	TO	1	zu
vertrauter	NNP	1	gesprächiger
vorhabt	NN	1	vorhabt
frommte	NN	1	frommte
vermeinte	JJ	1	einzige
schreien	VB	1	schreit
Frucht	NN	1	Frucht
dachte	PRP	1	sich
Ehrenkleid	NN	1	Ehrenkleid
lässest	NN	1	lässest
Bewundern	NN	1	Bewundern
vorgetragne	NN	1	vorgetragne
worunter	WRB	1	worunter
denselb	VB	1	sein
entkam	NN	1	Glück
übereilen	NN	1	übereilen
Frommen	NN	1	Frommen
Anspruch	IN	1	für
versichert	NN	1	versichert
Begnadigen	VBN	1	Begnadigt
Tapferkeit	NN	1	Tapferkeit
auferziehen	NN	1	Christin
tue	IN	1	So
Erlauben	IN	1	doch
mans	NN	1	mans
Dinar	NN	1	Dinar
eröffnen	VB	1	eröffne
wach	DT	1	diesem
Wofür	VB	1	hätte
Wehen	NN	1	Wehen
Partei	NN	1	Partei
Samen	NN	1	Samen
Sprach	NN	1	Tempelherr
erweichen	JJ	1	nur
Glücks	NN	1	Viel
vertraue	NN	1	vertraue
unhold	NN	1	unhold
Wirbel	IN	1	im
gespannt	NN	1	gespannt
Verspracht	NN	1	Verspracht
scherzt	NN	1	scherzt
Befunden	PRP	1	sich
Darum	RB	1	Darum
Eremit	IN	1	als
Armut	DT	1	das
Frevels	DT	1	solchen
Kreatur	NN	1	Kreatur
Stärkste	DT	1	der
kümmert	DT	1	das
Christenkinder	PRP	1	Er
Bug	NN	1	Bug
überdenke	NN	1	überdenke
Beliebt	NN	1	Beliebt
Bedürf	NN	1	Bedürf
Warnen	PRP$	1	Ihr
trockene	NN	1	trockene
ungeheuern	NN	1	ungeheuern
Haram	JJ	1	Haram
Ordens	PRP$	1	unsers
Sogar	NNP	1	Sogar
geiziger	NNP	1	geiziger
hernach	NN	1	hernach
Ferne	NN	1	Ferne
herum	RB	1	hier
grösserm	NN	1	größerm
winkt	VB	1	winkt
Beständig	JJ	1	Beständig
eig	NN	1	Euer
Vergisst	NN	1	Vergißt
glaubt	JJ	1	glaubt
kniet	NN	1	kniet
ergriff	NN	1	ergriff
Busse	NN	1	Buße
Bestes	RB	1	oder
achtzehn	IN	1	vor
Herrlichkeit	NN	1	Herrlichkeit
floh	CC	1	und
Unwürdig	JJ	1	Unwürdig
besitze	NN	1	besitze
Richters	NN	1	Richters
Deinen	NN	1	Deinen
anzuhalten	VB	1	anzuhalten
Plane	NN	1	Plane
Grösse	NN	1	Größe
spätre	NN	1	spätre
besitzt	NN	1	besitzt
mustert	NN	1	mustert
Fluge	NN	1	Fluge
Wusst	NN	1	Wußt
beklemmt	IN	1	so
ausgesucht	NN	1	ausgesucht
würdger	NN	1	würdger
Sklaven	DT	1	des
enthalten	TO	1	zu
Soldat	DT	1	Ein
geniessen	VB	1	genossen
Edelmut	IN	1	an
seufzen	VB	1	seufzen
Geschichtch	VB	1	Geschichtchen
Gesteckt	NN	1	Zeit
fühl	NN	1	fühl
Schwärmern	DT	1	den
Muselmanne	JJ	1	keinem
Busen	DT	1	dem
Verfahren	NN	1	Verfahren
Ankunft	DT	1	der
Wüsst	VB	1	bittet
nähmst	PRP	1	dir
keimt	JJ	1	Tugend
Menschenmäkelei	NN	1	Menschenmäkelei
Stillestand	NN	1	Stillestand
eingetrieben	NN	1	eingetrieben
Kapitulation	NN	1	Kapitulation
Seufzen	PRP$	1	Ihr
geziemt	NN	1	geziemt
Erzöge	PRP	1	sich
Selbsteigner	NN	1	Herrn
damals	NN	1	Mir
erschallt	NN	1	erschallt
martre	NN	1	martre
Erwünschte	NN	1	gibts
bereden	NN	1	bereden
Stuhl	NN	1	Stuhl
gewölbt	NN	1	gewölbt
bemüh	DT	1	itzt
schickt	IN	1	Da
Bedient	NN	1	Stöber
Erkundete	RB	1	auch
unverrückt	NN	1	unverrückt
vorgeschossen	NN	1	vorgeschossen
verfehlt	NN	1	Wegs
Nennt	NN	1	Nennt
Mag	VB	1	halten
Weibern	NN	1	Weibern
gnügt	VB	1	gnügt
Geschäfte	NN	1	Geschäfte
verkennt	NN	1	verkennt
Nils	VB	1	reichen
blutet	NN	1	blutet
Sperre	NN	1	Sperre
unglaublich	JJ	1	unglaublich
Getroffen	NN	1	Getroffen
Ebb	NN	1	Ebb
genügen	VB	1	genügt
Erbittert	IN	1	so
Verrichtet	NN	1	Wunder
vergelten	VB	1	vergelten
liessen	NNP	1	Deutschland
Herab	NN	1	Herab
süssern	NN	1	süßern
eingedenk	PRP	1	ihm
schlüg	IN	1	Noch
schonet	NN	1	schonet
versteht	VB	1	versteht
Menschenhass	NN	1	Menschenhaß
gebe	NN	1	Gott
Güt	NN	1	Güt
Waffenstillestandes	NN	1	Waffenstillestandes
erzeigen	VBN	1	erzeigt
Gotteslästerung	NN	1	Gotteslästerung
Führe	NN	1	Führe
Schutz	NNS	1	Schutze
tiefern	PRP$	1	ich
bedenkt	NN	1	bedenkt
bemühen	VB	1	bemüht
Brevier	DT	1	ein
hielten	VB	1	hielten
Sprichwort	NN	1	Sprichwort
suche	VB	1	bekommen
Christentempel	JJ	1	Verfallnen
vergeben	RB	1	nie
Eurem	NN	1	Eurem
zerriss	JJ	1	zerrissen
Forschers	NN	1	Forschers
Anlass	NN	1	Anlaß
sprudelnd	NN	1	sprudelnd
Ausdrucks	NN	1	Ausdrucks
Schwest	PRP$	1	meine
gutherzgen	NN	1	gutherzgen
rauh	JJ	1	rauh
Spruchesen	VB	1	Spruches
herrschend	JJ	1	herrschenden
entfuhr	NN	1	entfuhr
Überspannt	JJ	1	Überspanntes
nachzugrübeln	NN	1	nachzugrübeln
oh	NN	1	O
Augenblicks	NN	1	Augenblicks
plauderst	NN	1	plauderst
obbesagte	NN	1	obbesagte
tanze	NN	1	tanze
wurdet	NN	1	wurdet
spornt	NN	1	spornt
Ermuntrung	NN	1	Ermuntrung
Königinnen	NN	1	Königinnen
achte	CD	1	achte
Verlusts	NN	1	Verlusts
Getrost	VB	1	ist
dabeien	VB	1	dabei
Taugen	VBN	1	Taugt
Exempel	IN	1	Zum
beschworen	NN	1	beschworen
empfinden	RB	1	schon
verschränkten	NN	1	verschränkten
verbeisst	NN	1	verbeißt
allzuhäufig	JJ	1	allzuhäufig
zürnen	VB	1	zürnen
Erforscht	NN	1	Erforscht
Gefiel	NN	1	Gefiel
Geschwätz	JJ	1	liebliche
abziehn	RB	1	nicht
Judentum	NN	1	Aufs
Muselmannes	DT	1	eines
täglich	IN	1	täglich
fodern	NN	1	fodern
Feuren	VB	1	Feur
Musst	VB	1	stellen
dächten	NN	1	Alter
abgeschreckt	NN	1	abgeschreckt
entkäme	NN	1	entkäme
Vollends	NN	1	Vollends
Unstreitig	DT	1	das
nutzt	NN	1	nutzt
erschrecke	NN	1	erschrecke
Musse	NN	1	beßrer
Verlaufen	NN	1	Verlaufen
unvermuteten	NN	1	unvermuteten
belehren	NN	1	belehren
Jamerlonk	CC	1	oder
neuesen	VB	1	neues
Kranken	NN	1	Kranken
unerhört	JJ	1	unerhört
vererbte	NNP	1	vererbte
weigerte	NN	1	weigerte
Belohnet	IN	1	so
Absein	NN	1	Absein
grössre	RB	1	nicht
Kriegs	JJ	1	Kriegs
Erfahren	NN	1	Erfahren
hinweg	IN	1	hinweg
Tropfen	NN	1	Tropfen
Würmchen	DT	1	das
Hof	NN	1	Hof
aufgehalten	NN	1	aufgehalten
Schöne	MD	1	sollte
vors	NN	1	vors
Hinweg	NN	1	Hinweg
Entzögest	JJ	1	gleich
vorn	NN	1	stehn
behüte	NN	1	behüte
Röhren	NN	1	Röhren
Vermögend	JJ	1	Vermögend
erteilen	NN	1	Blut
Summ	NN	1	Summ
Ehre	NN	1	Ehre
andres	NN	1	andres
ekelt	NN	1	ekelt
straucheln	NN	1	straucheln
schätzen	VB	1	schätzen
hetzt	JJ	1	Patriarchen
schluchzt	CC	1	und
lästig	JJ	1	lästig
wackern	NN	1	wackern
witzelst	WP	1	Was
reichst	JJ	1	reichsten
Meint	NN	1	Meint
Vermählt	IN	1	nur
schleppte	CC	1	Und
anzuhören	VB	1	anzuhören
Nimms	NN	1	Komm
Fernen	JJ	1	heitern
vergib	NN	1	verzeih
Ström	NN	1	Ström
Leiden	NN	1	Leiden
beizuspringen	NN	1	beizuspringen
Fesseln	NN	1	Fesseln
Biedermann	NN	1	Biedermann
Schicken	VB	1	Schickt
Stille	NN	1	Stille
missen	IN	1	wenig
Vat	JJ	1	Vater
müsste	VB	1	müßte
Herausschmiss	NN	1	Herausschmiß
vorschiessen	JJ	1	vorschießen
Misslaut	NN	1	Mißlaut
empfindlich	JJ	1	empfindlich
bedächtig	RB	1	so
Verachtet	NN	1	Verachtet
Mädchenseele	WDT	1	diese
weckt	NN	1	weckt
siebenjährigem	IN	1	mit
schwur	NN	1	schwur
Sobalden	RB	1	Denn
zugelernte	NN	1	zugelernte
Schlimme	DT	1	das
Betragens	NN	1	rätselhaften
Wachens	JJ	1	Wachens
schadt	NNP	1	schadt
faselnd	IN	1	auch
nehmts	NN	1	nehmts
fall	UH	1	Nun
Sucht	JJ	1	gehässig
verstummen	VB	1	verstummen
Prälat	NN	1	Prälat
unbändigsten	NN	1	unbändigsten
Woll	MD	1	wollte
Silber	NN	1	Silber
Verzeihen	VB	1	Verzieht
Söhn	CD	1	sieben
gewahr	NN	1	gewahr
Ranken	NN	1	goldnen
lauf	NN	1	lauf
heiss	IN	1	Wie
begnadiget	NN	1	begnadiget
hoffentlich	RB	1	hoffentlich
erschrak	NN	1	Kind
Schwermut	NN	1	Schwermut
begleiten	RP	1	begleitet
Rücken	NN	1	Rücken
durchzudenken	NN	1	durchzudenken
fördersamst	NN	1	fördersamst
Fäden	JJ	1	Fäden
Verachten	IN	1	zu
Zählens	NN	1	Zählens
versengt	RP	1	versengt
aufgelesen	NN	1	aufgelesen
hervor	RP	1	hervor
verschmitzter	NN	1	verschmitzter
Mangels	NN	1	Mangels
vorzutragen	VB	1	vorzutragen
Gefällt	NN	1	Gefällt
Lehrt	NN	1	Lehrt
Aussicht	IN	1	von
unbesorgen	NN	1	Seid
verstosst	PRP$	1	Ihr
warteten	NN	1	warteten
Unendlich	JJ	1	Unendlich
ahndte	PRP	1	Es
besass	NN	1	besaß
hinaus	IN	1	hinaus
Plunder	NN	1	Plunder
Gabel	NN	1	Gabel
Lehre	NN	1	Lehre
Gemeine	NN	1	Gemeine
grausam	RB	1	so
Gift	NN	1	Gift
allerheiligsten	NN	1	allerheiligsten
hasste	NN	1	haßte
irrte	NN	1	irrte
Briefchens	NN	1	Briefchens
weggestossen	NN	1	weggestoßen
Abglanz	DT	1	Den
betäubt	NN	1	betäubt
plündern	VB	1	plündern
pocht	NN	1	pocht
spartest	NN	1	spartest
glaubs	PRP	1	Ich
Begraben	NN	1	Begraben
tust	NN	1	Du
eilen	VB	1	eilen
wichtger	JJ	1	wichtgere
übern	JJ	1	übern
lenken	IN	1	zu
Hoffnung	WDT	1	deren
Pfui	NN	1	Pfui
Umher	NN	1	Umher
bessre	JJ	1	beßre
Gesellen	NN	1	Gesellen
fernern	NN	1	fernern
steht	PRP	1	Er
Vergeben	IN	1	zu
heilen	VB	1	geheilt
geheissen	NN	1	geheißen
aufzuwiegen	PRP	1	es
Dawider	RB	1	Dawider
gehässig	NN	1	Euch
Friedrichs	NN	1	Friedrichs
Schlimmstes	PRP$	1	sein
entrissen	NN	1	Schwert
Block	DT	1	den
kühn	JJ	1	kühn
erheben	VB	1	erheben
Lässen	VB	1	Läßt
leugnet	WP	1	Wer
Ebenbild	NN	1	Ebenbild
beschwör	JJ	1	beschwör
Augenblicken	NN	1	Augenblicken
gewogen	NN	1	gewogen
Mass	NN	1	Maß
ledern	NN	1	ledern
taub	JJ	1	taub
besen	JJ	1	erste
edel	JJ	1	edel
klagen	RP	1	klagt
malt	NN	1	malt
Gecken	NN	1	Gecken
Laffe	JJ	1	junger
Erquickung	NN	1	Erquickung
halts	NN	1	halts
gedient	JJ	1	Zeit
Gefährlich	JJ	1	Gefährlich
reichre	NN	1	reichre
Christeneltern	NN	1	Christeneltern
Ratschluss	NN	1	Gottes
frühern	NN	1	Muß
herab	NN	1	herab
gebührt	IN	1	ebenfalls
anbringen	DT	1	etwas
Vogels	NN	1	Vogels
hie	JJ	1	hier
ruf	NN	1	ruf
anzuschlagen	VB	1	anzuschlagen
entreissen	NN	1	entreißen
Genauer	NN	1	Genauer
trösten	VB	1	trösten
geringres	NN	1	geringres
Laun	NN	1	Laun
Blieb	PRP	1	Er
Bankert	NN	1	Bankert
Kälte	NN	1	Kälte
List	NN	1	List
zehnmal	RB	1	zehnmal
Selbzwanzigster	NN	1	Selbzwanzigster
Et	NN	1	Et
abscheulich	JJ	1	abscheulich
dreimal	RB	1	dreimal
Laut	NN	1	Laut
Kehle	DT	1	die
Europäers	NN	1	Europäers
Schwierigkeiten	NN	1	Schwierigkeiten
Los	NN	1	Nathans
ausgehalten	JJ	1	länger
Dazwischen	RB	1	Dazwischen
beschönen	NN	1	beschönen
Ekel	JJ	1	großen
verrieten	NN	1	verrieten
Tausch	NN	1	Tausch
Persien	NNP	1	Persien
fertigen	VB	1	Wies
vorsichtger	NN	1	vorsichtger
Danks	NN	1	Danks
angezogen	NN	1	angezogen
Schleusen	NN	1	Schleusen
munt	NN	1	Sei
sogaren	RB	1	sogar
lenkt	NN	1	lenkt
Vorbei	NN	1	Vorbei
zeugte	PRP	1	sie
Alter	PRP$	1	seinem
Anblick	NN	1	Anblick
Muskel	PRP$	1	ihrer
bedürftig	JJ	1	bedürftig
abgewinnen	NN	1	Taten
dichtet	NN	1	dichtet
Holzstoss	NN	1	Holzstoß
Tyrannei	NN	1	Tyrannei
Deiner	VB	1	haben
besitzen	RB	1	zu
Schauer	NN	1	Schauer
löblich	JJ	1	löblich
kürzlich	PRP	1	du
vertraute	PRP$	1	mir
Bös	NN	1	Bös
ungerührt	JJ	1	ungerührt
verdiente	NN	1	Spott
malet	NN	1	malet
geschwärmt	NN	1	geschwärmt
gelog	VBN	1	gelogen
Vorbeien	VB	1	Vorbei
theatralsch	JJ	1	theatralschen
Treffen	NN	1	Treffen
entfernt	JJ	1	entfernt
Witzes	NN	1	Witzes
unversöhnlichsten	DT	1	den
verehret	NN	1	verehret
gewartet	NN	1	gewartet
Bessern	NN	1	Bessern
niederwirft	NN	1	niederwirft
Pfleg	NN	1	keimt
gespielt	NN	1	gnug
Bessers	NN	1	Bessers
Sichern	NN	1	Seele
Lippe	NN	1	Assads
verschieden	RP	1	verschieden
unverdient	JJ	1	unverdient
kleinsen	VB	1	kleinste
Christenpilger	DT	1	die
abzuhelfen	VB	1	abzuhelfen
Tempel	DT	1	diesen
Unentschlossenheit	DT	1	Der
fischen	VB	1	fischen
neugierge	NN	1	neugierge
zittert	NN	1	zittert
unbewusst	JJ	1	unbewußt
Dus	WP	1	wem
borgt	VBN	1	borgt
Berichtigen	NN	1	Berichtigen
Geliebt	NN	1	Geliebt
fehlt	JJ	1	fehlte
Ritterschaft	NN	1	Ritterschaft
Bewundrung	NN	1	Bewundrung
gefiel	PRP	1	dir
Muster	NN	1	Muster
Naserinchen	VB	1	Naserinchen
Vielleichen	VBN	1	Vielleicht
Nachts	NN	1	Nachts
Versprich	NNP	1	Versprich
selben	IN	1	Zur
aufgetragen	NN	1	aufgetragen
Schritt	JJ	1	zweiten
vertrieben	IN	1	dort
Entschuldigen	IN	1	zu
Bereite	RP	1	zurück
Auswahl	NN	1	Auswahl
Haar	NNS	1	Haare
gottergebn	DT	1	der
sassen	JJ	1	kurzem
Ändern	NN	1	Ändern
behaupten	RB	1	genug
koste	NN	1	koste
Endlich	RB	1	Endlich
Fangen	VB	1	Fangt
Handel	NN	1	bösen
Alltäglich	TO	1	Alltäglich
verstrickt	NN	1	verstrickt
streute	NN	1	streute
klingt	VB	1	klingt
wehren	VB	1	wehren
schaudere	PRP	1	ich
Dinare	NN	1	Dinare
abzubangen	VB	1	abzubangen
gewöhne	NN	1	Wahrheitstag
Erbieten	NN	1	Erbieten
unterwegens	NN	1	Kann
verscharrten	JJ	1	Askalon
finde	PRP$	1	sehe
Raum	NN	1	Raum
Äste	NN	1	Äste
Eröffne	NN	1	Eröffne
vernehmlich	JJ	1	vernehmlich
Erröten	NN	1	vorgesetzt
staunt	NN	1	staunt
Abtritt	PRP$	1	meinem
Geschichtchen	VB	1	Geschichtchen
sehnen	VB	1	sehn
Rechten	NN	1	Rechten
Bedienen	NN	1	Bedienen
Brief	DT	1	Dieser
ritterlich	JJ	1	ritterlich
Darfst	NN	1	Darfst
Fürsprach	PRP$	1	mein
dreiden	VB	1	dritte
ohnedemen	NN	1	Ja
freun	NN	1	freun
passen	TO	1	zu
Abbrech	VB	1	Abbrechen
folg	PRP	1	ich
nachzuäffen	NN	1	nachzuäffen
Gauch	PRP	1	Ich
lässst	NN	1	läßst
Tisch	JJ	1	Tische
werter	NN	1	werter
Ursache	NN	1	Ursache
Küssen	NN	1	Küssen
heisst	JJ	1	heißt
unentschlossen	NN	1	unentschlossen
Gestehn	NN	1	Gestehn
bequemeres	NN	1	bequemeres
anderwärts	NN	1	anderwärts
verdanket	NN	1	verdanket
Ballen	JJ	1	andern
preise	CC	1	und
Erwähnte	IN	1	vorhin
kleidet	NN	1	Munde
Christennamen	PRP$	1	ihren
besann	NN	1	Erkundete
schlafen	VB	1	schlafen
aufgelöset	NN	1	aufgelöset
Würdigen	NN	1	Euers
strebe	NN	1	strebe
wägst	NN	1	wägst
brach	NN	1	Raubgesindel
verschiednen	NN	1	verschiednen
Floht	NN	1	Floht
Zeigen	VB	1	Gezeigt
Prunk	NN	1	Prunk
schläft	NN	1	schläft
anverwandt	PRP	1	Sie
Sonnenuntergang	NN	1	Sonnenuntergang
Abendland	DT	1	kein
unterdrücken	VB	1	unterdrücken
Gründen	NN	1	Gründen
empfinde	NN	1	empfinde
Findt	VB	1	Findt
Knoten	DT	1	Der
Kapital	NN	1	Kapital
wiest	RP	1	wiest
vertragen	VB	1	vertragen
schwatz	NN	1	schwatz
verdien	NN	1	verdien
geringst	JJ	1	geringsten
platterdings	NN	1	Mich
freiwillig	JJ	1	freiwillig
Gesproch	JJ	1	Gesprochen
klänge	NN	1	klänge
meint	VB	1	meint
Lumpen	NN	1	Lumpen
Tebnin	NN	1	Tebnin
trüg	NN	1	trüg
Schachern	NN	1	Schachern
Schöpfer	NN	1	Schöpfer
reuen	PRP	1	mich
ausgemacht	JJ	1	völlig
Monden	NN	1	Monden
ermüden	VB	1	ermüden
Seltene	NN	1	Seltene
Verhasst	NN	1	Verhaßt
Klumpen	NN	1	Klumpen
küssen	VB	1	küssen
Schätzen	NN	1	Schätzen
hinten	CC	1	und
Traut	PRP	1	es
schwindelnd	NN	1	schwindelnd
Schwäche	NN	1	Schwäche
Bliebst	VB	1	versuchen
Dienstfertigkeit	NN	1	Dienstfertigkeit
schlimmern	JJ	1	Ist
Lage	JJ	1	ganze
anzunehmen	VB	1	anzunehmen
traue	NN	1	traue
entkräftet	NN	1	entkräftet
schlimmster	NN	1	Aberglauben
zeitlich	RB	1	zeitlich
gleicht	NN	1	gleicht
Bestritten	NN	1	Bestritten
bedurfte	NN	1	bedurfte
Stift	JJ	1	Stifter
wirzt	NN	1	wirzt
Geflohn	NN	1	Geflohn
musst	RB	1	So
Tigris	NNP	1	Tigris
Verfolgen	NN	1	Verfolgen
unbekümmert	JJ	1	unbekümmert
denke	PRP	1	ich
lachen	VB	1	gelacht
befragen	VB	1	Darum
Verliert	NN	1	aufgewachsen
unrechtmässigen	DT	1	Dem
Trug	NN	1	Trug
Leicht	NN	1	Rechas
Klage	JJ	1	laute
Zeitung	JJ	1	guten
Beschwatzen	PRP	1	mich
überreden	VB	1	überreden
Kaufe	NN	1	Kaufe
Schuppen	NN	1	Schuppen
Inhalt	JJ	1	Inhalt
Nehmts	VB	1	gegangen
einzuernten	IN	1	Dank
eigner	JJ	1	eigner
immerdar	NN	1	immerdar
stumm	JJ	1	stumm
nichten	NN	1	nichten
Unsers	IN	1	ja
aufgesprungen	NN	1	aufgesprungen
fähig	JJ	1	fähig
leg	CC	1	und
Sünden	JJ	1	aller
Auftrag	DT	1	ein
tausendfach	NN	1	tausendfach
Abscheulich	VB	1	Abscheuliche
nützlich	CC	1	und
erhaltnen	NN	1	erhaltnen
Zwei	CD	1	Zwei
Erkundigte	NN	1	Erkundigte
verreden	NN	1	verreden
verführte	NN	1	verführte
Sand	NN	1	Sand
Pilgermahl	NN	1	Pilgermahl
erriet	NN	1	erriet
verlohnt	NN	1	verlohnt
errat	JJ	1	errat
milden	VBN	1	mild
freudig	JJ	1	freudig
einziehn	NN	1	einziehn
Erregen	VB	1	Erregt
Fehlen	VB	1	Fehlt
gebahnet	NN	1	gebahnet
Begnügen	VB	1	Begnügt
Streitern	NN	1	Streitern
Treue	RB	1	Und
litte	NN	1	litte
Letzt	JJ	1	guter
kürzste	NN	1	kürzste
drängen	VB	1	drängt
verführt	NN	1	verführt
Fehler	NN	1	Mein
wuchern	NN	1	wuchern
dadurch	RB	1	dadurch
Männin	NN	1	Männin
Eidam	DT	1	solchen
Sehren	RB	1	Sehr
wiegte	NN	1	Kindheit
Versuchts	NN	1	Versuchts
Besondern	IN	1	Dank
neinen	RP	1	nein
gaffend	JJ	1	gaffend
dauern	RB	1	Denn
Zang	JJ	1	Zange
Getan	NN	1	Getan
bedientest	NN	1	bedientest
Mäuschen	NN	1	Mäuschen
ganzem	IN	1	In
eilig	JJ	1	eilig
verwandeln	VB	1	verwandeln
walten	VB	1	waltet
Schlafe	NN	1	Schlafe
Hofe	NN	1	Hofe
Kalte	NN	1	Verzweifeln
Abgeschmackters	NN	1	Abgeschmackters
schenke	NN	1	Leben
Schönes	WP	1	was
Äser	NN	1	Äser
Erlaubst	NN	1	Erlaubst
Neidisch	JJ	1	Neidisch
taube	JJ	1	taube
schlimmsten	NN	1	schlimmsten
verschafft	NN	1	verschafft
bliebs	IN	1	So
Amme	NN	1	Deiner
glüht	NN	1	glüht
blöde	DT	1	Die
nähern	PRP$	1	nähern
Spieles	NN	1	Spieles
unterbleiben	NN	1	hätt
spracht	CC	1	Und
Waffenstillestand	NN	1	Waffenstillestand
Plackerei	NN	1	Plackerei
Erfodert	NN	1	Erfodert
verteidgen	VB	1	getan
Gottsfürchtge	NN	1	Gottsfürchtge
ungut	RB	1	nicht
vorgeplaudert	WP	1	was
einkassieren	NN	1	einkassieren
Gelehrten	NN	1	Gelehrten
wittern	VB	1	wittern
Mittel	NN	1	Mittel
eingebracht	JJ	1	eingebracht
dannen	NN	1	Nimm
Geflattre	NN	1	Geflattre
leugnen	RB	1	nicht
Bastard	NN	1	Bastard
werben	PRP	1	sie
säumen	VB	1	säumen
junger	JJ	1	junger
erstiegen	NN	1	erstiegen
philosophsch	IN	1	Im
Betriegen	NN	1	Betriegen
Arbeit	NN	1	Arbeit
Kummers	NN	1	Kummers
Tuch	NN	1	Tuch
Raserei	NN	1	Raserei
ehren	VBN	1	geehrt
ungelegen	NN	1	ungelegen
tauschten	NN	1	tauschten
gach	IN	1	Wie
Sonnenschein	NN	1	Sonnenschein
Weizen	NN	1	lautern
sah	VB	1	sah
verhöhnen	NN	1	verhöhnen
kleinern	NN	1	kleinern
Vorwand	NN	1	Vorwand
geschwinden	VB	1	geschwind
Wüstenei	NN	1	Wüstenei
Worin	RB	1	wissen
scheinet	NN	1	scheinet
rächt	NN	1	rächt
eure	NN	1	eure
geschwinder	NN	1	geschwinder
Wüsten	NN	1	Wüsten
geschlaf	PRP	1	du
stören	TO	1	Zu
begünstigen	VB	1	begünstigen
Löwe	NN	1	Löwe
Künstlers	JJ	1	Des
allererst	NN	1	allererst
Gazza	PRP	1	ich
verklagen	NN	1	Euch
Ablauf	NN	1	Ablauf
Manns	NN	1	Mädchenseele
erfuhr	JJ	1	erfuhr
Gewundert	NN	1	Gewundert
Ghebern	NN	1	Ghebern
gelingen	VB	1	gelingen
Traums	NN	1	Traums
vollziehen	JJ	1	Ungebührliches
Traume	JJ	1	wachen
rechte	RB	1	rechte
habts	NN	1	habts
Mummerei	NN	1	Mummerei
frommt	NN	1	frommt
päpstlich	JJ	1	päpstliches
hellern	JJ	1	Sie
wage	IN	1	noch
tapfre	NN	1	tapfre
Bemerkt	NN	1	Bemerkt
Argwohnt	RP	1	halt
zausen	PRP	1	ihn
Sodann	IN	1	Sodann
Versprach	NN	1	Patriarch
lieblich	DT	1	das
schlechterdings	RB	1	schlechterdings
Armseligkeiten	NN	1	Armseligkeiten
fesselt	NN	1	fesselt
Last	JJ	1	ganze
erhellen	VB	1	erhellen
Ritters	NN	1	Ritters
fürchte	PRP	1	ich
Diözes	NN	1	Diözes
verweilst	NN	1	verweilst
Fasten	NN	1	Fasten
Div	JJ	1	guten
entbot	NN	1	entbot
säete	RB	1	Nicht
Jugend	NN	1	Jugend
Vernünftge	NN	1	Vernünftge
vermeiden	PRP$	1	vermeiden
Acca	NN	1	Acca
teil	DT	1	teile
Pferde	IN	1	vom
angelegner	NN	1	Weit
umfassen	VB	1	umfassen
unterhaltendste	NN	1	unterhaltendste
Kameln	VB	1	Kamelen
höchsen	IN	1	zum
beschwören	VB	1	beschwören
Erkaufen	RB	1	damit
folglich	RB	1	folglich
Vorrat	IN	1	Auf
traft	PRP$	1	Ihr
auserwählte	NN	1	auserwählte
Herrlich	RB	1	Herrlich
unrecht	JJ	1	unrecht
zerreisset	NN	1	zerreißet
auszufinden	NN	1	auszufinden
geborner	DT	1	ein
vergehn	NN	1	vergehn
allzu	RB	1	allzu
Nehmen	VB	1	Nehm
Gotteshäuschen	NN	1	Mein
Botenbrod	NN	1	Kein
Frank	DT	1	kein
rief	CC	1	und
Beichte	NN	1	Beichte
ausgestatten	VBN	1	ausgestattet
unparteiisch	JJ	1	unparteiisch
ablegen	RP	1	abgelegt
Fund	NN	1	Fund
Schade	CD	1	..
Menschheit	NN	1	blöde
Löschen	VB	1	Löschen
ungestüm	JJ	1	ungestüm
Bewahr	NN	1	Bewahre
unermesslich	JJ	1	unermeßlichen
hinwieder	NN	1	hinwieder
geschienen	NN	1	geschienen
Ungebührlich	NN	1	Nichts
streiten	PRP	1	dich
Edler	NN	1	Edler
Freigebigkeit	NN	1	Freigebigkeit
verfällst	RB	1	darauf
Bilder	NN	1	Bilder
anzureden	VB	1	anzureden
Stockjude	NN	1	Stockjude
Einander	RB	1	nicht
unterstehn	NN	1	unterstehn
dulden	VB	1	dulden
zerstreuet	NN	1	zerstreuet
wanns	NN	1	wanns
Erhob	NN	1	Erhob
eiteln	JJ	1	eiteln
Sipp	IN	1	als
erwartend	JJ	1	erwartend
schiene	PRP$	1	bezahlen
Gesteuert	NN	1	Gesteuert
würdge	NN	1	würdge
geschäftig	JJ	1	geschäftig
Menschenfreund	NN	1	Menschenfreund
meinetwegen	PRP	1	sie
klüger	RP	1	freilich
Lüg	NN	1	Lügen
kamst	NN	1	Du
Scheiterhaufen	NN	1	Scheiterhaufen
Rute	NN	1	Rute
Bemächtigen	NN	1	Bemächtigen
gehorsam	JJ	1	gehorsam
Siebensachen	PRP$	1	deine
schlich	NN	1	Gärung
gewähren	VB	1	gewähren
besondern	NN	1	besondern
leugst	NN	1	leugst
Lügnerin	RP	1	kaum
treigen	RB	1	nicht
Wirkt	NN	1	Wirkt
Christentöchterch	DT	1	das
verloschen	VB	1	verloschen
Querkopf	PRP	1	ich
Quarantana	IN	1	Auf
Seil	NN	1	Seil
glaubst	NN	1	Du
Empfänger	NN	1	Empfänger
Ziemte	NN	1	Ziemte
erinnerst	NN	1	erinnerst
besorgen	VB	1	besorgen
gieriger	NNP	1	gieriger
Näschen	RB	1	Näschen
dringlichste	NN	1	dringlichste
Unmittelbar	JJ	1	Unmittelbar
Hunderttausenden	NN	1	Hunderttausenden
Sonnenscheine	PRP$	1	seinem
Grunde	IN	1	Im
schwierig	RB	1	so
verlässt	PRP	1	ihn
schmelzen	VB	1	schmelzen
Verstärkung	JJ	1	letzten
spiessen	NN	1	spießen
frömmsten	NN	1	frömmsten
willen	IN	1	willen
Kellner	NN	1	Kellner
zerschlagen	VB	1	zerschlagen
Träne	NN	1	Träne
Fehls	DT	1	eines
speist	NN	1	speist
angingst	NN	1	angingst
Vorderste	DT	1	Der
Schonen	NN	1	entließ
Geiz	PRP$	1	sein
teilten	NN	1	teilten
sichern	VB	1	sicher
Erzählen	NN	1	Erzählen
glorreicher	NN	1	glorreicher
entliess	NN	1	Saladin
bedacht	DT	1	das
Banden	NN	1	Banden
nimmer	NNP	1	Gibt
klemmen	VB	1	klemmt
Kass	NN	1	Kaß
Klosterleute	NN	1	Klosterleute
schmeichelts	WP	1	wem
verlorn	JJ	1	verlornen
Ersticken	RB	1	nicht
Listen	NN	1	Listen
Schlechen	VB	1	Schlechten
vergnügter	NN	1	vergnügter
hintergehst	NN	1	hintergehst
Itzo	NN	1	Itzo
Verlassen	NN	1	Verlassen
floht	NN	1	floht
unverloren	IN	1	Dir
Töchterchens	PRP$	1	seines
Flur	NN	1	Flur
Flut	NN	1	Flut
Verdienet	NN	1	Verdienet
nass	IN	1	Mit
wackre	NN	1	wackre
Vereinigen	NNP	1	Vereinigen
Schläft	NN	1	Ton
wards	NN	1	wards
unverzüglich	FW	1	unverzüglich
Werken	NN	1	Werken
verwirren	VB	1	verwirren
Bedeuten	NN	1	Dingen
Weissen	NN	1	Weißen
verlenken	NN	1	verlenken
Gesetzes	NN	1	Gesetzes
aufzufinden	NN	1	Derwisch
Nase	NN	1	Nase
Speis	NN	1	Speis
Verdenkt	NN	1	Verdenkt
Halse	NN	1	Halse
höflicher	NN	1	höflicher
Verbesserer	NN	1	Verbesserer
Schilt	NN	1	Schilt
launisch	RB	1	doch
Fühlt	NN	1	Fühlt
geschehen	RP	1	geschehen
Tropf	PRP	1	Ich
verhunzen	IN	1	so
entzog	NN	1	entzog
übrigens	RP	1	übrigens
Ruhe	NN	1	Ruhe
Erbe	JJ	1	väterliches
dicker	NN	1	dicker
Eitelkeit	DT	1	die
ging	VB	1	ging
Schwach	JJ	1	Schwachen
früh	RB	1	So
bleibet	NN	1	bleibet
Fällt	RB	1	Hier
müsse	VB	1	entdecken
Mache	NN	1	Mache
Befällt	NN	1	Befällt
Tand	IN	1	an
Erwachsen	NN	1	Erwachsen
redten	NN	1	redten
Herbst	PRP$	1	meinem
Bösewichter	NN	1	Bösewichter
Kunst	NN	1	Kunst
übe	NN	1	Komm
umgeworfen	NN	1	umgeworfen
dämpfen	NN	1	Thebais
Machtspruch	NN	1	Machtspruch
Ungewöhnlichste	NN	1	Ungewöhnlichste
Angelegenheit	DT	1	solcher
Verstopfen	NN	1	Verstopfen
sonderbaren	NN	1	sonderbaren
ausgenomm	RB	1	ausgenommen
aufgedunsnen	NN	1	aufgedunsnen
Narr	NN	1	Narr
wechselt	NN	1	wechselt
Schatten	NN	1	Schatten
sagt	VB	1	sagt
Bedenken	NN	1	Bedenken
Ausmergeln	NN	1	Ausmergeln
befehlt	NN	1	befehlt
unverkünstelt	IN	1	so
tadle	NN	1	tadle
erzeige	NN	1	erzeige
Wichtigers	JJ	1	Wichtigers
Jauchzen	NN	1	Jauchzen
Unsrer	NN	1	Unsrer
kannst	JJ	1	kannst
wünscht	PRP	1	er
Täte	NN	1	Entzögest
Verständig	IN	1	zusammen
Benehmen	NN	1	Benehmen
bedürfen	RP	1	bedurft
Erscheinen	NN	1	Erscheinen
Karawan	DT	1	Die
Graus	IN	1	Mit
draufen	RP	1	drauf
plumper	JJ	1	plumper
Gekauft	NN	1	Gekauft
ruhigern	VB	1	ruhiger
wenigste	NN	1	wenigste
Lügen	VB	1	Lügt
überallen	VB	1	überall
Geschweige	VB	1	könnte
getrennt	JJ	1	getrennt
spreche	NN	1	spreche
Hungerns	NN	1	Hungerns
Wahrheitstag	NN	1	hellern
übeln	RB	1	nicht
Beginnt	NN	1	Beginnt
fortfährt	NN	1	fortfährt
Quelle	NN	1	Quelle
anwende	NN	1	anwende
Lenk	RB	1	nicht
Verrückt	JJ	1	Ziel
trefft	PRP$	1	Ihr
Schnurre	NN	1	Schnurre
besteh	NN	1	besteh
Tust	NN	1	Tust
göttlich	DT	1	Die
befehlen	VB	1	befehlen
Betrogene	NN	1	Betrogene
Hiermit	NN	1	Mann
Gestern	NN	1	Gestern
begierig	JJ	1	begierig
Gebauet	NN	1	Gebauet
heit	NN	1	Sei
kehrt	JJ	1	kehrt
ausritt	PRP	1	er
anliess	NN	1	anließ
Gemeinen	NN	1	Gemeinen
heim	RB	1	heim
Schonet	NN	1	Schonet
Grosses	DT	1	was
Lehren	NN	1	Lehren
Wenns	NN	1	Wenns
Weiber	NN	1	Weiber
Opfertier	NN	1	Opfertier
Geiern	NN	1	Geiern
winkte	NN	1	winkte
grünen	VB	1	grünen
Klimas	NN	1	Klimas
abgetan	NN	1	abgetan
grader	NN	1	grader
vorgespreizte	NN	1	vorgespreizte
Fürsten	NN	1	Fürsten
Adlerblick	NN	1	Adlerblick
allerdingsen	VB	1	allerdings
unerschöpflicher	NNP	1	unerschöpflicher
Zahn	NN	1	Zahn
Ausbund	DT	1	dieser
Gesund	NN	1	Gesund
Sanftmut	NN	1	Sanftmut
schmeichelt	NN	1	schmeichelt
wiederumen	VB	1	wiederum
Beschäm	NN	1	Komm
Grossen	NN	1	Großen
verlass	NN	1	verlaß
Schlag	NN	1	Schlag
erbarmen	IN	1	zu
Dieselbe	NN	1	Dieselbe
liebenswürdig	JJ	1	liebenswürdig
Verbrennen	IN	1	insgesamt
hochzuschätzen	NN	1	hochzuschätzen
Patriarche	NN	1	Patriarche
alltäglich	JJ	1	alltäglich
Lebendigen	NN	1	Lebendigen
eingehüllt	JJ	1	Mantel
Geschwinder	NN	1	Geschwinder
hindern	VB	1	hindern
Messer	DT	1	das
Zurüstungen	NN	1	Zurüstungen
wagte	NN	1	wagte
Ordensregeln	NN	1	Ordensregeln
Wovor	JJ	1	allerlei
fett	JJ	1	fett
Stachel	NN	1	Stachel
Geworden	NN	1	Geworden
merklich	IN	1	merklich
schwärzesten	NN	1	schwärzesten
gezollt	NN	1	gezollt
dreifach	NN	1	dreifach
Vorausgeschickt	NN	1	Vorausgeschickt
Sinnbilderst	NN	1	Brautkleid
abzujagen	NNS	1	Christen
Unglück	NN	1	Dein
gereuen	NN	1	gereuen
Erfüllung	NN	1	Erfüllung
Verfügung	NN	1	Verfügung
Kaiser	NN	1	Kaiser
Meiner	JJ	1	Meiner
Gebieten	NN	1	Gebieten
täuschen	VB	1	getäuscht
ausgezehrt	JJ	1	ausgezehrt
Laienbruders	DT	1	des
ältern	PRP$	1	deiner
wundern	VB	1	gewundert
vertilgen	NN	1	vertilgen
Bewegungsgründe	NN	1	Bewegungsgründe
zweitenmale	IN	1	zum
Furchtsamen	NN	1	Furchtsamen
glatt	JJ	1	glatten
Sinn	NN	1	Sinn
Zehen	NN	1	Zehen
Fragen	NN	1	gegriffnen
verreist	NNP	1	verreist
Erriet	NN	1	Erriet
Vaterland	NN	1	Vaterland
wundert	NN	1	wundert
Sina	NNP	1	Sina
Almosens	NN	1	Almosens
überreichtet	CC	1	und
Verzweifeln	JJ	1	kein
Mitleids	PRP$	1	wahren
wuchert	NN	1	wuchert
Verschwendung	NN	1	Verschwendung
verschwand	JJ	1	verschwand
schändlich	JJ	1	schändlich
Hineingeschrieben	JJ	1	Herr
ausredt	NNP	1	ausredt
Pfiff	DT	1	Der
Misstraun	IN	1	auf
niemands	PRP	1	sie
Deutschen	DT	1	einer
deutlichsten	NN	1	deutlichsten
Flecken	NN	1	Flecken
Beiher	NN	1	Geweint
Höhle	WP	1	welcher
Gehirn	NN	1	Gehirn
Meinst	VB	1	geben
Summen	NN	1	Summen
Dazuen	RB	1	Dazu
Gehorcht	NN	1	Gehorcht
Knorr	NN	1	Knorr
Stiel	NN	1	Stiel
winken	VB	1	winken
wiss	JJ	1	möglich
Unterricht	NN	1	Unterricht
doren	RB	1	dort
Steinen	NN	1	Steinen
eifersüchtig	JJ	1	eifersüchtig
Borgen	NN	1	Borgen
solchem	NN	1	solchem
wems	IN	1	Von
Lastertat	NN	1	Lastertat
eintritt	NN	1	eintritt
Eren	RB	1	Erst
werdet	NN	1	werdet
Nu	VB	1	unbesorgt
Heil	NN	1	Heil
Zurückgezogen	NN	1	Zurückgezogen
schönern	NN	1	schönern
Möcht	NN	1	Möcht
bekennen	RP	1	bekannt
Segen	NN	1	Segen
hinterbringen	NN	1	hinterbringen
Bilde	DT	1	diesem
Silbe	DT	1	diese
blutge	NN	1	blutge
unverhohlen	NN	1	unverhohlen
ofen	WDT	1	denen
tief	RB	1	Noch
trete	NN	1	trete
rauhe	NN	1	rauhe
überrascht	VB	1	überrascht
Träumst	NN	1	Träumst
ginge	NN	1	ginge
Willkommnen	DT	1	Dem
gekostet	NN	1	gnug
heilig	JJ	1	heiligen
Ginnistan	WP	1	welchem
Vätern	NN	1	Vätern
erfinden	VBN	1	erfunden
Mütterchen	PRP$	1	dein
Kannst	VB	1	lesen
verübeln	NN	1	verübeln
Linie	NN	1	Linie
Skrupel	NN	1	Skrupel
befestigen	VB	1	befestigen
Verfälschen	JJ	1	Verfälschen
Erschien	NN	1	Erschien
starken	NN	1	starken
Entreissen	RB	1	nicht
Propheten	NN	1	Propheten
Geschlechte	DT	1	dem
erwähnen	VB	1	erwähnen
Häfen	NN	1	Häfen
Rührung	NN	1	größern
wunderlich	JJ	1	wunderlich
abzuleugnen	DT	1	etwas
Geweint	RP	1	geweint
gedenken	VB	1	gedacht
Warnung	NN	1	Warnung
Frag	NN	1	Frag
flüchtet	NN	1	flüchtet
Richte	DT	1	die
unbestochnen	NN	1	unbestochnen
Schönheit	NN	1	Schönheit
dieserwegen	NN	1	dieserwegen
Mammon	NN	1	Mammon
Tier	NN	1	Tier
Aufwand	NN	1	Aufwand
dünken	VB	1	dünken
bettelarm	NN	1	bettelarm
Stange	NN	1	Stange
seiden	NN	1	Adern
feind	NN	1	feind
Lager	PRP$	1	mein
beladenen	JJ	1	beladenen
Ruhig	VB	1	dürfen
kaiserlich	JJ	1	kaiserliches
hingeworfnen	DT	1	dem
gehofft	NN	1	gehofft
Empor	NN	1	Empor
entfesselt	NN	1	entfesselt
Ehren	NN	1	Ehren
aufrichtig	JJ	1	aufrichtig
rechnet	NN	1	rechnet
weises	DT	1	Ein
Probe	JJ	1	erste
Richard	NNP	1	Richard
arg	RB	1	arg
rachbegierig	JJ	1	rachbegierig
schreiben	PRP	1	ihr
verdanken	RB	1	genug
Pah	NN	1	Pah
Kreuz	NN	1	Kreuz
beten	VB	1	beten
Lächelt	NN	1	Lächelt
betreffen	VB	1	betrifft
vorhin	DT	1	das
abzudingen	VB	1	abzudingen
Schönres	NN	1	Schönres
Gedächtnis	PRP$	1	mein
Kinde	DT	1	dem
leidige	NN	1	leidige
melden	TO	1	zu
vermessen	VB	1	vermessen
silbern	JJ	1	silbern
Überlegen	NN	1	Überlegen
Trag	RB	1	weg
könn	VB	1	könne
Pilger	NN	1	Pilger
Trau	NN	1	Trau
finst	JJ	1	finster
Gunst	PRP$	1	seiner
Syrien	NN	1	Syrien
Heldenmässigste	NN	1	Heldenmäßigste
beziehen	RB	1	nur
erwünschen	NN	1	O
abgejagt	RB	1	So
fiel	VB	1	fiel
Steins	NN	1	Steins
straf	PRP	1	Ich
Sträflich	JJ	1	Sträfliches
abzuzwacken	RB	1	viel
Worts	NN	1	Worts
passt	DT	1	das
schein	VB	1	scheinen
nien	RB	1	viel
Rande	NN	1	Rande
blühen	RB	1	wieder
Höhnerei	IN	1	An
stündlich	JJ	1	stündlich
Flamm	NN	1	Flamm
Quell	JJ	1	Quell
Labsal	NN	1	Labsal
Sängerin	NN	1	Sängerin
Buche	DT	1	diesem
Siedelei	DT	1	eine
lebet	VB	1	lebet
Stellt	NN	1	Stellt
Geistlich	DT	1	Ein
Eröffnen	NN	1	Eröffnen
Prüfung	NN	1	Prüfung
vergisst	JJ	1	je
genugen	NN	1	Manns
hörst	VB	1	hörst
obendreinen	RP	1	obendrein
ersaufen	NN	1	ersaufen
Saite	JJ	1	neuen
Scheuern	NN	1	Scheuern
gewürdiget	NN	1	gewürdiget
Mute	NN	1	Mute
Geber	NN	1	Geber
stürmen	VB	1	stürmen
Wiederkunft	NN	1	Wiederkunft
ganzes	NN	1	Tochter
heilgen	DT	1	Den
eifre	NN	1	eifre
ertrunken	NN	1	ertrunken
Diener	NN	1	Diener
spotten	NNS	1	Ketten
spielst	NN	1	spielst
schärfer	NN	1	schärfer
spottet	NN	1	spottet
neben	IN	1	neben
gelobten	NN	1	gelobten
verbrannt	JJ	1	verbrannt
Hervorgetreten	NN	1	Hervorgetreten
Maronien	VB	1	Maroniten
schleichen	RP	1	geschlichen
Händchen	RB	1	Händchen
erträglichern	DT	1	den
zeichnen	VB	1	zeichnet
verhindern	VB	1	verhindert
presst	NN	1	Silbe
schicke	NN	1	Vater
nennst	VB	1	nennst
Palästina	NNP	1	Palästina
melde	PRP	1	Ich
Reichtümer	NN	1	Reichtümer
Ersehn	NN	1	Ersehn
hergebracht	NN	1	hergebracht
Vertrauet	NN	1	Vertrauet
Geckereien	NN	1	Geckereien
Stütze	NN	1	Stütze
überlegen	VB	1	überlegen
lebe	PRP	1	Es
vernehmlicher	NN	1	vernehmlicher
Plätzchen	JJ	1	ander
Gottloben	NN	1	Gottlob
Indien	NNP	1	Indien
lebt	VB	1	lebt
vergebt	NN	1	vergebt
klang	DT	1	Das
Stund	NN	1	Stund
Knecht	NN	1	Knecht
Anteil	NN	1	Anteil
Spion	NN	1	Spion
fester	NN	1	fester
eingestimmt	NN	1	eingestimmt
Raubgesindel	JJ	1	arabisch
Drohen	PRP	1	ihr
Müss	NN	1	Müß
gönnst	NN	1	gönnst
Heh	NN	1	Heh
Krieg	NN	1	Krieg
gebrech	VB	1	gebrechen
Schale	NN	1	Schale
schaff	NN	1	schaff
Waffe	NNS	1	Waffen
besorg	NN	1	besorg
Kirche	NN	1	Kirche
vielmal	IN	1	vielmal
Zung	NN	1	Zung
Scheidebrief	NN	1	Scheidebrief
Büchelchen	DT	1	ein
allerlei	IN	1	zu
Rechenschaft	NN	1	Rechenschaft
geführet	NN	1	geführet
geflösst	NN	1	Block
Fiel	NN	1	Fiel
innerhalb	RP	1	innerhalb
geängstet	IN	1	so
nämlichen	RB	1	nämlichen
Zutrauns	NN	1	deines
Klemme	NN	1	Klemme
abhängen	RP	1	abhängt
verbreitet	JJ	1	verbreitet
Wilder	NN	1	Wilder
hattest	RP	1	hattest
Besinnen	IN	1	erst
mühsam	JJ	1	mühsam
Geschrieben	NN	1	Geschrieben
Ans	JJ	1	vermutlich
Träumerei	NN	1	süßen
verbreiten	VBN	1	verbreitet
Brautschatz	NN	1	Brautschatz
Beute	NN	1	Beute
sagte	VB	1	sagte
reifen	VB	1	reifen
Geizigsten	NN	1	Geizigsten
achten	VB	1	achtet
Pracht	NN	1	Pracht
neugiergem	NN	1	neugiergem
Winseln	JJ	1	kein
Vorfahren	NN	1	Vorfahren
undenkbar	JJ	1	undenkbar
entdecken	PRP	1	mir
Knuppen	NN	1	Knuppen
Trotzkopf	RP	1	wohl
kränken	VB	1	kränken
Bring	VBN	1	steigt
zuteilen	RP	1	zugeteilt
weisere	NN	1	weisere
greifen	VB	1	greifen
belauschen	JJ	1	belauschen
barfuss	RB	1	barfuß
Vergnügsam	JJ	1	Vergnügsam
begreiflich	JJ	1	begreiflich
Posten	NN	1	Posten
Allerdingsen	RB	1	Allerdings
Herze	NN	1	Herze
Reit	NN	1	Gestürzte
Mörder	PRP$	1	seinem
immern	JJ	1	ähnlich
Reis	NN	1	Reis
Reiz	DT	1	des
siebenmal	RB	1	siebenmal
Wein	NN	1	Wein
Geistlichkeit	PRP$	1	deine
schleppt	NN	1	schleppt
bewundern	NN	1	Stirn
Landes	NN	1	Landes
off	JJ	1	offen
Schaudert	NN	1	Schaudert
Wiege	NN	1	Wiege
Ziehen	VB	1	Zieht
Grausame	NN	1	Grausame
heitern	IN	1	Von
Gold	IN	1	mit
Zersprengen	NN	1	Zersprengen
Bekenn	NN	1	geziemte
setz	NN	1	setz
schi	NN	1	Ja
gewärtigen	VB	1	gewärtigen
Gerufen	JJ	1	Saladin
Mien	NN	1	Mien
Entscheiden	NN	1	Entscheiden
lese	NN	1	lese
Richterstuhl	NN	1	Richterstuhl
Bescheidne	JJ	1	Bescheidne
ruhen	VB	1	ruhen
Flusse	NN	1	Flusse
Aufschluss	DT	1	den
letzen	DT	1	Der
Wähnen	NN	1	Wähnen
martern	NN	1	martern
Bekümmert	NN	1	Bekümmert
mäkeln	NN	1	mäkeln
Vergesslichen	RB	1	Vergeßlichen
weh	RB	1	weh
zög	NN	1	zög
stehts	IN	1	Noch
schmutzgen	NN	1	schmutzgen
Esse	IN	1	mit
Ärmern	PRP	1	es
vorzuspiegeln	VB	1	vorzuspiegeln
Bluts	NN	1	deines
fliehn	NN	1	fliehn
verhüllt	NN	1	verhüllt
geholfen	NN	1	geholfen
Hässlichen	DT	1	die
Eis	NN	1	Eis
strafst	NN	1	strafst
Musterring	FW	1	Musterring
Horcherin	NN	1	Horcherin
Entschliessen	NN	1	Entschließen
Gelehrt	NN	1	Gelehrt
Fallen	NN	1	Fallen
Feuerkohlen	RB	1	Nicht
Original	NN	1	Original
taugts	NN	1	taugts
vermutlich	WDT	1	der
Erheb	PRP	1	mich
unterbrechen	VB	1	unterbrechen
höflich	JJ	1	höflich
Gewaltig	NN	1	stracks
Beteurte	NN	1	Beteurte
körnen	PRP	1	mich
verkennen	VBN	1	verkannt
warmen	VB	1	warmen
Verleitet	PRP	1	dich
billigsten	NN	1	billigsten
Bekannt	IN	1	Bekannt
reift	NN	1	reift
erpicht	IN	1	so
Obern	NN	1	Obern
hadern	JJ	1	andern
Schlimmes	IN	1	zu
stutzest	NN	1	stutzest
Umarmen	NN	1	Umarmen
Arznei	NN	1	Arznei
Allerliebst	PRP$	1	Ihr
rücken	VB	1	rücken
erkund	NN	1	erkund
eilst	NN	1	eilst
Schwab	NN	1	Schwab
Vertraun	NN	1	Vertraun
Vertraut	NN	1	Vertraut
Ort	NN	1	Ort
Strand	NN	1	öden
Subtilitäten	NN	1	Subtilitäten
Gnüge	NN	1	Gnüge
betäuben	NN	1	betäuben
erziehn	NN	1	erziehn
plumpen	NN	1	plumpen
beflissen	PRP$	1	Ihr
Verwiesen	NN	1	Verwiesen
Proben	NN	1	Proben
ermüdet	NN	1	ermüdet
ungeformten	NN	1	ungeformten
Ptolemais	NN	1	Ptolemais
Schweinefleisch	IN	1	ohne
erblickt	NN	1	erblickt
Tags	JJ	1	Des
Mamelucken	DT	1	solcher
Altars	JJ	1	morschen
Glatteis	NN	1	Glatteis
Almosen	NN	1	Almosen
auszuweichen	VB	1	auszuweichen
heisch	JJ	1	heische
Froh	NN	1	Froh
morsch	DT	1	eines
Nannte	NN	1	Nathan
drein	NN	1	drein
Gefangenen	NN	1	Gefangenen
wurdest	RB	1	wurdest
bestreitet	NN	1	bestreitet
strengsten	NN	1	strengsten
verwandt	NN	1	Sipp
Amm	JJ	1	meiner
Gewinn	IN	1	viel
Gewünscht	IN	1	nie
Blocke	NN	1	hingeworfnen
aufgeführten	NN	1	aufgeführten
Handelsleute	PRP$	1	Ihr
trocknen	TO	1	zu
rühr	RB	1	Nicht
Paket	NN	1	Paket
Meilen	NN	1	Meilen
Amt	NN	1	Amt
hoffnungsvollen	CD	1	sieben
Sorgfalt	NN	1	Sorgfalt
blühn	NN	1	blühn
schielt	NN	1	schielt
unsertwillen	PRP$	1	unsertwillen
Vorauszusetzen	RB	1	nicht
Hypothesen	NN	1	Hypothes
Bezeihen	NN	1	Bezeihen
hängen	RB	1	So
hastig	JJ	1	hastig
hm	NN	1	hm
Nötigen	VBN	1	Genötigt
zweifelt	NN	1	zweifelt
Erlassen	NN	1	Erlassen
Vertrauen	NN	1	Vertrauen
Gleisnereien	CC	1	und
Wolltet	NN	1	Wolltet
opfern	NN	1	Mädchen
Stöber	IN	1	zum
Neffen	PRP$	1	meine
Damaskus	NNP	1	Damaskus
Wahrhaftig	JJ	1	Wahrhaftig
überliefert	NN	1	überliefert
auftragen	RB	1	nun
braucht	JJ	1	braucht
bürgerlich	JJ	1	bürgerliche
ärgerlich	RB	1	Sehr
vergelt	NN	1	Gott
Pfaffe	NN	1	Pfaffe
Wunderkraft	NN	1	Wunderkraft
anzuraten	NN	1	Euch
Spangen	NN	1	Spangen
verschlossnem	NN	1	verschloßnem
manchmal	RB	1	manchmal
Iman	NN	1	Iman
Haut	JJ	1	gute
warens	NN	1	warens
trotzgen	NN	1	trotzgen
einzger	DT	1	Ein
vermeine	VB	1	tun
Antrag	NNP	1	Antrag
Geschmack	NN	1	Geschmack
jüdsch	DT	1	diesen
Nachher	NN	1	Nachher
freundlich	JJ	1	freundlicher
Sieben	IN	1	auf
Damien	RB	1	Damit
erfährt	DT	1	nichts
klar	JJ	1	klar
Erklär	PRP	1	du
Hirns	PRP$	1	unsers
Regeln	NN	1	Regeln
öden	NN	1	Lebens
folge	NN	1	folge
Konntest	NN	1	Konntest
verstopften	NN	1	verstopften
Schwätzer	NN	1	tolerante
Verschweig	NN	1	Preis
würgen	VB	1	würgen
Gebar	JJ	1	Gebar
vortrefflich	JJ	1	vortrefflich
irgendwoen	NN	1	Schachbrett
schadets	NN	1	schadets
erblicken	RB	1	nicht
