Title: Der junge Gelehrte
Number of all lemmas: 8748
Nummber of different lemmas: 2647

Lemma	POS	Frequency	Tokens
Herr	NN	137	Herr, Herren, Herrn
wissen	VVFIN, VVINF, VVPP	114	weiß, wüßtest, wissen, wüßte, Wissen, wußte, gewußt, wüßten, Wißt
sagen	VVFIN, VVPP, VVINF, VVIMP	113	sagen, gesagt, sage, sag, sagst, Sagen, sagt, Sage, sagte, sagten, Sagtest
wohl	ADV	85	wohl, Wohl
gut	ADJA, ADJD	78	guter, besten, guten, Gut, gut, besser, Besser, gute, gutes, beste, bessere, gutem
Vater	NN	76	Vater, Vaters, Vätern
sehen	VVFIN, VVINF, VVIMP, VVPP	72	Sieht, sehe, Sehen, sähe, sehen, Sieh, sieht, gesehen, sah, sieh, Siehst, siehst, sahen
glauben	VVINF, VVFIN, VVPP, VVIMP	65	glauben, glaubt, glaube, Glauben, Glaubt, geglaubt, glaub, Glaube, glaubte, glaubst
Lisette	NE	58	Lisette
Sohn	NN	58	Sohn, Sohnes, Sohne, Sohns
Damis	NE, NN, VVFIN	58	Damis
hören	VVINF, VVFIN, VVIMP	57	hören, Hören, höre, höret, hörte, Hörst, hört, Höre, hör, hörst
Valer	NE	56	Valer
kennen	VVINF, VVFIN, VVIMP, VVPP	51	kennen, kenne, kennst, kenn, gekannt, kennt, Kennen, Kennst, kennten
reden	VVFIN, VVINF	47	redete, reden, rede, Reden
gar	ADV	47	gar, Gar
Julianen	NN	45	Julianen
Brief	NN	41	Briefe, Brief, Briefes
bald	ADV	41	bald, Bald
erst	ADV, ADJA	40	erst, ersten, erste, erster, erstes
Anton	NE	39	Anton
Juliane	NE	37	Juliane
Buch	NN	36	Buch, Bücher, Büchern, Buchs
Wort	NN	35	Wort, Wörter, Worte, Worten
lieb	ADJA, ADJD	35	lieber, liebe, lieb, liebsten, liebste, lieben, liebster, liebes, Liebes, Liebster
verstehen	VVFIN, VVINF, VVPP, VVIMP	35	verstehen, versteht, verstehe, verstehst, verstünde, verstanden, versteh, Verstehst
Gelehrte	NN	34	Gelehrten, Gelehrter, Gelehrte
Frau	NN	33	Frau
gewiss	ADJD, ADJA	32	gewiß, Gewiß, gewissen, gewisses, gewisse
wahr	ADJD, ADJA	32	wahr, wahre, wahren
Jahr	NN	31	Jahren, Jahr, Jahre
recht	ADJD	30	recht, Recht
Mann	NN	30	Mann, Manne, Männer, Männern
wahrhaftig	ADJD	29	wahrhaftig, Wahrhaftig
denken	VVFIN, VVINF	29	denkt, denkst, dächte, denken, dachte, denke, Denkt, dächten, Denken
nehmen	VVINF, VVFIN, VVPP, VVIMP	29	nehmen, nimmt, nahm, nehme, genommen, nimm, Nimm
alt	ADJA, ADJD	29	alte, alt, alter, älter, alten, Alten
eben	ADV, ADJA	29	eben, Eben, ebenen
Zeit	NN	28	Zeiten, Zeit
heißen	VVFIN, VVINF	27	heißt, heißen, hieß
lesen	VVPP, VVFIN, VVINF, VVIMP	27	gelesen, lese, lesen, läse, Gelesen, liest, las, lies
genug	ADV	26	genug, Genug
Hand	NN	26	Hand, Hände, Händen
vielleicht	ADV	25	vielleicht, Vielleicht
Gott	NN	25	Gott, Gottes
heiraten	VVINF, VVFIN, VVPP	24	heiraten, heirate, heiratete, geheiratet
finden	VVFIN, VVINF, VVPP	24	findet, finde, finden, gefunden, findest
Frauenzimmer	NN	24	Frauenzimmern, Frauenzimmer
ha	NE	23	ha
lang	ADJD, ADJA	22	länger, lange, lang
Kopf	NN	22	Kopfe, Kopf, Köpfe
Himmel	NN	21	Himmel, Himmels
stehen	VVFIN, VVINF	21	steht, stehen, Stehst, stand, stehst, Steht
etwa	ADV	21	Etwa, etwa
vergessen	VVPP, VVFIN, VVIMP, VVINF	20	vergessen, vergesse, vergiß, vergißt, vergeßt
recht|rechts	ADJA	20	rechten, rechte
versprechen	VVFIN, VVINF, VVPP	20	verspreche, versprechen, versprochen, verspricht, versprach
groß	ADJD, ADJA	20	groß, große, großen, größte, größten, Größten, großer
böse	ADJD, ADJA	20	böse, böses, bösen
Post	NN	20	Post, post
Leute	NN	20	Leuten, Leute
Chrysander	NE, NN	20	Chrysander
ach	ITJ	20	Ach, ach
bekommen	VVFIN, VVINF, VVPP	20	bekomme, bekommen, bekam
wenigstens	ADV	20	wenigstens, Wenigstens
freilich	ADV	20	freilich, Freilich
Gedanke	NN	19	Gedanken, Gedanke
klein	ADJA, ADJD	19	kleine, kleinen, klein, kleinste, kleines
gehören	VVFIN	19	gehört, gehörst, gehören
Gelehrsamkeit	NN	19	Gelehrsamkeit
Welt	NN	19	Welt
allein	ADV, PTKVZ	19	Allein, allein
anfangen	VVIZU, VVPP, VVINF, VVFIN	18	anzufangen, angefangen, anfangen, anfängt, anfängst
kurz	ADJA, ADJD	18	kurzen, Kurz, kurz, kurzer, kürzer
antworten	VVFIN, VVINF, VVPP	18	Antworte, antworten, antwortest, geantwortet, antwortet, antworte
Sache	NN	18	Sache, Sachen
zwanzig	CARD	18	zwanzig
weißen	VVFIN	18	weißt, Weißt
gelehrt	ADJA	18	gelehrter, gelehrten, gelehrte
Recht	NN	18	Recht, Rechts, Rechtes
sonst	ADV	18	sonst
kömmt	VVFIN, NN	18	kömmt
Narr	NN	17	Narren, Narr
fort	PTKVZ, ADV	17	Fort, fort
lange	ADV	17	lange
wenige	PIAT, PIS	17	wenigen, wenig, weniger, wenige
dumm	ADJD, ADJA	17	dümmer, dümmste, dummer, dumme, dummen, dumm
Freund	NN, NE	17	Freund, Freunde, Freundes, Freunden
Sprache	NN	16	Sprache, Sprachen
schreiben	VVIMP, VVINF, VVPP, VVFIN	16	schreib, schreiben, geschrieben, schreibt, schrieb
ehrlich	ADJA, ADJD	16	ehrlichen, ehrlicher, ehrliche, ehrlich, ehrlichste
unmöglich	ADJD	16	unmöglich, Unmöglich
Ehre	NN	16	Ehre
setzen	VVFIN, VVINF, VVPP	16	setze, setzen, Gesetzt, Setzen, Setzt, gesetzt
Stube	NN	15	Stube
Ha	NE	15	Ha
verdienen	VVFIN, VVPP, VVINF	15	verdient, verdienen, Verdienen, verdienten
warten	VVFIN, VVINF	15	wartet, warten, Warte, warte, Warten
vorhin	ADV	15	vorhin, Vorhin
zeigen	VVINF, VVFIN	15	zeigen, zeigst, zeigt, Zeige, zeige
besinnen	VVFIN, VVINF, VVPP	15	besinnen, besinne, besinnt, Besinnen, besinnst, Besinnst, besonnen
jung	ADJA, ADJD	15	jungen, jung, junger, junges
weiter	ADV, PTKVZ	14	weiter, Weiter
Art	NN	14	Art, Arten
Tag	NN	14	Tagen, Tag, Tage
Advokat	NN	14	Advokaten, Advokat
lernen	VVINF, VVPP, VVFIN	14	lernen, gelernt, Lerne, lerne, lernt, Lernen
verdammt	ADJA, ADJD	14	verdammter, verdammten, verdammte, verdammt, Verdammte, Verdammter
Kleinigkeit	NN	14	Kleinigkeit, Kleinigkeiten
Henker	NN	14	Henker
endlich	ADV	14	endlich, Endlich
lachen	VVINF, VVFIN, VVPP	14	lachen, lachst, lache, lacht, gelacht
Heirat	NN	14	Heirat
Verstand	NN	14	Verstandes, Verstand, Verstande
Teil	NN	14	Teil, Teile, Teils
oft	ADV	14	oft
Mensch	NN	14	Mensch, Menschen
Wille	NN	13	Wille, Willens, Willen
Einfall	NN	13	Einfall, Einfälle
nu	ITJ	13	Nu, nu
glücklich	ADJA, ADJD	13	glücklicher, glücklich, glückliche
Kerl	NN	13	Kerl
schweigen	VVIMP, VVINF	13	Schweig, schweig, schweigen
gleichwohl	ADV, KOUS	13	gleichwohl, Gleichwohl
Wohltat	NN	13	Wohltaten, Wohltat
Herz	NN	12	Herzen, Herz, Herze, Herzens
heraus	ADV, PTKVZ	12	heraus
Name	NN	12	Namen, Namens
deswegen	PAV	12	deswegen
helfen	VVINF, VVIMP, VVPP	12	helfen, hilf, Hilf, geholfen
schicken	VVINF, VVPP, VVFIN	12	schicken, geschickt, schicke, schickt
Ei	NN	12	Ei
Tisch	NN	12	Tisch, Tische, Tisches
heute	ADV	12	heute
gern	ADV	12	gern
schön	ADJD, ADJA	12	schön, schöne, schönen, schönste
Liebe	NN	12	Liebe
Haus	NN	12	Haus, Hause
brauchen	VVFIN, VVINF	11	brauchte, brauche, braucht, brauchen, brauchst
lieben	VVFIN, VVINF, VVPP	11	liebe, liebt, lieben, geliebt
Ding	NN	11	Ding, Dinger, Dingen, Dinge
Thalassio	NN, NE	11	Thalassio
schlagen	VVPP, VVFIN, VVINF	11	geschlagen, Schlagt, schlägt, schlage, schlagen, Schlagen
Berlin	NE	11	Berlin
fragen	VVPP, VVFIN, VVINF, VVIMP	11	gefragt, fragen, frage, fragte, fragt, frag
einander	PRF	11	einander
alsdenn	NE, NN, VVFIN	11	alsdenn
Lateiner	NN	11	Lateiner
jen	PDAT, PDS	11	jener, jenen, jene, jenem, jenes
klug	ADJA, ADJD	11	klügsten, klug, klüger, klügere
Dank	NN	11	Dank, Danke
Weib	NN	11	Weiber, Weibern, Weib, Weibes
Geld	NN	11	Geld, Gelde, Geldes
deutsch	ADJA, NN, ADJD	10	deutsche, Deutsch, deutsch, deutschen
Augenblick	NN	10	Augenblick, Augenblicke
Lisetten	NN	10	Lisetten
bitten	VVFIN, VVPP, VVINF	10	bitte, gebeten, bitten
Streich	NN	10	Streich, Streiche
fangen	VVFIN, VVPP, VVINF	10	fängt, gefangen, fingen, fangen, Fangen
rufen	VVFIN, VVINF, VVPP	10	ruft, rufen, gerufen
schlecht	ADJA, ADJD	10	schlechte, schlechten, schlechter, schlecht, Schlecht
merken	VVFIN, VVIMP, VVINF	10	merkt, merkst, merkte, merke, merken, merk
verzeihen	VVFIN, VVPP, VVINF	10	verzeihen, Verzeihen, verziehen
Maul	NN	10	Maul, Maule
bloß	ADJD, ADJA	10	Bloß, bloß, bloße, bloßen, bloßes
Alte	NN	10	Alten, Alte
Homer	NN, ADJA, ADJD	10	Homer
suchen	VVFIN, VVPP, VVINF	10	sucht, gesucht, suchte, suchen
loben	VVFIN, VVINF	10	lobt, lobe, loben, lobte, lobten
Mädchen	NN	9	Mädchen
legen	VVFIN, VVPP, VVINF	9	legen, legte, Legen, lege, legt, gelegt
Vermögen	NN	9	Vermögen, Vermögens
Epithalamium	NN	9	Epithalamium
ei	NE, FM	9	Ei, ei
einzig	ADJA, ADJD	9	einzige, einziges, einziger, einzig, einzigen
fein	ADJD, ADJA	9	fein, feines, feiner, Fein
Exempel	NN	9	Exempel
unser	PPOSAT	9	Unser, unsere, Unsere, unser, unsrer, unserm
Teufel	NN	9	Teufel
tausend	CARD	9	tausend, Tausend
nennen	VVFIN, VVINF	9	nennt, nennen
bedenken	VVFIN	9	Bedenke, Bedenken, bedenken
Dokument	NN	9	Dokument, Dokuments, Dokumente
Jungfer	NN	9	Jungfer
verlassen	VVPP, VVIMP, VVFIN, ADJD, VVINF	9	verlassen, Verlaß
sitzen	VVFIN, VVINF	9	sitzen, sitzt, sitze
heilig	ADJA, ADJD	9	heiligen, heiliger, heilige, heilig
Glück	NN	9	Glück
Geist	NN	9	Geist, Geister, Geistern
Auge	NN	9	Augen, Auge
fahren	VVPP, VVFIN, VVIMP, VVINF	9	gefahren, fahren, fahr, fährt
Seite	NN	8	Seiten, Seite
schlimm	ADJA, ADJD	8	schlimme, schlimm, schlimmsten, schlimmer, schlimmen
leben	VVFIN, VVINF	8	lebe, Leben, leben
halb	ADJD, ADJA	8	halb, halbe, halbes
Akademie	NN	8	Akademie
Xantippe	NN	8	Xantippe
schwer	ADJD, ADJA	8	schwer, schweren, schwerer
verlieren	VVPP, VVINF	8	verloren, verlieren
gehören|hören	VVPP	8	gehört, Gehört
leicht	ADJD	8	leichter, leicht
danken	VVFIN, VVPP, VVINF	8	danke, gedankt, danken
verlangen	VVFIN, VVPP, VVINF	8	verlangt, verlangst, verlangen
Taube	NN	8	Tauben, Taube
kaum	ADV	8	kaum, Kaum
umsonst	ADV	8	umsonst, Umsonst
Ernst	NN, NE	8	Ernst
Buche	NN	8	Buche
überlegen	VVFIN, VVINF, VVPP	8	überlegen, überlegt, Überlegen, überlege
Wahrheit	NN	8	Wahrheit, Wahrheiten
Mamsell	ADJA, NN, NE	8	Mamsell
jemals	ADV	7	jemals
schuldig	ADJD, ADJA	7	schuldig, schuldige
bezahlen	VVFIN, VVINF, VVPP	7	bezahlte, bezahlen, bezahlt
hintergehen	VVINF, VVPP, VVFIN	7	hintergehen, hintergangen, hintergeht, Hintergangen
laß	ADJD	7	laß
schade	ADJD	7	Schade
Ernste	NN, NE	7	Ernste
laufen	VVPP, VVINF, VVFIN	7	gelaufen, laufen, läuft, Läuft
albern	ADJA, ADJD	7	alberne, albern, albernes
Zweifel	NN	7	Zweifel
Tugend	NN	7	Tugend, Tugenden
stoßen	VVFIN, VVINF, VVPP, VVIMP	7	stoße, stoßen, stößt, gestoßen, Stoß
St	NE	7	St
fehlen	VVPP, VVFIN	7	gefehlt, fehlte, fehlt, fehlen
stören	VVINF, VVPP, VVFIN	7	stören, gestört, störe, stört
Deutsche	NN	7	Deutschen, Deutscher, Deutsche
Lüge|Lügen	NN	7	Lügen
ihrige	PPOSAT	7	Ihrige, ihrige
geschwind	ADJD	7	geschwind
darin	PAV	7	Darin, darin
Kabinett	NN	7	Kabinett, Kabinette
lehren	VVPP, VVFIN	7	gelehrt, lehren
essen	VVINF, VVFIN	7	essen, esse, ißt
übel	ADJD	7	übel, Übel
laut	ADJD, APPR	7	lauter, laut, Laut, Lauter
Republik	NN	7	Republik
verstecken	VVINF, VVFIN, VVPP	7	verstecken, Verstecke, verstecke, versteckt
erlauben	VVFIN, VVPP, VVINF	7	Erlauben, erlaubt, erlauben
fallen	VVFIN, VVIMP, VVINF	7	fiel, fall, fallen
vollkommen	ADJD	7	vollkommen, Vollkommen
überall	ADV	7	überall, Überall
Ursache	NN	7	Ursache, Ursachen
Bediente	NN	7	Bedienter, Bedienten
arm	ADJD, ADJA	7	arm, arme, armes, armen
Kind	NN	7	Kinder, Kind
fern	APPR, ADJD	7	fern
Seele	NN	7	Seele
sachte	ADV	7	Sachte, sachte
Vers	NN	7	Verse, Vers
ichs	ADJD	7	ichs
zurück	PTKVZ	7	zurück
Geschicklichkeit	NN	7	Geschicklichkeit
übrig	ADJA, ADJD	7	übrigen, übrig, übrige
treten	VVFIN	7	Trete, trete, Tritt, tritt
Abhandlung	NN	7	Abhandlung, Abhandlungen
Dankbarkeit	NN	6	Dankbarkeit
drei	CARD	6	drei
Person	NN	6	Person, Personen
falsch	ADJD, ADJA	6	falsch, falsches, Falscher, falschen, falscher
de	FM, NE	6	de
Ausstattung	NN	6	Ausstattung
wert	ADJD	6	wert
vernünftig	ADJD	6	vernünftig
unglücklich	ADJA, ADJD	6	unglückliches, unglücklich, Unglückliche
beinahe	ADV	6	beinahe
stecken	VVINF, VVFIN	6	stecken, steckt, Steckt
gehorchen	VVFIN, VVINF	6	gehorchten, Gehorchten, gehorchen
ansehen	VVINF, VVFIN, VVPP	6	ansehen, ansieht, angesehen
Preis	NN	6	Preis, Preise
Narre	NN, ADJD	6	Narre
spielen	VVFIN, VVINF	6	spielte, spielen, spielt
Schlingel	NN	6	Schlingel
Stand	NN	6	Stand, Stande
ewig	ADJD, ADJA	6	ewig, ewige
werd	VVFIN	6	ward
wunderbar	ADJA, ADJD	6	wunderbare, wunderbaren, wunderbar
fassen	VVINF, VVPP, VVFIN	6	fassen, gefaßt, Fassen
bekümmern	VVPP, VVINF	6	bekümmert, bekümmern
gering	ADJA	6	geringsten, geringe, geringste
nötig	ADJD	6	nötig
schimpfen	VVINF, VVFIN, VVPP	6	schimpfen, schimpft, schimpfe, geschimpft, Schimpften
zanken	VVINF, VVFIN, VVPP	6	zanken, gezankt
Idiote	NN	6	Idiote
verzweifelt	ADJA	6	verzweifelte
treffen	VVFIN, VVINF	6	trifft, treffen, träfe
besitzen	VVFIN, VVINF	6	besitzt, besitzen, besitze
edel	ADJD, ADJA	6	edler, edel, edle, Edle
werfen	VVFIN, VVPP, VVINF	6	warf, geworfen, werfen, wirft, Wirft
Schrift	NN	6	Schriften, Schrift
närrisch	ADJA, ADJD	6	närrische, närrischen, närrisch
meinig	PPOSS	6	meinigen, meinige
Freude	NN	6	Freude, Freuden
manchmal	ADV	6	manchmal
weder	KON	6	weder
ah	ITJ	6	Ah
Belohnung	NN	6	Belohnung
Abschied	NN	6	Abschied
Betrug	NN	6	Betrug
st	VVFIN	6	st
Lob	NN	6	Lob, Lobe
Tasche	NN	6	Taschen, Tasche
Stern	NN	6	Stern
Potz	NN	6	Potz
Nachricht	NN	6	Nachricht, Nachrichten
Lust	NN	6	Lust
niederträchtig	ADJA	5	niederträchtigste, niederträchtige, niederträchtiger
toll	ADJA, ADJD	5	tollen, toll
Stunde	NN	5	Stunde
Frage	NN	5	Fragen, Frage
tragen	VVFIN, VVPP	5	trug, trägt, trage, getragen
klingen	VVINF, VVFIN	5	klingen, klingt
Dutzend	NN	5	Dutzend
vielmehr	ADV	5	vielmehr
erhalten	VVFIN, VVINF, VVPP	5	erhält, erhalten, erhielten
Entschuldigung	NN	5	Entschuldigungen, Entschuldigung
Schuld	NN	5	Schuld
erzählen	VVINF, VVFIN	5	erzählen, Erzähle, erzählt
schließen	VVFIN, VVINF, VVPP	5	schließe, schließen, geschlossen
unwissend	ADJA	5	unwissenden, Unwissender, unwissende
griechisch	ADJD, ADJA	5	Griechisch, griechische, griechischen
hurtig	ADJD	5	Hurtig, hurtig
selber	ADV	5	selber
Absicht	NN	5	Absicht
halt	ADV	5	Halt
Torheit	NN	5	Torheiten, Torheit
deutlich	ADJD, ADJA	5	deutlicher, deutliche, deutlich
Geduld	NN	5	Geduld
führen	VVINF	5	führen
Weg	NN	5	Wege, Weg
betrachten	VVFIN, VVINF, VVPP	5	betrachten, betrachtet
nunmehr	ADV	5	nunmehr
aufhören	VVINF, VVFIN	5	aufhören, aufhört
eitel	ADJD	5	eitel
entschließen	VVPP, VVINF	5	entschlossen, entschließen
Zeitlebens	NN	5	Zeitlebens
Dummheit	NN	5	Dummheit
Julianens	NN	5	Julianens
los	PTKVZ, ADJD	5	los
Menscher	NN	5	Menscher
Bestie	NN	5	Bestie, Bestien
erinnern	VVFIN, VVINF	5	erinnere, erinnern, erinnerten
Zeitung	NN	5	Zeitung
berühmt	ADJA, ADJD	5	berühmte, berühmt
Mühe	NN	5	Mühe
aufs	APPRART	5	aufs
rächen	VVINF	5	rächen
darum	PAV	5	darum, Darum
redlich	ADJD	5	redlich, redlicher
mirs	ADJD	5	mirs
vollends	ADV	5	vollends
unterdessen	ADV	5	unterdessen, Unterdessen
nimmermehr	ADV	5	nimmermehr, Nimmermehr
zufrieden	ADJD, VVFIN	5	zufrieden
allerlieb	ADJA, ADJD	5	allerliebstes, allerliebst, allerliebster
arg	ADJD, ADJA	5	ärger, ärgeres, arg
zwingen	VVPP, VVINF	5	gezwungen, zwingen
Freundschaft	NN	5	Freundschaft
richten	VVFIN, VVINF	5	richtet, richten
besorgen	VVPP, VVFIN	5	besorgt, besorge
willen	APPO	5	willen, Willen
dringen	VVFIN, VVINF	5	dringe, dringt, dringen
Vetter	NE, NN	5	Vetter
schmeicheln	VVFIN, VVPP, VVINF	5	schmeichelt, geschmeichelt, schmeichle, schmeicheln
Veränderung	NN	5	Veränderung
tief	ADJD, ADJA	5	tiefer, tiefen, tiefe
Schulmeister	NN	5	Schulmeister, Schulmeistern
Anfang	NN	5	Anfang, Anfangs
einerlei	ADV, PIAT, PIS	5	einerlei
einbilden	VVINF, VVFIN, VVPP	5	einbilden, einbildet, eingebildet
weisen	VVFIN, VVINF	5	wies, weisen, weise
jemand	PIS	5	jemand
vier	CARD	5	vier
trauen	VVFIN, VVINF	5	traue, traut, trauen, Traut
Heirat|Heiraten	NN	5	Heiraten
sogleich	ADV	5	sogleich
Hoffnung	NN	5	Hoffnung
Schimpf	NN	5	Schimpf, Schimpfe
Weibsbild	NN	5	Weibsbild
weg	PTKVZ, ADV	5	weg
Gelegenheit	NN	5	Gelegenheit, Gelegenheiten
zwei	CARD	5	Zwei, zwei
erkennen	VVINF, VVFIN	5	erkennen
Amt	NN	5	Amt, Amte
niemand	PIS	4	niemand
fürchterlich	ADJA, ADJD	4	fürchterliche, fürchterlicher, fürchterlichsten, fürchterlich
Uhr	NN	4	Uhr
Posse	NN	4	Possen
drinne	VVFIN	4	drinne
Paar	NN	4	Paar
Arm|Arme	NN	4	Arme
Vaterland	NN	4	Vaterland
frei	ADJA, ADJD	4	freie, frei
kömmst	VVFIN	4	kömmst
Fertigkeit	NN	4	Fertigkeit
entschuldigen	VVINF, VVFIN	4	entschuldigen, entschuldigt
angenehm	ADJA, ADJD	4	angenehmerer, angenehmsten, angenehm
fürchten	VVFIN	4	Fürchten, fürchte
Lisettens	NN	4	Lisettens
Schule	NN	4	Schule
verflucht	ADJA	4	verfluchte, verfluchten, verfluchtes
wenig	ADV	4	wenig
Schande	NN	4	Schande
nie	ADV	4	nie
Beweis	NN	4	Beweise, Beweis
Eigenschaft	NN	4	Eigenschaft, Eigenschaften
Ton	NN	4	Tone
Beschäftigung	NN	4	Beschäftigungen
Quark	NN	4	Quark, Quarks
Hochzeit	NN	4	Hochzeit
leiden	VVINF, VVFIN	4	leiden, leidet
Taler	NN	4	Taler
leer	ADJD	4	leer
Kluge	NN, NE	4	Klugen, Kluges
rot	ADJA, ADJD	4	roten, rote, rot
übergeben	VVPP, VVINF	4	übergeben
wiederholen	VVINF, VVFIN	4	wiederholen, wiederhole
hoffen	VVFIN, VVINF	4	hoffe, hoffen, hoffte
Horaz	NE	4	Horaz
et	FM	4	et
Begriff	NN	4	Begriff, Begriffe
Kurz	NE	4	Kurz
Hals	NN	4	Hals
wacker	ADJD, ADJA	4	wacker, wackre
Aggressor	NN	4	Aggressor
unsre	PPOSAT	4	unsre, unsern
fallen|fällen	VVFIN	4	fällt
Mädel	NN	4	Mädel
Mund	NN	4	Mund, Munde
eigennützig	ADJD, ADJA	4	eigennützig, Eigennützigen, eigennützige
Prozess	NN	4	Prozeß
Abend	NN	4	Abend
entgegen	PTKVZ	4	entgegen
stark	ADJA, ADJD	4	starke, stärksten, stark
notwendig	ADJD	4	notwendig, Notwendig
minder	ADJD	4	minder
richtig	ADJD	4	richtig, Richtig
hinaus	ADV, PTKVZ	4	hinaus
lustig	ADJD	4	lustig, lustiger
erhitzen	VVPP, VVFIN	4	erhitzt, erhitze
Tor	NN	4	Toren, Tor
Tod	NN	4	Tode
herunter	ADV, PTKVZ	4	herunter
Ärger	NN	4	Ärgers
Sperling	NN	4	Sperling
verschieden	ADJA	4	verschiedene
ernsthaft	ADJA, ADJD	4	ernsthaftesten, ernsthafter, ernsthaften, ernsthaft
ausgehen	VVPP, VVINF	4	ausgegangen, ausgehen
Mönch	NN	4	Mönch
Wissenschaft	NN	4	Wissenschaften
Umstand	NN	4	Umstände, Umständen
Fehler	NN	4	Fehler
dadurch	PAV	4	dadurch, Dadurch
durchaus	ADV	4	durchaus
Dienst	NN	4	Diensten, Dienste, Dienst
erwarten	VVINF, VVPP, VVFIN	4	erwarten, erwartet, erwarte
vorlesen	VVPP, VVINF, VVFIN	4	vorgelesen, vorlesen
schwatzen	VVINF, VVFIN	4	schwatzen, schwatzt
Gesicht	NN	4	Gesicht
verfluchter	ADJA	4	verfluchter, Verfluchter
Schurke	NN	4	Schurke
Ritter	NN	4	Ritter
Weile	NN	4	Weile
geschehen	VVINF, VVPP, VVFIN	4	geschehen, geschieht
gemein	ADJD, ADJA	4	gemein, gemeinen, gemeiner
Kunst	NN	4	Kunst
Ort	NN	4	Ort, Orte
befehlen	VVINF, VVPP, VVFIN	4	befehlen, befohlen, befehle
zornig	ADJD	4	zornig
Nase	NN	4	Nase, Nasen
Lobeserhebungen	NN	4	Lobeserhebungen
Beschreibung	NN	4	Beschreibung, Beschreibungen
liebenswürdig	ADJA	4	liebenswürdiges, liebenswürdige, liebenswürdigen
Pfarr	NE	4	Pfarr
erstaunen	VVFIN, VVINF, VVPP	4	erstaune, erstaunen, erstaunt
Mannsperson	NN	4	Mannspersonen
Kompliment	NN	4	Komplimente, Kompliment
wunderlich	ADJA	4	wunderlichen, wunderliche, Wunderliche
wodurch	PWAV	4	Wodurch, wodurch
euer	PPOSAT	4	euer, eure, eurer
Monade	NN	4	Monaden
Rede	NN	4	Rede
Studierstube	NN	4	Studierstube
Mode	NN	4	Mode
Kaufmann	NN	4	Kaufmann
allezeit	ADV	4	allezeit
Rechnung	NN	4	Rechnungen, Rechnung
Stadt	NN	4	Stadt
längst	ADV	4	längst
ziehen	VVINF, VVPP	4	ziehen, gezogen
entdecken	VVINF	4	entdecken
greifen	VVFIN	4	greift, griff, greife
Bösewicht	NN	4	Bösewicht, Bösewichte
Ohr	NN	4	Ohren, Ohr
handeln	VVINF, VVFIN	4	handeln, handelt
denken|gedenken	VVPP	4	gedacht
Jugend	NN	4	Jugend
perpende	NN	4	perpende
aufmerksam	ADJD	4	aufmerksam
eins	CARD	4	eins, einem
Unwissende	NN	4	Unwissenden, Unwissender, Unwissende
Vertrauen	NN	4	Vertrauen
seit	APPR	4	seit, Seit
vortrefflich	ADJA, ADJD	4	vortreffliches, vortreffliche, vortrefflich
voraus	PTKVZ, ADV	3	voraus
Misstrauen	NN	3	Mißtrauen
annehmen	VVIZU, VVFIN	3	anzunehmen, annimmst
Zeug	NN	3	Zeug
gesinnt	ADJD	3	gesinnt
Plaudern	NN	3	Plaudern
nichtswürdig	ADJA	3	nichtswürdigen, nichtswürdige
Deutschland	NE	3	Deutschland
sicher	ADJD, ADJA	3	sicher, sichersten
sterben	VVPP, VVFIN, VVINF	3	gestorben, starb, sterben
Gegenstand	NN	3	Gegenstand
Antwort	NN	3	Antwort, Antworten
unsterblich	ADJD	3	unsterblich
entreißen	VVPP, VVINF	3	entrissen, entreißen
weniger	ADV	3	weniger
Urteil	NN	3	Urteil
viperino	NE	3	viperino
Rede|Reden	NN	3	Reden
Sakrament	NN	3	Sakrament
vorgehen	VVFIN, VVPP	3	vorgeht, vorgegangen
gefährlich	ADJD, ADJA	3	gefährlich, gefährliche, gefährlichen
raten	VVFIN, VVINF	3	raten, rate
Närrin	NN	3	Närrin
nahe	PTKVZ	3	nahe
Schein	NN	3	Schein
Gang	NN	3	Gang
Vergnügen	NN	3	Vergnügen, Vergnügens
Grille|Grillen	NN	3	Grillen
dasjenige	PDS	3	dasjenige
Gewalt	NN	3	Gewalt
<UNKNOWN>	NN, VVINF	3	Stirne, öftern, Galimathias
erfüllen	VVINF	3	erfüllen
Schweig	NE	3	Schweig
zänkisch	ADJD	3	zänkisch
Vorurteil	NN	3	Vorurteile, Vorurteil
ankommen	VVFIN, VVINF	3	ankäme, ankommen
Ungewissheit	NN	3	Ungewißheit
unten	ADV	3	unten
kosten	VVINF, VVFIN	3	kosten, kostet
Punkt	NN	3	Punkt, Punkte
Wichtigste	NN	3	Wichtigste, Wichtigsten
naseweis	ADJD	3	naseweis
hübsch	ADJD, ADJA	3	hübsch, hübsches
tugendhaft	ADJD	3	tugendhaft
woher	PWAV	3	woher, Woher
Devise	NN	3	Devise
dritt	ADJA	3	dritten, dritte
Ehemann	NN	3	Ehemann
lateinisch	ADJA, ADJD	3	lateinisches, Lateinisch, lateinischen
vel	NE, ADJA	3	vel
Tat	NN	3	Tat
geloben|loben	VVPP	3	gelobt
Gute	NN	3	Gutes, Gute
Unrecht	NN	3	Unrecht, Unrechtes
Ehestand	NN	3	Ehestand
Benennung	NN	3	Benennungen, Benennung
versuchen	VVFIN, VVINF, VVPP	3	Versuchen, versuchen, versucht
Rat	NN	3	Rat
ausculta	ADJA	3	ausculta
schaden	VVFIN, VVIMP	3	schadet, Schade
gestern	ADV	3	gestern
Gewäsche	NN	3	Gewäsche
Chrysandern	NN	3	Chrysandern
erträglich	ADJA, ADJD	3	erträglichsten, erträglich
schwärmst	VVFIN	3	schwärmst
Maulschelle	NN	3	Maulschelle, Maulschellen
nochmals	ADV	3	nochmals
beibringen	VVIZU, VVPP	3	beizubringen, beigebracht
vorbei	ADV	3	vorbei
unselig	ADJA	3	unseligen, unselige
betriegen	ADJD, VVFIN	3	betriegen
Dummkopf	NN	3	Dummkopf
Licht	NN	3	Licht
gefallen	VVINF, VVFIN	3	gefallen, gefällt
behalten	VVINF	3	behalten
Bescheidenheit	NN	3	Bescheidenheit
dick	ADJA	3	dicken, dicke
besonder	ADJA	3	besondere
barbarisch	ADJA	3	barbarischer, barbarische, barbarischen
Werk	NN	3	Werk, Werke
verhelfen	VVINF	3	verhelfen
herum	APZR	3	herum
vergebens	ADV	3	vergebens
blau	ADJA	3	blaue, blauen
Mus|Muse	NN	3	Musen, Muse
gebären	VVPP	3	geboren
erkenntlich	ADJD	3	erkenntlich
geschickt	ADJD	3	geschickt
verstehn	ADJD, VVFIN, VVINF	3	verstehn
Nacht	NN	3	Nächte, Nacht
Ratsherr	NN	3	Ratsherrn, Ratsherr
Neigung	NN	3	Neigung
Meinung	NN	3	Meinung, Meinungen
rühmen	VVINF	3	rühmen
empfinden	VVFIN, VVINF	3	empfinde, empfinden
Nu	NN	3	Nu
ehe	KOUS	3	ehe, Ehe
Spiel	NN	3	Spiele, Spiel
schätzen	VVINF, VVPP	3	schätzen, geschätzt
Verdruss	NN	3	Verdruß
erfahren	VVINF, VVPP	3	erfahren
Stunde|Stunden	NN	3	Stunden
empfindlich	ADJD	3	empfindlicher, empfindlich
Braut	NN	3	Braut
italienisch	NN, ADJA	3	Italienisch, italienische, italienischen
wohin	PWAV	3	wohin
einfältig	ADJD	3	einfältig, einfältiger
unterstehen	VVINF, VVFIN	3	unterstehen, Unterstehe
vortragen	VVIZU, VVINF, VVFIN	3	vorzutragen, vortragen, vorträgt
Liebhaber	NN	3	Liebhabers, Liebhaber
verleumden	VVINF	3	verleumden
grausam	ADJD, ADJA	3	grausam, grausamste
Bekanntschaft	NN	3	Bekanntschaft
Reise|Reisen	NN	3	Reisen
ungestört	ADJD	3	ungestört
Verdienst	NN	3	Verdiensten, Verdienste
hebräisch	ADJA, ADJD	3	hebräischer, Hebräisch, hebräischen
irren	VVFIN, VVPP	3	irren, geirrt
Unglück	NN	3	Unglück
zugleich	ADV	3	zugleich
zerstreut	ADJD	3	zerstreut
freigebig	ADJD, ADJA	3	freigebig, freigebigen
unerträglich	ADJA	3	unerträgliche, unerträglichste
Handel	NN	3	Handel
Geplaudre	NN	3	Geplaudre
Dienerin	NN	3	Dienerin
Mittel	NN	3	Mittel
beständig	ADJD, ADJA	3	beständig, beständige
unrecht	ADJD, ADJA	3	unrecht, unrechte
Neuigkeit	NN	3	Neuigkeit, Neuigkeiten
zerreißen	VVFIN	3	zerreißen, zerreißt, zerreiße
Hören	NN	3	Hören
frisch	ADJD	3	frisch, frischer
küssen	VVINF	3	küssen
Hymenaeus	NN	3	Hymenaeus
fliehen	VVINF, VVFIN	3	fliehen, fliehe
nützlich	ADJA, ADJD	3	nützliche, nützlich, nützlicher
Irrtum	NN	3	Irrtümer, Irrtümern, Irrtum
erraten	VVINF, VVPP	3	erraten
Betrieger	NN	3	Betrieger
beweisen	VVINF, VVPP	3	beweisen, bewiesen
dreien	CARD	3	dreien
verjagen	VVPP, VVFIN	3	verjagt
einbinden	VVPP	3	eingebunden
Kenntnis	NN	3	Kenntnis
Staat	NN	3	Staaten, Staat, Staate
redt	ADJD	3	redt
weiß	ADJD	3	weiß, Weiß
allgemein	ADJA, ADJD	3	allgemeinen, allgemein
acht	CARD	3	acht
meinetwegen	ADV	3	meinetwegen
holen	VVPP, VVINF	3	geholt, holen
taugen	VVFIN	3	taugt, taugen, tauge
Schlange	NN	3	Schlange, Schlangen
Ruhm	NN	3	Ruhm
anhören	VVFIN, VVINF	3	anhörst, anhören
Gemüt	NN	3	Gemüt, Gemüter
gestehen	VVINF	3	gestehen
voll	ADJD, ADJA	3	voll, voller
überführen	VVINF, VVPP	3	überführen, überführt
Finger	NN	3	Finger, Fingern
erklären	VVFIN, VVINF	3	erkläre, erklären
Land	NN	3	Lande, Land, Ländern
Papier	NN	3	Papier
Quelle	NN	3	Quelle
Erklärung	NN	3	Erklärungen, Erklärung
ausdrücken	VVINF, VVPP, VVIZU	3	ausdrücken, ausgedrückt, auszudrücken
umgehen	VVFIN, VVIZU, VVPP	3	umgeht, umzugehen, umgegangen
spöttisch	ADJD	3	Spöttisch, spöttisch
Sinn	NN	3	Sinn, Sinne
erwägen	VVFIN, VVINF	3	erwäge, erwägen
gedenken	VVFIN, VVINF	3	gedächte, gedenke, gedenken
Tier	NN	3	Tiere, Tier
verbinden	VVFIN, VVINF	3	verbindet, verbinden
Irrtume	NN	3	Irrtume
Unwissenheit	NN	3	Unwissenheit
Esel	NN	3	Esel
plaudern	VVPP	3	geplaudert
Entschluss	NN	3	Entschluß
fremd	ADJA	3	fremde, fremden
Ohrfeige	NN	3	Ohrfeige
Genie	NN	3	Genies
non	NE, XY	3	non
beschreiben	VVFIN, VVINF	3	beschreibt, beschreiben
bewundern	VVINF, VVFIN	3	bewundern, bewunderst
verfluchen	VVPP	3	verflucht, Verflucht
vorschlagen	VVPP, VVFIN, VVINF	3	vorgeschlagen, vorschlug, vorschlagen
Spötterei	NN	3	Spötterei, Spöttereien
genau	ADJD, ADJA	3	genau, genauer
beschließen	VVPP, VVINF	3	beschlossen, beschließen
wünschen	VVFIN	3	wünsche, wünscht
est	ADJA	3	est
aufstehen	VVPP	3	aufgestanden
zweifeln	VVFIN, VVINF	3	zweifeln
studieren	VVPP, VVINF, VVFIN	3	studiert, studieren, studierst
ärgerlich	ADJD	3	Ärgerlicher, ärgerlich
Ihrigen	NN	3	Ihrigen
mehrerm	ADJA	3	mehrerm
nieder	PTKVZ	2	nieder
Kleid	NN	2	Kleid, Kleider
neun	CARD	2	neun
pflegen	VVINF	2	pflegen
Umgang	NN	2	Umgang
Erkenntlichkeit	NN	2	Erkenntlichkeit
fleißig	ADJD, ADJA	2	fleißig, fleißiger
Miene	NN	2	Mienen, Miene
Beichtvater	NN	2	Beichtvater
vorig	ADJA	2	vorigen, vorige
Katerchen	NN	2	Katerchen
anführen	VVINF, VVFIN	2	anführen, anführt
Recht|Rechte	NN	2	Rechte
Überlegung	NN	2	Überlegung
drauf	PAV	2	drauf
Acht	NN	2	Acht
ausfallen	VVINF, VVPP	2	ausfallen, ausgefallen
Geschäft	NN	2	Geschäften
Versprechung	NN	2	Versprechung, Versprechungen
vierzig	CARD	2	vierzig
hundert	CARD	2	hundert
Junge	NN	2	Junge
satt	ADJD	2	satt
damalig	ADJA	2	damaligen
kehren	VVFIN	2	kehret, kehren
Einbildungskraft	NN	2	Einbildungskraft
ergreifen	VVFIN, VVINF	2	ergreife, ergreifen
nachreden	VVINF	2	nachreden
philosophisch	ADJD, ADJA	2	philosophischer, philosophischen
billig	ADJA, ADJD	2	billige, billig
antreffen	VVFIN, VVINF	2	antreffe, antreffen
beklagen	VVFIN, VVINF	2	beklagen
Bande	NN	2	Bande, Banden
Widerwille	NN	2	Widerwillen, Widerwillens
Unum	NN	2	Unum
abziehen	VVINF, VVPP	2	abziehen, abgezogen
Cha-	TRUNC	2	Cha-
letztern	ADJD	2	letztern
müßig	ADJD, ADJA	2	müßig, müßige
Dichterin	NN	2	Dichterinnen
unterscheiden	VVINF	2	unterscheiden
Horn	NN	2	Horn, Horne
zubringen	VVIZU, VVPP	2	zuzubringen, zugebracht
unnötig	ADJD	2	unnötig, Unnötig
Meretrix	NE, NN	2	Meretrix
Freigeisterei	NN	2	Freigeisterei
zuletzt	ADV	2	zuletzt
tot	ADJA	2	tote, toten
disputiert	VVFIN, ADJD	2	disputiert
tod	ADJD	2	tod
Prügel	NN	2	Prügel
einrichten	VVPP, VVIZU	2	eingerichtet, einzurichten
Buchdrucker	NN	2	Buchdrucker
leugnen	VVFIN, VVINF	2	leugnen
künftig	ADJA, ADJD	2	künftiger, künftig
unterschieben	VVINF, VVPP	2	unterschieben, untergeschoben
besuchen	VVFIN	2	besuchte
bst	VVFIN	2	bst
ansehnlich	ADJA	2	ansehnliche
Karlinen	NE	2	Karlinen
fordern	VVFIN	2	fordert, Fordern
Untersuchung	NN	2	Untersuchung
singen	VVPP	2	gesungen
Verbindung	NN	2	Verbindung
Brand	NE	2	Brand
Schlag	NN	2	Schläge, Schlage
ungelehrten	ADJA	2	ungelehrten
rechtschaffen	ADJA	2	rechtschaffene
Mademoisell	VVFIN	2	Mademoisell
schämen	VVINF	2	schämen
schwach	ADJD	2	schwächer
uxoribus	NN	2	uxoribus
Ergötzlichkeiten	NN	2	Ergötzlichkeiten
bekannt	ADJD	2	bekannt
Gewohnheit	NN	2	Gewohnheit
Umfang	NN	2	Umfange
vorgesetzt	ADJA	2	vorgesetzten
Sprüchelchen	NN	2	Sprüchelchen
schenken	VVFIN	2	schenkt
geraten|raten	VVPP	2	geraten
vexieren	VVINF, VVFIN	2	vexieren
Grund	NN	2	Grunde, Gründe
kützliche	ADJA	2	kützliche
selig	ADJA	2	selige, seliger
Geschöpf	NN	2	Geschöpfe, Geschöpfen
Aufmerksamkeit	NN	2	Aufmerksamkeit
fest	ADJD	2	fest
aussuchen	VVINF	2	aussuchen
Erlaubnis	NN	2	Erlaubnis
Besitz	NN	2	Besitz
Zorn	NN, NE	2	Zorn
wenden	VVFIN	2	Wendet, wende
ankleiden	VVFIN, VVINF	2	ankleiden
jetzo	ADJD	2	jetzo
Sachsen	NE	2	Sachsen
kalt	ADJD, ADJA	2	kalt, kalten
gewinnen	VVPP	2	gewonnen
Geschlecht	NN	2	Geschlechts
Vogel	NN	2	Vogel
zärtlich	ADJA	2	zärtliches
gönnen	VVINF, VVFIN	2	gönnen, gönnt
Medikus	NN	2	Medikus
misstrauisch	ADJA, ADJD	2	mißtrauischen, mißtrauisch
Ho	NE	2	Ho
Versprechen	NN	2	Versprechen
Grab	NN	2	Grabe, Grab
Grad	NN	2	Grade, Grad
darunter	PAV	2	darunter
aufhängen	VVINF	2	aufhängen
woran	PWAV	2	woran
Geschichte	NN	2	Geschichte
Ende	NN	2	Ende
überwinden	VVFIN, VVINF	2	überwindet, überwinden
zählen	VVINF, VVFIN	2	zählen
beschwerlich	ADJD	2	beschwerlich
Verfasser	NN	2	Verfasser
Versuch	NN	2	Versuch, Versuche
gehöret	VVPP, VVFIN	2	gehöret
zurechte	NN	2	zurechte
verdächtig	ADJD	2	verdächtig
wählen	VVFIN	2	wählte, wähle
Kömmt	NN, VVFIN	2	Kömmt
Geistliche	NN	2	Geistlicher, Geistlichen
Wahl	NN	2	Wahl
behaupten	VVFIN	2	behauptet, behaupte
Narrenspossen	NN	2	Narrenspossen
verbergen	VVPP, VVINF	2	verborgen, verbergen
lächerlich	ADJD	2	lächerlich
Alliierte	NN	2	Alliierten
erfordern	VVPP	2	erfordert
sieben	CARD	2	sieben
zeugen	VVINF, VVPP	2	zeugen, gezeugt
vermieten	VVPP, VVFIN	2	vermietet
Vorwurf	NN	2	Vorwürfe
Gesellschaft	NN	2	Gesellschaften, Gesellschaft
verständlich	ADJD	2	verständlich
zugeben	VVINF	2	zugeben
betrügen	VVPP	2	betrogen
berechtiget	ADJA, VVFIN	2	berechtiget
still	ADJD, ADJA	2	still, stille
Tapete	NN	2	Tapete
gnädig	ADJD, ADJA	2	gnädig, gnädigen
kosen|kosten	VVFIN	2	koste
Gleichnis	NN	2	Gleichnis
bekömmt	VVFIN	2	bekömmt
übergehen	VVINF, VVFIN	2	übergehen
blind	ADJD, ADJA	2	blind, blinde
aufheben	VVIZU, VVINF	2	aufzuheben, aufheben
Lohn	NN	2	Lohn
sechs	CARD	2	sechs
Erklären	NN	2	Erklären
vornehm	ADJA	2	vornehmste
ans	APPRART	2	ans
Bein	NN	2	Beine
fertig	ADJD	2	fertig
Karlin	NE	2	Karlin
Sterbliche	NN	2	Sterblicher, Sterbliche
garstig	ADJA	2	garstiges, Garstige
willigen	VVINF	2	willigen
verachten	VVPP, VVFIN	2	verachtet, verachte
Hochzeitgedichte	NN	2	Hochzeitgedichte
väterlich	ADJA	2	väterlichen
Weise	NN	2	Weise
Gegenwärtige	NN	2	Gegenwärtige
versichern	VVPP, VVFIN	2	Versichert, versichern
Anspruch	NN	2	Anspruch
Lotrix	NE, NN	2	Lotrix
zugegen	ADJD	2	zugegen
gehörig	ADJD	2	gehörig
damals	ADV	2	damals
einfallen	VVPP	2	eingefallen
teuer	ADJD, ADJA	2	teuersten, teuren
Verteidiger	NN	2	Verteidiger
Kranke	NN	2	Kranken
Kreatur	NN	2	Kreatur
Gestrige	NN	2	Gestrige, Gestrigen
Raserei	NN	2	Raserei
Überbleibsel	NN	2	Überbleibsel
dergleichen	PIS	2	dergleichen
Barbara	NE	2	Barbara
krank	ADJD	2	krank, kränker
Sitte	NN	2	Sitten
meiste	PIS	2	meisten
murmeln	VVFIN, VVINF	2	murmelt, murmeln
mutantur	NN	2	mutantur
Spitzbube	NN	2	Spitzbuben, Spitzbube
Befehl	NN	2	Befehle, Befehl
Schwäche	NN	2	Schwäche
bereden	VVINF	2	bereden
Stuhl	NN	2	Stuhl, Stuhle
kriechen	VVFIN, VVPP	2	kriecht, gekrochen
fortmachen	ADJD, VVINF	2	fortmachen
tausendmal	ADV	2	tausendmal
jagen	VVINF, VVFIN	2	jagen, jagt
Einwilligung	NN	2	Einwilligung
diejenigen	PDAT	2	diejenigen
Tüchtge	ADJA	2	Tüchtge
Gedächtnis	NN	2	Gedächtnis
Übung	NN	2	Übung
wackeln	VVPP, VVFIN	2	gewackelt, wackelt
Wissen	NN	2	Wissen
pfui	ITJ	2	Pfui
sanguine	NE	2	sanguine
Element	NN	2	Element, Elemente
etwan	ADJA, NN	2	etwan
leisten	VVINF, VVFIN	2	leisten, leistet
Rabbi	NN	2	Rabbi, Rabbinen
dienen	VVINF, VVPP	2	dienen, gedient
Vorzug	NN	2	Vorzug
hinein	ADV, PTKVZ	2	hinein
viert	ADJA	2	vierte
trinken	VVFIN, VVINF	2	trinken
Lehre	NN	2	Lehre
Körper	NN	2	Körper
verzweifeln	VVINF, VVPP	2	verzweifeln, Verzweifelt
Barmherzigkeit	NN	2	Barmherzigkeit
alsdann	ADJD, VVFIN	2	alsdann
aufschreiben	VVINF, VVIZU	2	aufschreiben, aufzuschreiben
abbringen	VVINF, VVIZU	2	abbringen, abzubringen
zumal	KOUS	2	zumal
anbringen	VVIZU, VVFIN	2	anzubringen, anbringen
widersprechen	VVFIN, VVINF	2	widersprichst, widersprechen
Dresden	NE	2	Dresden
redte	ADJA, VVFIN	2	redte
Tempus	NN	2	Tempora
Betriegerin	NN	2	Betriegerin
abhelfen	VVIZU	2	abzuhelfen, Abzuhelfen
Erde	NN	2	Erde
zeihen|ziehen	VVFIN	2	ziehe
dreimal	ADV	2	dreimal
unbesorgt	ADJD	2	unbesorgt
abhalten	VVPP, VVFIN	2	abgehalten, abhielt
flüchtig	ADJD	2	flüchtig, flüchtiger
Hölle	NN	2	Hölle
Henne	NN	2	Henne
necessarium	NN	2	necessarium
zugestehen	VVINF	2	zugestehen
Buchstabe	NN	2	Buchstabe, Buchstaben
Ratskeller	NN	2	Ratskeller
hierin	PAV	2	Hierin, hierin
bürgerlich	ADJA	2	bürgerliche, bürgerlichen
ruhig	ADJD	2	ruhig
jetzig	ADJA	2	jetzigen
unverschämt	ADJA	2	Unverschämte, unverschämte
Verrichtung	NN	2	Verrichtung, Verrichtungen
Poesie	NN	2	Poesie
Galle	NN	2	Galle
Zettel	NN	2	Zettel
Mutter	NN	2	Mutter
Teller	NN	2	Teller
Erkenntnis	NN	2	Erkenntnis
überlassen	VVPP, VVFIN	2	überlassen
unsinnig	ADJA	2	unsinnige
Freiheit	NN	2	Freiheit
erbarmen	VVINF, VVFIN	2	erbarmen
genießen	VVPP	2	genossen
Cautius	NE	2	Cautius
finster	ADJD	2	finster
Held	NN	2	Helden
Viertelstunde	NN	2	Viertelstunde
strafen	VVINF, VVPP	2	strafen, gestraft
überedel	NE, ADJD	2	überedel
Treue	NN	2	Treue
Gütigkeit	NN	2	Gütigkeit
Hochzeitsfackel	NN	2	Hochzeitsfackel
schwören	VVFIN	2	schwöre, schwur
unschuldig	ADJA	2	unschuldige
Natur	NN	2	Natur
beleidigen	VVINF	2	beleidigen
ungehalten	ADJD	2	ungehalten
bewegen	VVFIN, VVPP	2	bewegt, bewogen
herein	ADV	2	herein
Arbeit	NN	2	Arbeit
behülflich	ADJD	2	behülflich
Faulheit	NN	2	Faulheit
Aufschlag	NN	2	Aufschlägen, Aufschläge
fällen	VVPP	2	gefällt
stellen	VVFIN	2	stellte, stellten
Lobspruch	NN	2	Lobsprüche
Aufgabe	NN	2	Aufgabe, Aufgaben
erschrecken	VVINF, VVFIN	2	erschrecken, erschrickst
Zukünftige	NN	2	Zukünftige
beschwören	VVFIN, VVPP	2	beschwöre, beschworen
folglich	ADV	2	Folglich
Zerstreuung	NN	2	Zerstreuung
weis	PTKVZ	2	weis
Latein	NN	2	Latein
zerstreuen	VVPP	2	zerstreut
schaffen	VVINF, VVFIN	2	schaffen, schaffe
Menge	NN	2	Menge
verderben	VVINF	2	verderben
Maß	NN	2	Maße, Maß
Schicksal	NN	2	Schicksale, Schicksal
Feind	NN	2	Feindes, Feind
Verlust	NN	2	Verluste
Controversiä	NE	2	Controversiä
Einsicht	NN	2	Einsicht
Redner	NN	2	Redner
fallen|gefallen	VVPP	2	gefallen
Gleichgültigem	NN	2	Gleichgültigem
Chrysanders	NN	2	Chrysanders
aufopfern	VVINF	2	aufopfern
Marter	NN	2	Marter
verfallen	VVINF	2	verfallen
langsam	ADJA	2	langsame, langsamen
Anmerkung	NN	2	Anmerkung, Anmerkungen
umwenden	VVFIN	2	umwende, umwendet
neben	APPR	2	neben
Leben	NN	2	Leben
fühls	VVFIN, NN	2	fühls
Stimme	NN	2	Stimme
Schurek	NE	2	Schurek
reich	ADJD	2	reich
gleichfalls	ADV	2	gleichfalls
verdanken	VVINF	2	verdanken
Pflicht	NN	2	Pflicht
eigensinnig	ADJD	2	eigensinnig
unvergleichlich	ADJA	2	unvergleichlicher, unvergleichliche
undankbar	ADJA	2	undankbare, undankbares
Status	NN	2	Status
Hui	NE	2	Hui
Zahl	NN	2	Zahl
Schwur	NN	2	Schwur
ander	ADJA	2	ander
Roman	NN	2	Romane
paar	PIAT	2	Paar
zeitig	ADJD	2	zeitig
Gesangbuche	NN	2	Gesangbuche
geredt	ADJD	2	geredt
morgen	ADV	2	Morgen
Doktor	NN	2	Doktor
warnen	VVINF, VVFIN	2	warnen, warne
Gehirn	NN	2	Gehirne, Gehirn
aussetzen	VVPP	2	ausgesetzt
Gefahr	NN	2	Gefahr
ausnehmen	VVPP	2	ausgenommen
reißen	VVFIN, VVINF	2	Reißt, reißen
bekennen	VVPP, VVINF	2	bekannt, bekennen
Übel	NN	2	Übels, Übel
hinterbringen	VVINF, VVFIN	2	hinterbringen
Philosoph	NN	2	Philosophen
zugehen	VVPP, VVINF	2	zugegangen, zugehen
Vorschrift	NN	2	Vorschriften
wovon	PWAV	2	wovon
einnehmen	VVPP	2	eingenommen
Sorge	NN	2	Sorge
hässlich	ADJA	2	häßliche
Zweck	NN	2	Zwecken
Chaos	NN	2	Chaos
kauen	VVINF, VVFIN	2	kauen, kaut
überdrüssig	ADJD	2	überdrüssig
aufrichtig	ADJA	2	aufrichtiges, aufrichtigsten
Blatt	NN	2	Blatt
Scherz	NN	2	Scherze, Scherz
ists	VVFIN, ADJD	2	ists
melden	VVINF, VVFIN	2	melden
eingebildet	ADJA	2	eingebildete
fliegen	VVINF	2	fliegen
Loch	NN	2	Loch
rechnen	VVINF, VVFIN	2	rechnen, rechnet
Sonne	NN	2	Sonne
gebräuchlich	ADJD	2	gebräuchlich
beßre	VVFIN, NN	2	beßre
Schelm	NN	2	Schelm
Heller	NN	2	Heller
rechen	VVFIN	2	rechte, rechten
kindisch	ADJD, ADJA	2	kindisch, kindische
Gesetz	NN	2	Gesetze
Aspasia	NE	2	Aspasia
drum	PAV	2	drum, Drum
Schalk	NN	2	Schalk
scherzen	VVINF, VVFIN	2	scherzen
Poetrix	NN	2	Poetrix
Verspottungen	NN	2	Verspottungen
ändern	VVFIN, VVPP	2	ändern, geändert
Verzweiflung	NN	2	Verzweiflung
Buckel	NN	2	Buckel
alleine	ADV	2	alleine
vermehren	VVINF	2	vermehren
Betriegern	NN	2	Betriegern
Grundsatz	NN	2	Grundsatz
worauf	PWAV	2	worauf
abwarten	VVINF	2	abwarten
martern	VVINF	2	martern
weh	ADJD	2	weh
Hym	ADJA, NN	2	Hym
Profession	NN	2	Profession
treffen|triefen	VVPP	2	Getroffen, getroffen
Eruditorum	NN	2	Eruditorum
Rätsel	NN	2	Rätsel
Hochmut	NN	2	Hochmuts, Hochmut
äußerlich	ADJA	2	äußerlichen
gestrig	ADJA	2	gestrigen, gestrige
Tracht	NN	2	Tracht
Weltweiser	NN	2	Weltweiser
ankömmt	ADJA, VVFIN	2	ankömmt
Ungelehrte	NN, ADJA	2	Ungelehrte
Sorgfalt	NN	2	Sorgfalt
hängen	VVFIN	2	hängt
hi	VVFIN	2	hi
ho	VVFIN	2	ho
Kömmst	VVFIN	2	Kömmst
he	ITJ	2	he
Celarent	ADJA, VVFIN	2	Celarent
Eifer	NN	2	Eifer
Haut	NN	2	Haut
Geschmack	NN	2	Geschmack
Nachteil	NN	2	Nachteile, Nachteil
Backe|Backen	NN	2	Backen
Verräter	NN	2	Verräter
abzuhangen	VVIZU	1	abzuhangen
scheiden	VVPP	1	geschieden
öfter	ADV	1	öfter
betteln	VVINF	1	betteln
steigen	VVFIN	1	steigen
parlieren	VVINF	1	parlieren
Lorbeer	NN	1	Lorbeer
bemächtiget	VVFIN	1	bemächtiget
Zweifler	NN	1	Zweiflern
Lunge	NN	1	Lunge
gänzlich	ADJD	1	gänzlich
dachen	VVFIN	1	dacht
doctus	NN	1	doctus
Aufopfern	NN	1	Aufopfern
ergo	ADV	1	ergo
göttlich	ADJA	1	göttlichen
Platz	NN	1	Platz
mäßig	ADJA	1	mäßigen
überlästig	ADJD	1	überlästig
nichtswürdigsten	ADJA	1	nichtswürdigsten
Telesillen	NN	1	Telesillen
träumen	VVINF	1	träumen
Denkungsart	NN	1	Denkungsart
Gasse	NN	1	Gassen
nimium	NN	1	nimium
Ururältervater	NN	1	Ururältervater
Todenmahle	NN	1	Todenmahle
Weibsbilde	NN	1	Weibsbilde
wegschicken	VVPP	1	weggeschickt
Wörtchen	NN	1	Wörtchen
gucken	VVIMP	1	guck
Scharteke	NN	1	Scharteke
Beratschlagung	NN	1	Beratschlagung
manum	NN	1	manum
Rarität	NN	1	Raritäten
gesteh	NE	1	gesteh
Figur	NN	1	Figuren
a	FM	1	a
Abendessen	NN	1	Abendessen
Schwester	NN	1	Schwester
Pum	NN	1	Pum
nachdenken	VVFIN	1	nachdenke
ruchlos	ADJA	1	ruchloser
Spur	NN	1	Spur
begucken	VVPP	1	beguckt
überzeugen	VVPP	1	überzeugt
speien	VVINF	1	speien
Vorteil	NN	1	Vorteil
übermäßig	ADJA	1	übermäßige
Lehrbuch	NN	1	Lehrbüchern
gottlos	ADJA	1	gottlose
Andre	NE	1	Andre
Homo	NN	1	Homo
Spruch	NN	1	Sprüche
nulla	VVFIN	1	nulla
Eingezogenheit	NN	1	Eingezogenheit
himmlisch	ADJA	1	himmlische
anheben	VVINF	1	anheben
zerbrechen	VVPP	1	zerbrochen
undeutlich	ADJD	1	undeutlich
Drohung	NN	1	Drohungen
Gleiche	NN	1	Gleiches
Zureden	NN	1	Zureden
euern	ADJA	1	euern
wenigsten	ADV	1	wenigsten
Arzneikunst	NN	1	Arzneikunst
gedienet	VVPP	1	gedienet
gelassener	ADJD	1	gelassener
Ärgernis	NN	1	Ärgernis
bewusst	ADJD	1	bewußt
warm	ADJD	1	warm
zuwider	PTKVZ	1	zuwider
Eruditis	NN	1	Eruditis
Pakto	NN	1	Pakto
ers	ADJD	1	ers
δὲ	NN	1	δὲ
Entsetzen	NN	1	Entsetzen
exceptione	NE	1	exceptione
befürchtest	NN	1	befürchtest
Trinken	NN	1	Trinken
Damide	NE	1	Damide
gelehrter	ADJD	1	gelehrter
anstehen	VVFIN	1	ansteht
Würde	NN	1	Würde
unterhalten	VVFIN	1	unterhielt
Paradoxon	NN	1	Paradoxon
Poet	NN	1	Poet
δ᾽	NN	1	δ᾽
Tiberim	NE	1	Tiberim
nachteilig	ADJA	1	nachteilige
unvergänglichsten	ADJA	1	unvergänglichsten
A	NN	1	A
vermögend	ADJD	1	vermögend
Pedant	NN	1	Pedanten
aufhobst	VVFIN	1	aufhobst
hüten	VVPP	1	gehütet
Hülfe	NN	1	Hülfe
Türkenmäßig	ADJD	1	Türkenmäßig
unterstützen	VVINF	1	unterstützen
künftger	ADJA	1	künftger
Proselyt	NN	1	Proselyten
Medizin	NN	1	Medizin
Nichtswürdige	NN	1	Nichtswürdige
Meister	NN	1	Meister
Gestalt	NN	1	Gestalt
Xenokrates	NN	1	Xenokrates
fix	ADJA	1	fixe
Banquerot	NN	1	Banquerot
Westentasche	NN	1	Westentasche
herausprügeln	VVPP	1	herausgeprügelt
Dorf	NN	1	Dorfe
Pate	NN	1	Paten
Antrag	NN	1	Antrag
Gotteslohn	NN	1	Gotteslohn
antun	VVINF	1	antun
Motion	NN	1	Motion
erschrecklich	ADJD	1	erschrecklich
befreiet	VVPP	1	befreiet
ABCschnitzer	NN	1	ABCschnitzer
Dero	NN	1	Dero
Hobbes	NN	1	Hobbes
entzückt	ADJD	1	entzückt
ermuntern	VVINF	1	ermuntern
verabscheuen	VVINF	1	verabscheuen
begeistern	VVINF	1	begeistern
übeln	ADJA	1	übeln
Brocken	NN	1	Brocken
επιτηοντο	NN	1	επιτηοντο
Kopfbrechen	NN	1	Kopfbrechen
gehorsamste	ADJA	1	gehorsamste
Körnchen	NN	1	Körnchen
zweimal	ADV	1	zweimal
Untertänigkeit	NN	1	Untertänigkeit
erziehen	VVPP	1	erzogen
Ware	NN	1	Waren
Bauch	NN	1	Bauche
Staatsmann	NN	1	Staatsmann
Kapitalist	NN	1	Kapitalisten
scheinet	VVFIN	1	scheinet
sahe	VVFIN	1	sahe
Rücken	NN	1	Rücken
anzeigen	VVFIN	1	anzeige
lüstern	ADJD	1	lüstern
versöhnen	VVINF	1	versöhnen
widerrufen	VVINF	1	widerrufen
Sekt|Sekte	NN	1	Sekte
nichtswürdiger	ADJA	1	Nichtswürdiger
Schuldige	NN	1	Schuldige
lauter	PIAT	1	lauter
preis	VVINF	1	preisen
ungeheuer	ADJA	1	ungeheurer
beschäftigt	ADJA	1	beschäftigten
Freigeist	NN	1	Freigeister
spazieren	VVINF	1	spazieren
Buchladen	NN	1	Buchladen
Mlo	NE	1	Mlo
nutzen	VVFIN	1	nutzen
του	NN	1	του
bedanken	VVINF	1	bedanken
verraten	VVFIN	1	verraten
Prose	NN	1	Prose
Ehrentagen	NN	1	Ehrentagen
Eigennutz	NN	1	Eigennutz
orientalisch	ADJA	1	orientalischen
Profit	NN	1	Profit
Nachsinnen	NN	1	Nachsinnen
schwatzhaft	ADJD	1	schwatzhaft
herrschen	VVINF	1	herrschen
Gekauten	NN	1	Gekauten
Müßiggänger	NN	1	Müßiggänger
hingehen	VVINF	1	hingehen
laden	VVFIN	1	laden
herbei	PTKVZ	1	herbei
elend	ADJA	1	elender
gestehn	ADJD	1	gestehn
Stückwerk	NN	1	Stückwerk
Praxillen	NN	1	Praxillen
Vernunft	NN	1	Vernunft
empfangen	VVFIN	1	empfangen
Mitarbeiter	NN	1	Mitarbeiter
Weltweisheit	NN	1	Weltweisheit
Gemach	NN	1	Gemach
beredtesten	ADJD	1	beredtesten
menschlich	ADJA	1	menschliche
Wand	NN	1	Wände
Fuß	NN	1	Füßen
Bürschchen	NN	1	Bürschchen
ungemacht	ADJD	1	ungemacht
dreies	ADJA	1	dreies
Gegenteil	NN	1	Gegenteil
üben	VVINF	1	üben
mitten	ADV	1	mitten
Spott	NN	1	Spott
Verschlagenheit	NN	1	Verschlagenheit
bemerken	VVPP	1	bemerkt
mengen	VVINF	1	mengen
Weiche	NN	1	Weiche
höchstens	ADV	1	höchstens
gewöhnlich	ADJD	1	Gewöhnlich
Paradoxo	NE	1	Paradoxo
spitz	ADJA	1	spitzen
admissis	NE	1	admissis
Obrigkeit	NN	1	Obrigkeit
losziehen	VVINF	1	losziehen
verteidigen	VVINF	1	verteidigen
weggeben	VVIZU	1	wegzugeben
ungültig	ADJD	1	ungültig
Epith	NN	1	Epith
Pfauenfeder	NN	1	Pfauenfedern
eurige	NN	1	eurige
rund	ADJA	1	runden
Masseter	NN	1	Masseter
freuen	VVINF	1	freuen
wachsen	VVPP	1	gewachsen
Pflegetochter	NN	1	Pflegetochter
zurücklassen	VVINF	1	zurücklassen
erfinden	VVFIN	1	Erfinden
beschimpfen	VVFIN	1	beschimpfen
meabis	NN	1	meabis
inne	PTKVZ	1	inne
töricht	ADJA	1	törichten
Gift	NN	1	Gift
Schlimmers	NN	1	Schlimmers
achtzig	CARD	1	achtzig
Philosophie	NN	1	Philosophie
schadlos	ADJD	1	schadlos
Aufschrift	NN	1	Aufschrift
Stufenweise	NN	1	Stufenweise
gemeinschaftlich	ADJD	1	gemeinschaftlich
trocknen	VVFIN	1	trocknen
Geschenk	NN	1	Geschenke
Kirche	NN	1	Kirche
schmieden	VVPP	1	geschmiedet
brav	ADJA	1	brave
Brust	NN	1	Brust
Landsleute	NN	1	Landsleuten
Tollhaus	NN	1	Tollhaus
Schuldmanne	NN	1	Schuldmanne
beiwohnen	VVPP	1	beigewohnt
Faust	NE	1	Fausts
Unwille	NN	1	Unwillen
unbesonnen	ADJA	1	unbesonnene
abstehen	VVINF	1	abstehen
Regel	NN	1	Regeln
wider	APPR	1	wider
Vertraute	NN	1	Vertrauter
Besondre	NN	1	Besondre
vergeß	VVFIN	1	vergeß
Gedicht	NN	1	Gedichten
ungelegnen	ADJA	1	ungelegnen
Morgenlied	NN	1	Morgenlied
viereckigten	ADJA	1	viereckigten
verändern	VVINF	1	verändern
Karesse	NN	1	Karesse
umgeben	VVPP	1	umgeben
Hälfte	NN	1	Hälfte
köpfen	VVINF	1	köpfen
Aufsicht	NN	1	Aufsicht
zufallen	VVPP	1	zugefallen
Schutzengel	NN	1	Schutzengel
Hauskreuz	NN	1	Hauskreuz
bezeugen	VVFIN	1	bezeugt
Sterben	NN	1	Sterben
geschweige	ADV	1	geschweige
Bücherchen	NN	1	Bücherchen
Sammlung	NN	1	Sammlung
ehrbar	ADJD	1	ehrbar
verharret	VVFIN	1	verharret
verzeihen|verziehen	VVFIN	1	verziehen
zehnt	ADJA	1	zehnten
κεν	ADJA	1	κεν
Gaukelei	NN	1	Gaukeleien
krützelt	VVFIN	1	krützelt
Gesundheit	NN	1	Gesundheit
schen	NN	1	schen
Schlaf	NN	1	Schlafe
Waise	NN	1	Waise
Grobian	NN	1	Grobian
Verwandtschaft	NN	1	Verwandtschaft
ereifern	VVFIN	1	ereifern
Garten	NN	1	Garten
qualis	NE	1	qualis
beßres	NN	1	beßres
Lehre|Lehren	NN	1	Lehren
coenam	ADJA	1	coenam
Beredsamkeit	NN	1	Beredsamkeit
Mundstück	NN	1	Mundstück
Hauptwerk	NN	1	Hauptwerk
dieselb	PDAT	1	derselben
ankündigen	VVIZU	1	anzukündigen
billigen	VVINF	1	billigen
zuweilen	ADV	1	zuweilen
niemals	ADV	1	niemals
Lumpengesindel	NN	1	Lumpengesindel
Spiegel	NN	1	Spiegel
verlangt	ADJA	1	verlangten
Charakter	NN	1	Charakter
Leidenschaft	NN	1	Leidenschaft
spannen	VVFIN	1	Spannen
Haufe	NN	1	Haufen
wiedernehmen	VVINF	1	wiedernehmen
erstenmale	NN	1	erstenmale
zerreißest	VVFIN	1	zerreißest
betriegt	VVFIN	1	betriegt
schwarz	ADJD	1	schwarz
Arm	NN	1	Arm
darzu	VVIZU	1	darzu
Idiot	NN	1	Idioten
Aufschreiben	NN	1	Aufschreiben
packen	VVIMP	1	pack
niedrig	ADJD	1	niedrig
heiligen	VVFIN	1	heilige
sinnreich	ADJA	1	sinnreiche
Passus	NN	1	passus
Gläubiger	NN	1	Gläubiger
Hi	VVFIN	1	Hi
binden	VVINF	1	binden
vertraulich	ADJD	1	vertraulicher
internus	NE	1	internus
treibest	VVFIN	1	treibest
verschweigen	VVPP	1	verschwiegen
gebückt	ADJA	1	gebückte
alber	ADJA	1	alber
gründen	VVPP	1	gegründet
Schuh	NN	1	Schuhe
missbrauchen	VVFIN	1	Mißbrauchen
Essen	NN	1	Essen
Gartengesellschaft	NN	1	Gartengesellschaft
Griechische	NN	1	Griechische
Cur	NN	1	Cur
satirisch	ADJA	1	satirische
Rufte	VVIMP	1	Rufte
Beste	NN	1	Beste
lavat	VVFIN	1	lavat
Schwärmer	NN	1	Schwärmer
Billigkeit	NN	1	Billigkeit
flehentlich	ADJD	1	flehentlich
vorkommen	VVPP	1	vorgekommen
trocken	ADJD	1	trocken
Englisch	NN	1	Englisch
Asche	NN	1	Asche
negantem	ADJA	1	negantem
Bußlied	NN	1	Bußlied
Nagel	NN	1	Nagel
Lästerns	NN	1	Lästerns
mitbringen	VVINF	1	mitbringen
Theologe	NN	1	Theologen
gepaaret	VVPP	1	gepaaret
cautius	NE	1	cautius
Hagestolz	NN	1	Hagestolz
auskleiden	VVINF	1	auskleiden
hinter	APPR	1	hinter
argwöhnen	VVFIN	1	argwöhnen
verdrehen	VVINF	1	verdrehen
Muhmen	NN	1	Muhmen
widerfahren	VVINF	1	widerfahren
Volk	NN	1	Volke
lösen	VVFIN	1	lösen
Stück	NN	1	Stücken
Nachlässigkeit	NN	1	Nachlässigkeit
Ode	NN	1	Ode
bedienen	VVINF	1	bedienen
unwert	ADJD	1	unwert
marternden	ADJA	1	marternden
gelanget	VVFIN	1	gelanget
entfallen	VVFIN	1	entfiele
erholen	VVFIN	1	erholen
Verstellung	NN	1	Verstellung
Erstaunen	NN	1	Erstaunen
νψν	ADJA	1	νψν
juchhe	ADJD	1	juchhe
Kriegsrate	NN	1	Kriegsrate
ausstaffieren	VVPP	1	ausstaffiert
Geschwätz	NN	1	Geschwätz
spaßhaft	ADJD	1	spaßhaft
ekeln	VVIMP	1	ekel
waschen	VVPP	1	gewaschen
wegzufangen	VVIZU	1	wegzufangen
abgeschmackteste	ADJA	1	abgeschmackteste
Äußerste	NN	1	Äußerstes
Sanguine	NN	1	Sanguine
ὲδ᾽	ADJA	1	ὲδ᾽
Gewissensbiss	NN	1	Gewissensbisse
unvorgreiflichen	ADJA	1	unvorgreiflichen
Einfaltspinsel	NN	1	Einfaltspinsel
Gastwirt	NN	1	Gastwirt
Widerlaufen	NN	1	Widerlaufen
verliebt	ADJD	1	verliebt
einblasen	VVPP	1	eingeblasen
Pfeife	NN	1	Pfeife
applizieren	VVINF	1	applizieren
tugendhaftes	ADJA	1	tugendhaftes
gewissermaßen	ADV	1	gewissermaßen
Unbeständigkeit	NN	1	Unbeständigkeit
enterben	VVINF	1	enterben
Grausamkeit	NN	1	Grausamkeit
wenns	VVFIN	1	wenns
ernähren	VVINF	1	ernähren
Ehrlichkeit	NN	1	Ehrlichkeit
Wahn	NN	1	Wahne
Mitte	NN	1	Mitte
politisch	ADJA	1	politischen
Stoßen	NN	1	Stoßen
ausschweifend	ADJD	1	ausschweifend
Goldstück	NN	1	Goldstücken
Weste	NN	1	Weste
aufbringen	VVINF	1	aufbringen
Sachte	NN	1	Sachte
Verschwiegenheit	NN	1	Verschwiegenheit
Appetit	NN	1	Appetit
bejammern	VVINF	1	bejammern
schmauseten	VVFIN	1	schmauseten
stüße	VVFIN	1	stüße
Müdigkeit	NN	1	Müdigkeit
zuziehen	VVINF	1	zuziehen
Banise	NE	1	Banise
erwecken	VVINF	1	erwecken
majori	ADJD	1	majori
unbekümmert	ADJD	1	unbekümmert
Wisch	NN	1	Wisch
Fleiß	NN	1	Fleiß
krönen	VVPP	1	gekrönt
hocken	VVFIN	1	hocken
Rübbenstoße	NN	1	Rübbenstoße
schmeißen	VVINF	1	schmeißen
schlucken	VVINF	1	schlucken
lobenswürdig	ADJD	1	lobenswürdig
weiland	ADV	1	weiland
Haller	NN	1	Haller
Französisch	NN	1	Französisch
ixen	VVIMP	1	ix
Tölpel	NN	1	Tölpel
Erinnen	NN	1	Erinnen
Platysmamyodes	NN	1	Platysmamyodes
beurteilet	VVFIN	1	beurteilet
Dach	NN	1	Dache
Wirst	NN	1	Wirst
Briefträger	NN	1	Briefträger
Handschuh	NN	1	Handschuhs
Dreustigkeit	NN	1	Dreustigkeit
darein	ADV	1	darein
hergeben	VVFIN	1	hergebe
ohnehin	ADV	1	ohnehin
unbrauchbar	ADJA	1	unbrauchbare
Dieb	NN	1	Diebe
bezeigen	VVINF	1	bezeigen
versucht	ADJA	1	versuchte
unnütz	ADJA	1	unnützen
Ben	NE	1	Ben
olivum	ADJA	1	olivum
nachäffen	VVIZU	1	nachzuäffen
Unverschämter	NN	1	Unverschämter
duften	VVFIN	1	duftet
Lied	NN	1	Lied
Sage	NN	1	Sage
würdig	ADJD	1	würdig
Kauf	NN	1	Kauf
unwidersprechlichsten	ADJA	1	unwidersprechlichsten
Unterschied	NN	1	Unterschied
Stiefkind	NN	1	Stiefkinder
Maimon	NN	1	Maimon
schieben	VVFIN	1	schiebe
Gabel	NN	1	Gabel
kritisch	ADJA	1	kritischen
Erduldung	NN	1	Erduldung
Magister	NN	1	Magister
vitat	ADJD	1	vitat
wässrig	ADJD	1	wäßrig
Tiefsinnigkeit	NN	1	Tiefsinnigkeit
Pinsel	NN	1	Pinsel
wickeln	VVINF	1	wickeln
herumraten	VVFIN	1	herumraten
reißend	ADJD	1	reißend
Heiratens	NN	1	Heiratens
Glaube	NN	1	Glauben
redlichste	ADJA	1	redlichste
überheben	VVPP	1	überhoben
Verdacht	NN	1	Verdacht
sprech	VVFIN	1	sprech
Probe	NN	1	Probe
Stärke	NN	1	Stärke
Ιτηακέσιοι	NN	1	Ιτηακέσιοι
Nachmittags	NN	1	Nachmittags
nordisch	ADJA	1	nordischen
Gunst	NN	1	Gunst
Stelle	NN	1	Stelle
auferzogen	VVFIN	1	auferzogen
Einsamkeit	NN	1	Einsamkeit
erzürnen	VVINF	1	erzürnen
Fenster	NN	1	Fenster
principia	ADJD	1	principia
trunken	ADJA	1	trunkene
Innere	NN	1	Innere
Strich	NN	1	Strich
Jad	NE	1	Jad
mißgönnest	VVFIN	1	mißgönnest
Larve	NN	1	Larve
illam	NE	1	illam
untröstlich	ADJD	1	untröstlich
beschaffen	VVINF	1	beschaffen
unterrichten	VVPP	1	unterrichtet
erneuert	ADJA	1	erneuerte
Beiwort	NN	1	Beiwort
Kränzchen	NN	1	Kränzchen
günstig	ADJD	1	günstiger
erweisen	VVINF	1	erweisen
irre	ADJD	1	irre
Weibsvolk	NN	1	Weibsvolk
Corinnen	NN	1	Corinnen
Schnitt|Schnitte	NN	1	Schnitte
Mediziner	NN	1	Medizinern
itzt	VVFIN	1	itzt
Übersetzung	NN	1	Übersetzung
Geschmacke	NN	1	Geschmacke
aufhalten	VVPP	1	aufgehalten
auftragen	VVPP	1	aufgetragen
außer	APPR	1	außer
Auctore	NE	1	Auctore
nachsinnend	ADJD	1	Nachsinnend
Vorsatze	NN	1	Vorsatze
Opsimathia	NE	1	Opsimathia
schmecken	VVPP	1	geschmeckt
durchgängig	ADJD	1	durchgängig
Finsternis	NN	1	Finsternis
schöpfen	VVPP	1	geschöpft
Kapitel	NN	1	Kapitel
Staatskunst	NN	1	Staatskunst
Jude	NN	1	Jude
vorrechnen	VVIZU	1	vorzurechnen
gilts	NN	1	gilts
κλψον	ADJA	1	κλψον
überschreien	VVFIN	1	überschreit
desgleichen	ADV	1	Desgleichen
tiefsinnig	ADJD	1	tiefsinnig
anhängig	ADJD	1	anhängig
Ansehen	NN	1	Ansehen
erfreuen	VVFIN	1	erfreut
stotternd	ADJD	1	Stotternd
aufweisen	VVINF	1	aufweisen
μευ	NN	1	μευ
Anstalt	NN	1	Anstalt
aliter	NN	1	aliter
Schöne	NN	1	Schönes
untersucht	ADJD	1	untersucht
Nachschlagen	NN	1	Nachschlagen
Pythagoras	NN	1	Pythagoras
Stammwort	NN	1	Stammwörter
Münze	NN	1	Münze
beben	VVFIN	1	beben
Feuer	NN	1	Feuer
hui	FM	1	Hui
Anwerbung	NN	1	Anwerbung
krumm	ADJA	1	krumme
unrein	ADJA	1	unreinen
wers	NN	1	wers
Korrespondent	NN	1	Korrespondent
Studieren	NN	1	Studieren
Bekenntnis	NN	1	Bekenntnis
Weinglas	NN	1	Weinglas
Soldat	NN	1	Soldaten
sero	NE	1	sero
Wohnstube	NN	1	Wohnstube
Bürger	NN	1	Bürger
allzugelehrter	VVFIN	1	allzugelehrter
träumest	VVFIN	1	träumest
Prügel|Prügeln	NN	1	Prügeln
sat	VVPP	1	sat
Halt	NN	1	Halt
Schlinge	NN	1	Schlinge
arare	ADJA	1	arare
Busen	NN	1	Busen
zutrauen	VVINF	1	zutrauen
Angst	NN	1	Angst
demosthenischen	ADJA	1	demosthenischen
Versteck|Verstecken	NN	1	Verstecken
Mitleiden	NN	1	Mitleiden
rosten	VVINF	1	rosten
ohnedem	ADJD	1	ohnedem
Certo	NE	1	Certo
preußisch	ADJA	1	Preußische
Furcht	NN	1	Furcht
nachsehen	VVINF	1	nachsehen
Bangigkeit	NN	1	Bangigkeit
Redlichkeit	NN	1	Redlichkeit
anstecken	VVPP	1	angesteckt
Dichter	NN	1	Dichter
Wen	NE	1	Wen
verrichten	VVINF	1	verrichten
Schreibesucht	NN	1	Schreibesucht
Wind|Winde	NN	1	Winde
Niederland	NN	1	Niederlanden
Kastanie	NN	1	Kastanien
daselbst	ADV	1	daselbst
Hauptsprache	NN	1	Hauptsprache
Bewegung	NN	1	Bewegungen
Studio	NN	1	studio
dieselbe	PDS	1	derselben
ehemalig	ADJA	1	ehemaligen
annehmlich	ADJD	1	annehmlich
kläglich	ADJA	1	kläglichen
rasen	VVINF	1	rasen
Ungeziefer	NN	1	Ungeziefer
Schmausereien	NN	1	Schmausereien
zappeln	VVINF	1	zappeln
Grieche	NN	1	Griechen
ausgenommen	ADV	1	ausgenommen
malis	ADJA	1	malis
lebhaft	ADJA	1	lebhaften
schreien	VVFIN	1	schrie
Zeitvertreibe	NN	1	Zeitvertreibe
Quae	NE	1	Quae
worunter	PWAV	1	worunter
Boden	NN	1	Boden
angenommen	ADJA	1	angenommenen
merkwürdig	ADJA	1	merkwürdiges
Tapferkeit	NN	1	Tapferkeit
Anblick	NN	1	Anblicke
fortlaufen	VVINF	1	fortlaufen
anbelangen	VVPP	1	anbelangt
erstaunend	ADJD	1	erstaunend
eröffnen	VVPP	1	eröffnet
besorgt	ADJD	1	besorgt
Zwang	NN	1	Zwang
wandern	VVFIN	1	wandern
distinguieren	ADJD	1	distinguieren
Fakultät	NN	1	Fakultäten
Pickelhering	NN	1	Pickelhering
allzuscharfen	ADJA	1	allzuscharfen
Note	NN	1	Noten
Illen	NN	1	Illen
Lehrmeister	NN	1	Lehrmeister
Armut	NN	1	Armut
Ausrufung	NN	1	Ausrufung
Grobheit	NN	1	Grobheit
brauchen|gebrauchen	VVPP	1	gebraucht
sichs	NN	1	sichs
geschahe	VVFIN	1	geschahe
Advokate	NN	1	Advokate
genugsam	ADV	1	genugsam
Verbeugung	NN	1	Verbeugung
mutmaßen	VVINF	1	mutmaßen
Mutterwitz	NN	1	Mutterwitz
bestehet	VVFIN	1	bestehet
anzugaffen	VVIZU	1	anzugaffen
Ungehorsam	NN	1	Ungehorsam
Abreise	NN	1	Abreise
Hauptsache	NN	1	Hauptsache
Verweis	NN	1	Verweise
Schnitt	NN	1	Schnitt
abspenstig	ADJD	1	abspenstig
Bettel	NN	1	Bettel
behüten	VVFIN	1	Behüte
Briefträgerlohn	NN	1	Briefträgerlohn
umfangen	VVFIN	1	umfange
betrüben	VVPP	1	betrübt
Heiterkeit	NN	1	Heiterkeit
Geldsache	NN	1	Geldsachen
zierlich	ADJD	1	zierlich
Netrix	NE	1	Netrix
beredt	ADJD	1	beredt
marternd	ADJA	1	marternde
Regula	NE	1	regula
I	NN	1	Is
Verteidigung	NN	1	Verteidigung
besprechen	VVINF	1	besprechen
allzuzärtlichen	ADJA	1	allzuzärtlichen
zittern	VVINF	1	zittern
sinnen	VVINF	1	sinnen
seufzen	VVFIN	1	seufzen
öffentlich	ADJA	1	öffentliches
berichten	VVINF	1	berichten
schreiten	VVFIN	1	schreiten
Zeitungsschreiber	NE	1	Zeitungsschreiber
aussehen	VVFIN	1	aussieht
Hast	NN	1	Hast
hecken	VVINF	1	hecken
dasmal	ADV	1	dasmal
Textsprache	NN	1	Textsprache
Plagium	NN	1	Plagium
Gattung	NN	1	Gattung
Kamerad	NN	1	Kameraden
Atomi	NN	1	Atomi
herumführen	VVINF	1	herumführen
ausschmücke	VVFIN	1	ausschmücke
Mona	NE	1	Monas
Vorwand	NN	1	Vorwand
Beurteilung	NN	1	Beurteilung
begegnen	VVPP	1	begegnet
discat	ADJD	1	discat
erleuchten	VVINF	1	erleuchten
angelegner	NN	1	angelegner
Gauner	NN	1	Gauner
Nebenbuhler	NN	1	Nebenbuhler
gesinnet	VVFIN	1	gesinnet
Mark	NN	1	Mark
Schlafzimmer	NN	1	Schlafzimmer
Gebieterin	NN	1	Gebieterin
bejammernswürdig	ADJD	1	bejammernswürdig
auslegen	VVINF	1	auslegen
hieher	NN	1	hieher
Men	ADJA	1	Men
Achselbänder	NN	1	Achselbänder
bemühen	VVINF	1	bemühen
meinet	VVFIN	1	meinet
vergeben	VVINF	1	vergeben
platzen	VVINF	1	platzen
erstaunlich	ADJD	1	erstaunlich
übertreffen	VVPP	1	übertroffen
Rock	NN	1	Rock
bestrebt	ADJD	1	bestrebt
Οσ	ADJA	1	Οσ
Büchelchen	NN	1	Büchelchen
unbelohnt	ADJD	1	unbelohnt
gleichviel	ADV	1	gleichviel
Kosmopolit	NN	1	Kosmopolit
originell	ADJA	1	originellen
Betrachtung	NN	1	Betrachtung
Handelsleute	NN	1	Handelsleute
Mut	NN	1	Mut
prügeln	VVINF	1	prügeln
erwachen	VVFIN	1	erwacht
Philolog	NN	1	Philolog
Kalmuckisch	ADJD	1	Kalmuckisch
ipsam	NE	1	ipsam
ernährest	VVFIN	1	ernährest
Schuldmann	NN	1	Schuldmann
täglich	ADJD	1	täglich
Prediger	NN	1	Prediger
überzeugt	ADJD	1	überzeugt
tüchtig	ADJA	1	tüchtiges
Gottlosigkeit	NN	1	Gottlosigkeit
Zeichen	NN	1	Zeichen
eingehen	VVINF	1	eingehen
mechanisch	ADJA	1	mechanischen
widerstehen	VVINF	1	widerstehen
Vorbeigehen	NN	1	Vorbeigehen
hoffärtig	ADJD	1	hoffärtig
Lebensumstand	NN	1	Lebensumstände
respectu	NE	1	respectu
Aufwartung	NN	1	Aufwartung
ohn	VVFIN	1	ohn
vors	APPRART	1	vors
ängstlich	ADJA	1	ängstlichen
Hol	VVFIN	1	Hol
einschicken	VVPP	1	eingeschickt
hernehmen	VVPP	1	hergenommen
au	ITJ	1	au
Lerne	NN	1	Lerne
Erdball	NN	1	Erdball
gehorchen|horchen	VVPP	1	gehorcht
Digastricus	NE	1	Digastricus
Geheimter	ADJA	1	Geheimter
allerernstlichstem	ADJA	1	allerernstlichstem
hinausstoßen	VVFIN	1	hinausstoßen
fasten	VVINF	1	fasten
Entzückung	NN	1	Entzückung
Sacke	NN	1	Sacke
zitternd	ADJA	1	zitternde
Warte	NN	1	Warte
allzuzärtliche	ADJA	1	allzuzärtliche
gibts	NN	1	gibts
widersprich	VVFIN	1	widersprich
herschreibt	VVFIN	1	herschreibt
Maßregel	NN	1	Maßregeln
Merkmal	NN	1	Merkmale
Eingeweide	NN	1	Eingeweide
Weiter	NN	1	Weitere
Süßigkeit	NN	1	Süßigkeit
beteure	VVFIN	1	beteure
bekräftigen	VVFIN	1	bekräftigen
Färberpferd	NN	1	Färberpferd
Hofmeister	NN	1	Hofmeister
Heilige	NN	1	Heilige
Annehmlichkeit	NN	1	Annehmlichkeit
tödlich	ADJD	1	tödlich
kaltsinniges	ADJA	1	kaltsinniges
Geschichtskundiger	NN	1	Geschichtskundiger
mangelhaft	ADJD	1	mangelhaft
entziehen	VVFIN	1	entzöge
breit	ADJA	1	breiten
Rabenaas	NN	1	Rabenaas
Poetris	NN	1	Poetris
bläset	VVFIN	1	bläset
bove	VVFIN	1	bove
gewahr	ADJD	1	gewahr
eingeschickt	ADJA	1	eingeschickten
Homers	NN	1	Homers
eingesalznen	ADJA	1	eingesalznen
übertrieben	ADJA	1	übertriebenen
Vertrag	NN	1	Vertrag
verbessern	VVINF	1	verbessern
Adjeu	ADJD	1	Adjeu
räumen	VVINF	1	räumen
bonis	ADJA	1	bonis
Besinnen	NN	1	Besinnen
nirgends	ADV	1	nirgends
Versuchung	NN	1	Versuchungen
Verzeihung	NN	1	Verzeihung
Fisch|Fischen	NN	1	Fischen
Türe	NN	1	Tür
ungekünstelt	ADJA	1	ungekünstelten
Pommer	NN	1	Pommern
heben	VVFIN	1	Hebt
Speise|Speisen	NN	1	Speisen
Erneuerung	NN	1	Erneuerung
deinetwegen	ADV	1	deinetwegen
Wetterhahn	NN	1	Wetterhahn
Vorschein	NN	1	Vorschein
geliebt	ADJA	1	geliebte
vernichten	VVFIN	1	vernichte
ausmachen	VVINF	1	ausmachen
Wozu	NN	1	Wozu
Lache|Lachen	NN	1	Lachen
wohnen	VVPP	1	gewohnt
übertreiben	VVPP	1	übertrieben
Nadel	NN	1	Nadel
Konsumtionsakzise	NN	1	Konsumtionsakzise
Europa	NE	1	Europa
Wein	NN	1	Wein
Diebstahl	NN	1	Diebstahl
Krakelfüße	NN	1	Krakelfüße
streiten	VVFIN	1	stritten
äußer	ADJA	1	äußersten
minor	NN	1	minor
Gewissen	NN	1	Gewissen
Ader	NN	1	Ader
Beweisgründe	NN	1	Beweisgründe
taub	ADJD	1	taub
klagen	VVINF	1	klagen
Jahrhundert	NN	1	Jahrhunderts
disputieren	VVINF	1	disputieren
bersten	VVINF	1	bersten
Schulbrocken	NN	1	Schulbrocken
Ausculta	ADJA	1	Ausculta
ablegen	VVINF	1	ablegen
Legion	NN	1	Legion
verwehren	VVINF	1	verwehren
Wegens	NN	1	Wegens
zugestutzt	VVPP	1	zugestutzt
Biographie	NN	1	Biographie
Bst	NE	1	Bst
kauderwelschen	ADJA	1	kauderwelschen
Grille	NN	1	Grille
Stallknecht	NN	1	Stallknecht
rasend	ADJA	1	rasendes
hierunter	PAV	1	hierunter
priori	NN	1	priori
Rechtsgelehrte	NN	1	Rechtsgelehrte
geschiehet	VVFIN	1	geschiehet
einflickt	ADJD	1	einflickt
Tischlied	NN	1	Tischlied
unschätzbar	ADJA	1	unschätzbare
Pterygoideus	NE	1	Pterygoideus
Manuskript	NN	1	Manuskripte
gedruckt	ADJD	1	gedruckt
überleben	VVINF	1	überleben
tangere	ADJA	1	tangere
Anständigkeit	NN	1	Anständigkeit
Seltnes	ADJD	1	Seltnes
spitzen	VVPP	1	gespitzt
abscheulich	ADJD	1	abscheulich
Vorschlag	NN	1	Vorschlag
versehen	VVFIN	1	versah
eingemachter	ADJA	1	eingemachter
Dohle	NN	1	Dohle
Erhaltung	NN	1	Erhaltung
stabis	NN	1	stabis
unerkenntlich	ADJD	1	unerkenntlich
erdichtet	ADJA	1	erdichteten
wankelhaft	ADJD	1	wankelhaft
vermag	VVFIN	1	vermag
Alter	NN	1	Alter
anwenden	VVINF	1	anwenden
voran	PTKVZ	1	voran
Lehrbegierde	NN	1	Lehrbegierde
Requisita	NN	1	Requisita
verehren	VVFIN	1	verehre
Regung	NN	1	Regungen
zwölfmal	ADV	1	zwölfmal
Mucke|Mucken	NN	1	Mucken
malen	VVFIN	1	malst
ausstrecken	VVINF	1	ausstrecken
bequemen	VVFIN	1	bequemte
allzufleischlich	ADJD	1	allzufleischlich
μαν	NN	1	μαν
ηοττι	NN	1	ηοττι
externus	NE	1	externus
unverdient	ADJA	1	unverdienter
verdrüßliche	ADJA	1	verdrüßliche
Italiener	NN	1	Italiener
Abendlied	NN	1	Abendlied
treulos	ADJD	1	treulos
Leibgrille	NN	1	Leibgrille
Zeugnis	NN	1	Zeugnis
ηοι	ADJA	1	ηοι
abnehmen	VVFIN	1	abnimmt
vertitur	NN	1	vertitur
Sklave	NN	1	Sklaven
hoffentlich	ADV	1	Hoffentlich
chinesisch	ADJD	1	Chinesisch
dirs	NN	1	dirs
ausgeteilet	VVPP	1	ausgeteilet
Stümper	NN	1	Stümper
Informator	NN	1	Informator
Fähigkeit	NN	1	Fähigkeit
Montur	NN	1	Montur
Witwe	NN	1	Witwe
zukommen	VVINF	1	zukommen
auslesen	VVINF	1	auslesen
Schatz	NN	1	Schatz
unruhig	ADJA	1	unruhiger
unermüdeter	ADJA	1	unermüdeter
Theolog	NN	1	Theolog
Skorpion	NN	1	Skorpionen
Horcher	NN	1	Horcher
Ex	NN	1	Ex
Jungferchen	NN	1	Jungferchen
Heiratssachen	NN	1	Heiratssachen
wagen	VVINF	1	wagen
frech	ADJD	1	frech
Unsinn	NN	1	Unsinn
akademisch	ADJA	1	akademischen
entheiliget	ADJA	1	entheiliget
fischen	VVFIN	1	fischt
Erzählung	NN	1	Erzählungen
heuen	VVFIN	1	heut
Juchhe	NE	1	Juchhe
mittelmäßig	ADJA	1	mittelmäßigen
contra	ADV	1	contra
glänzen	VVINF	1	glänzen
herkommen	VVPP	1	hergekommen
bestellen	VVPP	1	bestellt
untergehen	VVINF	1	untergehen
Aufführung	NN	1	Aufführung
sehnen	VVIMP	1	sehn
fruchtbar	ADJD	1	fruchtbar
Schoß	NN	1	Schoß
leiblich	ADJA	1	leiblichen
Ungelehrtesten	NN	1	Ungelehrtesten
überreden	VVINF	1	überreden
Falsche	NN	1	Falsche
darzwischen	ADJA	1	darzwischen
Vergebung	NN	1	Vergebung
vertun	VVFIN	1	vertut
untersuchen	VVINF	1	untersuchen
schamrot	ADJD	1	schamrot
untermengt	VVFIN	1	untermengt
schlafen	VVFIN	1	schlafe
gedankenleer	ADJD	1	gedankenleer
Vornehmste	NN	1	Vornehmste
Nix	NN	1	Nix
vergebner	NE	1	vergebner
Erfahrung	NN	1	Erfahrung
Affe	NN	1	Affe
praktizieren	VVPP	1	praktiziert
flavum	NN	1	flavum
Kleopatra	NE	1	Kleopatra
Höllenzwang	NN	1	Höllenzwang
praktizieret	ADJD	1	praktizieret
Frauenzimmers	NN	1	Frauenzimmers
Undank	NN	1	Undank
Träne	NN	1	Träne
Κεκλψτε	ADJA	1	Κεκλψτε
Trutze	NE	1	Trutze
ausstatten	VVIZU	1	auszustatten
Handwerksgelehrte	NN	1	Handwerksgelehrte
Turnier	NN	1	Turnier
Zygomaticus	NE	1	Zygomaticus
miteinander	ADV	1	miteinander
unzählbar	ADJA	1	unzählbaren
Rüstung	NN	1	Rüstung
quovis	NE	1	quovis
Posaune	NN	1	Posaune
irgend	ADV	1	irgend
angebracht	ADJA	1	angebrachten
Ermanglung	NN	1	Ermanglung
erdulden	VVINF	1	erdulden
Fehlerchen	NN	1	Fehlerchen
vitulum	NN	1	vitulum
Narrheit	NN	1	Narrheit
größrer	ADJA	1	größrer
vergnügt	ADJD	1	vergnügt
Reich	NE	1	Reich
furchtsam	ADJD	1	furchtsamer
Grundsprache	NN	1	Grundsprache
Titel	NN	1	Titel
rechtschaffne	ADJA	1	rechtschaffne
beruhigen	VVFIN	1	Beruhige
Eheteufels	NN	1	Eheteufels
Halskrause	NN	1	Halskrausen
Belesenheit	NN	1	Belesenheit
scheuen	VVFIN	1	scheuen
zerbeißen	VVINF	1	zerbeißen
vorne	ADV	1	vorne
seh	NE	1	seh
Mündel	NN	1	Mündel
fähig	ADJD	1	fähig
unvergeblich	ADJD	1	unvergeblich
Ungestümigkeit	NN	1	Ungestümigkeit
Ausspruch	NN	1	Ausspruch
Vorteilchen	NN	1	Vorteilchen
ersparen	VVINF	1	ersparen
Buchstabenkrämer	NN	1	Buchstabenkrämer
hierdurch	PAV	1	hierdurch
gefaßt	ADJD	1	gefaßt
Ungelehrten	NN	1	Ungelehrten
Entschließung	NN	1	Entschließungen
eurigen	ADJA	1	eurigen
Staatsgeschäft	NN	1	Staatsgeschäfte
überwerfen	VVPP	1	überworfen
Härte	NN	1	Härte
weislich	ADJD	1	weislich
Glückseligkeit	NN	1	Glückseligkeit
zusammen	PTKVZ	1	zusammen
rücken	VVFIN	1	Rücken
verwandeln	VVINF	1	verwandeln
vergehen	VVINF	1	vergehen
allmählich	ADJD	1	allmählich
Zusammenkunft	NN	1	Zusammenkünfte
dus	VVFIN	1	dus
Zinshahn	NN	1	Zinshahn
bestärken	VVFIN	1	Bestärken
nehm	VVFIN	1	nehm
Geizhals	NN	1	Geizhals
Schlimmste	NN	1	Schlimmste
fur	NE	1	fur
hinsetzen	VVINF	1	hinsetzen
statten	VVINF	1	statten
Gegenwart	NN	1	Gegenwart
Nachwelt	NN	1	Nachwelt
Unterredung	NN	1	Unterredung
Mist	NN	1	Miste
näher	PTKVZ	1	näher
vielweniger	ADJD	1	vielweniger
Sterbelied	NN	1	Sterbelied
überlaufen	VVPP	1	überlaufen
Hochzeitcarmen	NN	1	Hochzeitcarmen
urteilen	VVINF	1	urteilen
ungelegen	ADJD	1	ungelegener
bedachen|bedenken	VVPP	1	bedacht
vermuten	VVINF	1	vermuten
Wette	NN	1	Wette
Ton|Tönen	NN	1	Tönen
andermal	ADV	1	andermal
vernehmen	VVINF	1	vernehmen
Entdeckung	NN	1	Entdeckung
unendlich	ADJD	1	unendlich
Koptisch	NN	1	Koptisch
akkordieren	NN	1	akkordieren
erbitten	VVPP	1	erbeten
allenfalls	ADV	1	allenfalls
hervorkommen	VVINF	1	hervorkommen
Anschlag	NN	1	Anschläge
erzürnst	VVFIN	1	erzürnst
auswachsen	VVPP	1	ausgewachsen
allzugeistlich	ADJD	1	allzugeistlich
gemäß	ADJD	1	gemäß
αρα	ADJA	1	αρα
gelingen	VVPP	1	gelungen
Kummer	NN	1	Kummer
tanzen	VVINF	1	tanzen
Prinzessin	NN	1	Prinzessin
Gesunde|Gesunden	NN	1	Gesunden
Gültigkeit	NN	1	Gültigkeit
Gebrauch	NN	1	Gebrauche
cur	NN	1	cur
Bricht	NN	1	Bricht
sanft	ADJD	1	sanft
verändert	ADJA	1	veränderten
danke	PTKANT	1	Danke
ausbessern	VVPP	1	ausgebessert
einschmeicheln	VVINF	1	einschmeicheln
Last	NN	1	Last
disputandum	NN	1	disputandum
steif	ADJD	1	steif
schonen	VVFIN	1	schone
bedeuten	VVFIN	1	bedeute
Paktum	NN	1	Paktum
männlich	ADJA	1	männlichen
Pappelbäume	NN	1	Pappelbäume
wiederbekommen	VVINF	1	wiederbekommen
entgehen	VVFIN	1	entgeht
pitha	ADJA	1	pitha
Gleichgewicht	NN	1	Gleichgewicht
Hin-	TRUNC	1	Hin-
Wunder	NN	1	Wunders
hinten	ADV	1	hinten
Bosheit	NN	1	Bosheit
seinetwegen	ADV	1	Seinetwegen
Herrschaft	NN	1	Herrschaft
Engeland	NN	1	Engeland
Herd|Herde	NN	1	Herde
entwenden	VVPP	1	entwandt
schützen	VVINF	1	schützen
allzugewissenhafte	VVFIN	1	allzugewissenhafte
Apollo	NE	1	Apollo
irgendswo	ADV	1	irgendswo
verstehest	VVFIN	1	verstehest
folgest	VVFIN	1	folgest
Endung	NN	1	Endung
hitzig	ADJD	1	hitzig
Geschwätze	NN	1	Geschwätze
Hochzeitgedichten	NN	1	Hochzeitgedichten
Treppe	NN	1	Treppe
senili	ADJD	1	senili
Gesellschafter	NN	1	Gesellschafter
quilibet	ADJD	1	quilibet
Pack	NN	1	Pack
Bart	NN	1	Bart
verführen	VVFIN	1	verführt
Journalist	NN	1	Journalisten
thlamium	NN	1	thlamium
Widerlegung	NN	1	Widerlegung
nachsetzen	VVINF	1	nachsetzen
Siegel	NN	1	Siegel
Rate	NN	1	Rate
kurieren	VVINF	1	kurieren
besondern	VVFIN	1	besondern
scheinend	ADJA	1	scheinenden
Anverwandte	NN	1	Anverwandte
Geheimnis	NN	1	Geheimnis
vierzehn	CARD	1	vierzehn
pöbelhaften	ADJA	1	pöbelhaften
betrogen	ADJA	1	betrogene
eindringen	VVINF	1	eindringen
Professores	NN	1	Professores
Wirds	NN	1	Wirds
Fügung	NN	1	Fügung
Gemütsart	NN	1	Gemütsart
erlangen	VVINF	1	erlangen
schielen	VVFIN	1	schielen
Ansehung	NN	1	Ansehung
grammatikalisch	ADJD	1	grammatikalisch
verrauchen	VVPP	1	verraucht
gesehn	ADJD	1	gesehn
Alberne	NN	1	Albernes
Nachdruck	NN	1	Nachdrucke
verständig	ADJD	1	verständig
Begierde	NN	1	Begierde
Böse	NN	1	Böses
Zeitungsblatt	NN	1	Zeitungsblatt
verstärken	VVFIN	1	verstärke
goldner	NE	1	goldner
ειπὸ	NN	1	ειπὸ
Sachwalter	NE	1	Sachwalter
Männerchen	NN	1	Männerchen
Beschwerliches	NN	1	Beschwerliches
Gottesgelahrheit	NN	1	Gottesgelahrheit
windig	ADJD	1	windig
herausrücken	VVFIN	1	herausrücke
versprochen	ADJA	1	versprochene
Wirkung	NN	1	Wirkung
Überbringung	NN	1	Überbringung
verschlagne	NN	1	verschlagne
dran	PAV	1	dran
ausschlagen	VVFIN	1	ausschlägt
wendisch	ADJD	1	wendisch
zurücknehmen	VVPP	1	zurückgenommen
Lobrede	NN	1	Lobrede
Malabarisch	NE	1	Malabarisch
Ausnahme	NN	1	Ausnahme
Vormund	NN	1	Vormund
gefangen	PTKVZ	1	gefangen
verwirren	VVFIN	1	verwirre
ehedem	ADV	1	ehedem
anständig	ADJA	1	anständige
witzig	ADJA	1	witzigen
Gelehrtchen	NN	1	Gelehrtchen
Lebensbeschreibung	NN	1	Lebensbeschreibung
erzürne	VVFIN	1	erzürne
wiederkommen	VVINF	1	wiederkommen
Odyssee	NN	1	Odyssee
Universität	NN	1	Universität
lenken	VVIMP	1	Lenk
hochschätzte	VVFIN	1	hochschätzte
zuhören	VVINF	1	zuhören
Not	NN	1	Not
Hab	NN	1	Hab
Gelehrtesten	NN	1	Gelehrtesten
Wildpret	NN	1	Wildpret
Ruhe	NN	1	Ruhe
Sorge|Sorgen	NN	1	Sorgen
nebst	APPR	1	nebst
Bullenbeißer	NN	1	Bullenbeißer
entfahren	VVPP	1	entfahren
hechtgraues	ADJA	1	hechtgraues
abgehen	VVINF	1	abgehen
επηατη᾽	NN	1	επηατη᾽
bestreben	VVINF	1	bestreben
mahlen	VVINF	1	mahlen
Konferenz	NN	1	Konferenz
beliebe	VVFIN	1	beliebe
Urtel	NN	1	Urtel
Widersprechen	NN	1	Widersprechen
Zimmermann	NE	1	Zimmermann
gütig	ADJA	1	gütigen
Sinn|Sinnen	NN	1	Sinnen
Äffchen	NN	1	Äffchen
betaure	VVFIN	1	betaure
Lebendige	NN	1	Lebendige
Vorsatz	NN	1	Vorsatz
Richtigtigkeit	NN	1	Richtigtigkeit
Dienstfertigkeit	NN	1	Dienstfertigkeit
prahlen	VVINF	1	prahlen
Knopf	NN	1	Knöpfe
abgeben	VVPP	1	abgegeben
vertragen	VVINF	1	vertragen
Wunsch	NN	1	Wunsche
Zeitungsmann	NN	1	Zeitungsmann
Kobold	NN	1	Kobold
verdoppeln	VVINF	1	verdoppeln
sine	ADJA	1	sine
übernehmen	VVINF	1	übernehmen
benötigen	VVPP	1	benötigt
33	CARD	1	33
eilfertig	ADJD	1	eilfertig
unwidersprechlicher	ADJD	1	unwidersprechlicher
keufst	VVFIN	1	keufst
bereuen	VVFIN	1	bereuen
verdienteste	ADJA	1	verdienteste
Null	NN	1	Null
zurückziehen	VVPP	1	zurückgezogen
fürchterlichern	ADJA	1	fürchterlichern
Schiffssegel	NN	1	Schiffssegel
anhalten	VVPP	1	angehalten
Sapienti	NN	1	Sapienti
Foptisch	NN	1	Foptisch
wenigste	PIS	1	wenigsten
Kredit	NN	1	Kredit
Treuloser	NN	1	Treuloser
Ungelehrsamkeit	NN	1	Ungelehrsamkeit
Statur	NN	1	Statur
links	ADJA	1	linke
auswendig	ADV	1	auswendig
Frankreich	NE	1	Frankreich
rauh	ADJD	1	rauh
meliori	NN	1	meliori
Stäubchen	NN	1	Stäubchen
Hebräisch	NN	1	Hebräisch
Vorsorge	NN	1	Vorsorge
einkommen	VVINF	1	einkommen
wächsern	ADJA	1	wächserne
aufrichtigste	ADJA	1	aufrichtigste
Statum	NN	1	Statum
verschonen	VVPP	1	verschont
stechen	VVFIN	1	sticht
grünen	VVINF	1	grünen
Leutchen	NN	1	Leutchen
ausposaunet	VVFIN	1	ausposaunet
Zahn	NN	1	Zähne
Vortrag	NN	1	Vortrag
bene	VVFIN	1	bene
zwischen	APPR	1	zwischen
Bezeigen	NN	1	Bezeigen
Geruch	NN	1	Geruch
ABCbuch	NN	1	ABCbuch
angenehmern	NN	1	angenehmern
empfehlen	VVPP	1	empfohlen
sic	NE	1	sic
ergötzen	VVFIN	1	ergötzt
aufsagen	VVIZU	1	aufzusagen
seltsam	ADJA	1	seltsamen
Müßiggang	NN	1	Müßiggang
Katzenpfote	NN	1	Katzenpfoten
Stößer	NN	1	Stößer
Bücherwürmchen	NN	1	Bücherwürmchen
Kleidung	NN	1	Kleidung
Übergang	NN	1	Übergang
Lästermaul	NN	1	Lästermaul
hiervon	PAV	1	hiervon
Folge	NN	1	Folgen
horchen	VVINF	1	horchen
Bücherwurm	NN	1	Bücherwürmer
wundern	VVFIN	1	Wundert
zehn	CARD	1	zehn
allerunerträglichsten	ADJA	1	allerunerträglichsten
öfters	ADV	1	öfters
Forderung	NN	1	Forderung
Zunge	NN	1	Zunge
Philologe	NN	1	Philologen
gleichgültig	ADJD	1	gleichgültig
zerschneiden	VVINF	1	zerschneiden
Woche	NN	1	Wochen
rennen	VVINF	1	rennen
Generalsuperintendent	NN	1	Generalsuperintendent
auszusinnen	VVIZU	1	auszusinnen
verberabilissime	NE	1	verberabilissime
Ergötzungen	NN	1	Ergötzungen
fröhlich	ADJD	1	fröhlich
Nachbar	NN	1	Nachbarn
modo	NE	1	modo
lieget	VVFIN	1	lieget
huschen	VVIMP	1	husch
ablaufen	VVPP	1	abgelaufen
Wende	NN	1	Wende
hintereinander	ADV	1	hintereinander
fluchen	VVINF	1	fluchen
umgekehrt	ADJD	1	umgekehrt
chasaka	NE	1	chasaka
Netz	NN	1	Netz
Silbe	NN	1	Silben
derjenige	PDS	1	desjenigen
vorlegen	VVFIN	1	vorlegt
tätig	ADJA	1	tätigen
bilden	VVINF	1	bilden
vorsetzen	VVPP	1	vorgesetzt
verächtlich	ADJD	1	verächtlich
timet	VVFIN	1	timet
überfallen	VVFIN	1	überfiel
Knicker	NN	1	Knicker
deshalb	PAV	1	deshalb
Auskommen	NN	1	Auskommen
Tierchen	NN	1	Tierchen
erwürgen	VVINF	1	erwürgen
Exzeption	NN	1	Exzeption
Unsinnige	NN	1	Unsinnige
potz	NE	1	potz
Schönheit	NN	1	Schönheit
Voraussetzung	NN	1	Voraussetzung
verwünscht	ADJA	1	verwünschte
Spaß	NN	1	Spaß
abgestorbner	ADJA	1	abgestorbner
schliefest	ADJD	1	schliefest
abermals	ADV	1	abermals
scholastisch	ADJA	1	scholastischen
ungelegnern	ADJA	1	ungelegnern
Erznarren	NN	1	Erznarren
Zipfel	NN	1	Zipfel
sed	NE	1	sed
drittenmal	NN	1	drittenmal
lebendig	ADJA	1	lebendiges
überraschen	VVINF	1	überraschen
fußen	VVFIN	1	Fußen
aufgeweckt	ADJA	1	aufgeweckter
betreffen	VVFIN	1	betrifft
prächtig	ADJA	1	prächtigen
reimen	VVFIN	1	reimt
Eil	NN	1	Eil
mille	ADJA	1	mille
silbern	ADJA	1	silbernes
Zickzacke	NN	1	Zickzacke
bange	ADJD	1	bange
Deleatur	NN	1	Deleatur
Neckerei	NN	1	Neckerei
Eulengeschlecht	NN	1	Eulengeschlecht
rege	ADJD	1	rege
putas	NE	1	putas
aushalten	VVIZU	1	auszuhalten
prahle	VVFIN	1	prahle
Gut	NN	1	Gut
Cha	ADJA	1	Cha
hinterwärts	ADV	1	hinterwärts
Bibel	NN	1	Bibel
Einwurf	NN	1	Einwurf
vorstellen	VVINF	1	vorstellen
untergedrucktem	ADJA	1	untergedrucktem
Rechtsgelehrsamkeit	NN	1	Rechtsgelehrsamkeit
Schimpfwort	NN	1	Schimpfwörter
Pöbel	NN	1	Pöbels
neugierig	ADJA	1	neugierigen
Bratenwender	NN	1	Bratenwender
libro	ADJA	1	libro
unwürdig	ADJA	1	unwürdiger
berechtigen	VVFIN	1	berechtigte
davor	PAV	1	davor
honetten	ADJA	1	honetten
obgleich	KOUS	1	obgleich
Lehrgedichts	NN	1	Lehrgedichts
schlau	ADJD	1	schlau
mündig	ADJD	1	mündig
potest	NN	1	potest
veränderlich	ADJA	1	veränderlichen
stimmen	VVINF	1	stimmen
reif	ADJA	1	reifer
Vollkommenheit	NN	1	Vollkommenheit
Hundert	NN	1	Hundert
bessern	VVFIN	1	bessern
geschwätzig	ADJD	1	geschwätzig
geschenkt	ADJA	1	geschenkten
Frucht	NN	1	Frucht
Moschus	NN	1	Moschus
schleichen	VVINF	1	schleichen
zerrüttet	ADJA	1	zerrüttetes
wirs	ADJD	1	wirs
verursachen	VVINF	1	verursachen
Minute	NN	1	Minute
Stör|Stören	NN	1	Stören
fortreisen	VVINF	1	fortreisen
Rolle	NN	1	Rolle
Gesundheitsregel	NN	1	Gesundheitsregeln
Galgen	NN	1	Galgen
entscheiden	VVINF	1	entscheiden
überleget	VVFIN	1	überleget
Höre	NN	1	Höre
Schraubereien	NN	1	Schraubereien
hastig	ADJD	1	hastig
einführen	VVIZU	1	einzuführen
verschlagen	VVPP	1	verschlagen
Krieg	NN	1	Kriege
ad	FM	1	ad
Schwätzerin	NN	1	Schwätzerin
streitig	ADJD	1	streitig
Taufname	NN	1	Taufname
literas	NE	1	literas
kahl	ADJD	1	kahler
quid	ADJD	1	quid
vielmal	ADV	1	vielmal
besänftiget	VVFIN	1	besänftiget
hassen	VVFIN	1	haßt
ehelose	ADJA	1	ehelose
Magen	NN	1	Magen
Wendisch	NN	1	Wendisch
Politik	NN	1	Politik
selten	ADJD	1	selten
abhängen	VVINF	1	abhängen
Teufelsgrillen	NN	1	Teufelsgrillen
erschüttert	ADJA	1	erschütterten
Manus	ADJA	1	Manus
Poetria	NE	1	Poetria
Gesteh	NE	1	Gesteh
Geschicklichkeiten	NN	1	Geschicklichkeiten
zweifelhaft	ADJD	1	zweifelhaft
Unkosten	NN	1	Unkosten
Verzeichnis	NN	1	Verzeichnis
nachstehen	VVINF	1	nachstehen
betreten	VVFIN	1	betrete
Muskel	NN	1	Muskel
Disziplin	NN	1	Disziplin
Ehrfurcht	NN	1	Ehrfurcht
irrend	ADJA	1	irrenden
Zittern	NN	1	Zittern
allzuviel	PIS	1	allzuviel
verstellen	VVINF	1	verstellen
Plage	NN	1	Plage
Prophet	NN	1	Propheten
Kaufmanne	NN	1	Kaufmanne
Reiz	NN	1	Reiz
geschiedne	ADJA	1	geschiedne
anmelden	VVINF	1	anmelden
Gehalt	NN	1	Gehalt
Reim	NN	1	Reime
überstudierter	ADJA	1	überstudierter
schelten	VVFIN	1	schelten
Einbildung	NN	1	Einbildung
Lobenswürdiges	NN	1	Lobenswürdiges
schriftlich	ADJD	1	schriftlich
Schock	NN	1	Schock
schimpfend	ADJA	1	schimpfenden
Moral	NN	1	Moral
wehen	VVFIN	1	wehe
Drittel	NN	1	Drittel
außerordentlichste	ADJA	1	außerordentlichste
nichtsweniger	ADJD	1	nichtsweniger
geistern	VVIMP	1	Geister
geschafft	ADJD	1	geschafft
neunt	ADJA	1	neunten
Erschrick	NN	1	Erschrick
Donnerschlag	NN	1	Donnerschlag
unumstößlich	ADJA	1	unumstößlichen
vermählen	VVPP	1	vermählt
Erbstück	NN	1	Erbstück
Kraft	NN	1	Kräfte
trifur	NE	1	trifur
Glückes	NN	1	Glückes
Mittag	NN	1	Mittage
Unerhörte	NN	1	Unerhörtes
Zärtlichkeit	NN	1	Zärtlichkeit
Gabe	NN	1	Gaben
bequem	ADJD	1	bequem
womit	PWAV	1	womit
dennoch	ADV	1	dennoch
Kunstwörter	NN	1	Kunstwörter
Beschriebene	NN	1	Beschriebene
Mulier	NE	1	Mulier
Stockfisch	NN	1	Stockfisch
haschen	VVINF	1	haschen
Nennen	NN	1	Nennen
Überedle	ADJA	1	Überedle
erschrecklichen	ADJA	1	erschrecklichen
Beleidigung	NN	1	Beleidigungen
ausstoßen	VVFIN	1	ausstößt
Wirtin	NN	1	Wirtin
Scharfrichter	NN	1	Scharfrichtern
Berlinische	ADJA	1	Berlinische
nachgeben	VVINF	1	nachgeben
wetten	VVFIN	1	wette
verderblich	ADJA	1	verderbliche
Beschimpfung	NN	1	Beschimpfungen
Ratschlag	NN	1	Ratschläge
oben	ADV	1	oben
Komplimentierbuch	NN	1	Komplimentierbuch
Erdboden	NN	1	Erdboden
Sonntag	NN	1	Sonntags
anmerken	VVPP	1	angemerkt
betauern	VVFIN	1	betauern
allerangenehmste	ADJA	1	allerangenehmste
diejenige	PDS	1	Desjenigen
schicklichste	ADJA	1	schicklichste
Arzt	NN	1	Arzt
allzugroße	ADJA	1	allzugroße
hexen	VVINF	1	hexen
erkennet	VVFIN	1	erkennet
drein	PTKVZ	1	drein
Segen	NN	1	Segen
Gläschen	NN	1	Gläschen
verwandt	ADJA	1	verwandten
Postträger	NN	1	Postträger
quanta	NE	1	quanta
Kanzel	NN	1	Kanzel
Urlaub	NN	1	Urlaub
ehemals	ADV	1	ehemals
drohen	VVFIN	1	drohen
schelmisch	ADJA	1	schelmisches
Gold	NN	1	Golde
Wetter	NN	1	Wetter
Plautus	NN	1	Plautus
Valeren	NE	1	Valeren
beisammen	PTKVZ	1	beisammen
Verlöbnis	NN	1	Verlöbnis
Lästern	NN	1	Lästern
Ungesagte	NN	1	Ungesagtes
Disputierens	NN	1	Disputierens
zuschreiben	VVINF	1	zuschreiben
Milton	NE	1	Milton
Tumult	NN	1	Tumult
ausgekünstelte	ADJA	1	ausgekünstelte
erschreckst	VVFIN	1	erschreckst
zwanzigtausend	CARD	1	zwanzigtausend
Schwätzer	NN	1	Schwätzer
μαλα	ADJA	1	μαλα
Omne	ADJA	1	Omne
Sitz	NN	1	Sitze
Buchbinder	NN	1	Buchbinder
umgießen	VVPP	1	umgegossen
lobst	VVFIN	1	lobst
