Title: Der Freigeist
Number of all lemmas: 7056
Nummber of different lemmas: 2266

Lemma	POS	Frequency	Tokens
Adrast	VVFIN, ADJD, VVPP, NN, TRUNC, ADJA, VVIMP, NE	118	Adrast
sagen	VVFIN, VVPP, VVINF, VVIMP	104	sagt, gesagt, sagen, Sagen, sage, sagst, sagte, Sage, Sagte, Sag
wohl	ADV	88	wohl, Wohl
Theophan	NE, NN	86	Theophan
wissen	VVFIN, VVINF, VVPP	85	Wissen, weiß, wissen, wißt, Weiß, wüßte, gewußt
sehen	VVPP, VVFIN, VVINF, VVIMP	69	gesehen, sehe, Sehen, sehen, sieht, sah, Sieh, Sähe, sieh, siehst, Siehst, sähe, Seht, seht
Herr	NN	68	Herren, Herr, Herrn
gut	ADJD, ADJA	64	Gut, besser, beste, gut, gute, gutes, bessere, guten, guter, gutem, besten
glauben	VVFIN, VVPP, VVINF	57	glauben, geglaubt, Glauben, glaube, glaubt, glaubte, Glaube, glaubten, glaubst, Glaubt
lieben	VVINF, VVFIN	56	lieben, liebe, liebt, liebet, liebte, liebten
gewiss	ADJD, ADJA	47	Gewiß, gewisse, gewisses, gewiß, gewissen
Juliane	NE	43	Juliane
hören	VVFIN, VVINF, VVIMP	42	Hören, hören, Höre, hört, höre, Hör, hörst, hörte
eben	ADV	41	Eben, eben
lieb	ADJD, ADJA	36	lieber, liebe, lieben, liebste, lieb, liebster, Lieber, Liebster
Mann	NN	34	Mann, Manne, Männern, Mannes
Art	NN	33	Art
Wort	NN	31	Worte, Wort, Wortes, Worten
Schwester	NN	31	Schwestern, Schwester
finden	VVINF, VVFIN, VVPP	30	finden, findet, finde, Findest, gefunden, Finde, fand
schön	ADJD, ADJA	29	schön, schöner, schöne, schönste, schönsten, schönen, schönes, Schön
nehmen	VVINF, VVFIN, VVPP	27	nehmen, nehme, genommen, Nehmen, nimmt, nehmt
allein	ADV, PTKVZ	27	allein, Allein
Herz	NN	26	Herz, Herzen, Herzens
Vetter	NN, NE	26	Vetter, Vettern
ach	ITJ	26	Ach, ach
Henriette	NE	25	Henriette
Lisette	NE	25	Lisette
reden	VVINF, VVFIN	25	reden, redet, rede, Reden
gar	ADV	25	gar
Mensch	NN	25	Mensch, Menschen
kennen	VVFIN, VVPP, VVINF	24	kennen, kennten, gekannt, Kennen, kennet, kennt, Kennst, kenne
Freundschaft	NN	24	Freundschaft
Araspe	NN, ADJD	23	Araspe
Person	NN	23	Person, Personen
klein	ADJA, ADJD	23	kleiner, kleinen, kleine, kleines, klein, kleinste
erst	ADV, ADJA	23	Erst, erste, ersten, erst, erstes
Julianen	NN	23	Julianen
vielleicht	ADV	22	vielleicht, Vielleicht
denken	VVINF, VVFIN	22	denken, denke, dachte, Denken, denkst, denkt, dächte
wahr	ADJD, ADJA	21	wahr, wahre, wahren, wahres
bald	ADV	21	Bald, bald
Auge	NN	20	Augen, Auge
Gesicht	NN	19	Gesichte, Gesicht, Gesichts, Gesichter
Wahrheit	NN	19	Wahrheiten, Wahrheit
recht	ADJD, PTKVZ	18	Recht, recht
Grund	NN	18	Grund, Grunde, Gründe, Gründen
groß	ADJD, ADJA	18	groß, großen, großer, großes, große, größte
wenige	PIAT, PIS	18	wenig, weniger
Glück	NN	18	Glück
zwei	CARD	18	Zwei, zwei, zweien
Welt	NN	18	Welt
diese	PDS	17	diese, dieses, Diesen, Diese, dieser, Dieses, diesen
Hand	NN	17	Hand, Hände, Händen
Leute	NN	17	Leute, Leuten
unser	PPOSAT	17	unsere, unser, unserm, unsrer, unserer
Recht	NN	17	Recht
stehen	VVFIN, VVINF	17	stehen, steht, stehe, Stehen, stehet, stand
ha	NE	17	ha
Seite	NN	16	Seite, Seiten
Geist	NN	16	Geiste, Geist, Geister, Geistes
Liebe	NN	16	Liebe
Wechsel	NN	15	Wechsel
Ding	NN	15	Dinge, Dingen, Dinger, Ding
Mühe	NN	15	Mühe
Henrietten	NN	15	Henrietten
kömmt	VVFIN, VVINF, ADJD	15	kömmt
suchen	VVFIN, VVINF, VVPP	15	suche, suchte, suchst, sucht, suchen, gesucht
Mamsell	NE, ADJA, NN	15	Mamsell
weiter	PTKVZ, ADV	14	weiter, Weiter
genug	ADV	14	genug
nunmehr	ADV	14	nunmehr, Nunmehr
einander	PRF	14	einander
Lisidor	NE, NN	14	Lisidor
Teufel	NN	14	Teufel
erlauben	VVFIN, VVINF, VVPP	14	erlauben, Erlauben, erlaubt
Ha	NE	13	Ha
verstehen	VVFIN, VVPP, VVINF, VVIMP	13	verstehe, verstanden, versteht, verstehen, versteh
ehrlich	ADJA	13	ehrlicher, ehrliche, ehrlichen, ehrlichsten
lange	ADV	13	lange
kurz	ADJD	13	kurz, kürzer, Kurz
böse	ADJD, ADJA	13	böse, bösen
antworten	VVINF, VVFIN	13	antworten, antworte
Sache	NN	13	Sachen, Sache
hassen	VVINF, VVFIN	13	hassen, hasse
nennen	VVFIN, VVPP, VVINF	13	Nennen, nennen, nenne, genannt, nannten, nennst, nennte, nennt
Umstand	NN	13	Umständen, Umstände
sonst	ADV	13	sonst
Seele	NN	13	Seelen, Seele
setzen	VVPP, VVFIN, VVINF	13	gesetzt, setzt, Setzen, setzen, setze
Rache	NN	12	Rache
Zeit	NN	12	Zeit
Religion	NN	12	Religion
unmöglich	ADJD	12	unmöglich
Martin	NE	12	Martin
Mund	NN	12	Mund, Munde
jen	PDAT, PDS	12	jene, jener, jenes, jenem, jenen, Jenes, Jener
Leben	NN	12	Leben, Lebens
Freund	NN	12	Freund, Freunde, Freunden
Haus	NN	12	Hause, Haus
vortrefflich	ADJD, ADJA	12	vortrefflich, vortrefflichsten, vortreffliche, Vortrefflich
bezahlen	VVPP, VVINF, VVFIN	11	bezahlt, bezahlen, bezahle
Augenblick	NN	11	Augenblick, Augenblicke, Augenblicken
bitten	VVFIN, VVINF, VVPP	11	bitte, bitten, gebeten
stellen	VVFIN, VVPP, VVINF	11	stellen, gestellt, Stellen, stellte, stellten
ansehen	VVFIN, VVPP, VVINF, VVIZU	11	ansiehst, angesehen, ansieht, ansehen, anzusehen
einzig	ADJA, ADJD	11	einzige, einziger, einzigen, einzig, einziges
bekommen	VVINF, VVFIN, VVPP	11	bekommen, bekomme
Gott	NN	11	Gott
verlassen	VVINF, VVFIN, VVPP	11	verlassen, verließen, verließe, verlasse
Feind	NN	11	Feinde, Feindes, Feind
Verstand	NN	11	Verstandes, Verstande, Verstand
oft	ADV	11	oft
Mädchen	NN	10	Mädchen, Mädchens
hoffen	VVINF, VVFIN	10	hoffen, Hoffe, hoffe
Buch	NN	10	Buch, Bücher, Büchern
spielen	VVFIN, VVPP, VVINF	10	spielt, spielst, spielen, gespielt
unsre	PPOSAT	10	Unsre, unsre, unsern
Atheist	NN	10	Atheist, Atheisten
fragen	VVINF, VVFIN, VVPP	10	fragen, gefragt, fragst, frage, Fragst
erfahren	VVFIN, VVPP, VVINF	10	erfuhr, erfahren
endlich	ADV	10	endlich
lachen	VVFIN, VVIMP, VVINF	10	lacht, lache, Lacht, lach, lachen
lang	ADJD	10	länger, lang, Länger
zurück	PTKVZ	10	zurück
Pst	NN	10	Pst
wünschen	VVFIN, VVINF	10	wünschen, wünsche, Wünschen, wünscht
vergessen	VVFIN, VVINF, VVPP	9	vergessen, vergißt
wahrhaftig	ADJD	9	Wahrhaftig, wahrhaftig
Vergnügen	NN	9	Vergnügen
wider	APPR	9	wider, Wider
Tag	NN	9	Tag, Tages
Absicht	NN	9	Absicht
lernen	VVFIN, VVPP, VVINF	9	Lernen, gelernt, lernen
merken	VVFIN, VVPP, VVINF	9	merke, gemerkt, merken
bloß	ADJD, ADJA	9	bloß, bloße
nötig	ADJD, ADJA	9	nötig, nötige, nötigen, nötigsten
Nu	NN	9	Nu
stark	ADJA, ADJD	9	starker, stärker, starken, stark
treffen	VVFIN, VVINF	9	treffe, treffen, trifft
fallen	VVFIN, VVINF	9	fallen, Fallen
verlangen	VVFIN, VVINF, VVPP	9	verlange, verlangen, verlangt
Blick	NN	9	Blick, Blicke
jemals	ADV	8	jemals
annehmen	VVFIN, VVPP, VVINF, VVIZU	8	annimmt, angenommen, annehmen, anzunehmen, annähme
Tochter	NN	8	Töchtern, Töchter, Tochter
anfangen	VVFIN, VVPP, VVIZU, VVINF	8	anfange, angefangen, anzufangen, anfangen
schämen	VVFIN, VVINF	8	schämt, schämen, schäme
Zweifel	NN	8	Zweifel
deswegen	PAV	8	deswegen
heißen	VVFIN	8	heißen, heißt, heiße, hieß
glücklich	ADJD, ADJA	8	glücklich, glücklichen, glückliche, glücklichste
ei	NE	8	Ei
blind	ADJA, ADJD	8	blinden, blind, blinder, blinde
Exempel	NN	8	Exempel, Exempeln
alsdann	ADJD, VVFIN, ADJA	8	alsdann
verlieren	VVPP, VVINF	8	verloren, Verloren, verlieren
unschuldig	ADJA, ADJD	8	unschuldige, unschuldigen, unschuldiges, unschuldig
Streich	NN	8	Streich, Streiche
Vater	NN	8	Vaters, Vater, Väter
Frauenzimmer	NN	8	Frauenzimmer
Himmel	NN	8	Himmel, Himmels
wenigstens	ADV	8	wenigstens, Wenigstens
Pflicht	NN	8	Pflichten, Pflicht
gern	ADV	8	gern
erstaunen	VVFIN	8	erstaune, erstaunt, erstaunen
einbilden	VVPP, VVINF, VVFIN	8	eingebildet, einbilden, einbilde
vorhin	ADV	8	vorhin
Schmeichelei	NN	8	Schmeichelei
überlegen	VVFIN, VVINF	8	Überlegen, Überlege, überlegen, überlegt
geschehen	VVFIN, VVINF, VVPP	7	geschieht, geschehen
frei	ADJD	7	frei
Rede|Reden	NN	7	Reden
Fuß	NN	7	Fuß, Füße, Fuße
Tugend	NN	7	Tugend, Tugenden
verdienen	VVPP, VVFIN	7	verdient, verdienten, verdienst
schweigen	VVIMP, VVINF	7	Schweig, schweigen, schweig
Begriff	NN	7	Begriffe, Begriffen, Begriff
gering	ADJA, ADJD	7	geringstes, gering, geringste, geringsten
Meinung	NN	7	Meinungen, Meinung
alt	ADJA, ADJD	7	alter, alte, altes, alten, ältesten, alt
Theophans	NE	7	Theophans
dadurch	PAV	7	dadurch
zwingen	VVFIN, VVPP, VVINF	7	Zwingen, gezwungen, zwingen
heute	ADV	7	heute
gehören|hören	VVPP	7	gehört
fast	ADV	7	fast, Fast
erklären	VVFIN, VVINF	7	Erkläre, erklären, Erklären
Mannsperson	NN	7	Mannsperson, Mannspersonen
eifersüchtig	ADJD	7	eifersüchtig
umsonst	ADV	7	Umsonst, umsonst
verbinden	VVPP, VVFIN, VVINF	7	verbunden, verbinden
Rede	NN	7	Rede
Esel	NN	7	Esel
etwa	ADV	7	etwa
leben	VVINF, VVFIN	7	leben, lebt, Leben
gleichwohl	ADV	7	gleichwohl
weg	ADV, PTKVZ	7	weg
freilich	ADV	7	freilich, Freilich
erkennen	VVINF, VVFIN	7	erkennen, erkenne, erkannte
seit	APPR, KOUS	7	seit, Seit
voraus	ADV, PTKVZ	6	voraus
laß	ADJD	6	laß
Araspen	NN	6	Araspen
niemand	PIS	6	niemand, niemanden
Wille	NN	6	Willen
brauchen	VVINF, VVFIN	6	brauchen, Brauchen, braucht
weniger	ADV	6	weniger
Gedanke	NN	6	Gedanken
Gesinnung	NN	6	Gesinnungen, Gesinnung
Vernunft	NN	6	Vernunft
schwach	ADJA, ADJD	6	schwachen, schwach
Schande	NN	6	Schande, Schanden
nie	ADV	6	nie
niemals	ADV	6	niemals
nu	ITJ	6	Nu, nu
Tat	NN	6	Taten, Tat
Summe	NN	6	Summe
Verdacht	NN	6	Verdacht, Verdachte, Verdachts
Stand	NN	6	Standes, Stande, Stand
Name	NN	6	Namen, Name
Geduld	NN	6	Geduld
Weg	NN	6	Weg, Wege
verzeihen	VVFIN, VVPP, VVINF	6	Verzeihen, verziehen, Verzieh, verzeihen
breit	ADJD	6	breit
übel	ADJD	6	übel
Daumen	NN	6	Daumen
drohen	VVFIN	6	drohe, drohen, Drohen
Unglück	NN	6	Unglück
Hölle	NN	6	Hölle
vollkommen	ADJD, ADJA	6	vollkommen, vollkommene
Mittel	NN	6	Mittel
Ursache	NN	6	Ursachen, Ursache
Freude	NN	6	Freude, Freuden
Fehler	NN	6	Fehler, Fehlern
richten	VVINF	6	richten
künftig	ADJA, ADJD	6	künftiger, künftigen, künftiges, künftig
Gelegenheit	NN	6	Gelegenheit
beschließen	VVPP, VVINF	6	beschlossen, beschließen
Anmerkung	NN	6	Anmerkung, Anmerkungen
anhören	VVINF, VVIZU	6	anhören, anzuhören
gestehen	VVINF, VVFIN	6	gestehen
danken	VVINF, VVFIN	6	danken, danke
heraus	PTKVZ, ADV	6	heraus
Vertrauen	NN	6	Vertrauen
Anbeter	NN	6	Anbeter
Adrasten	NN	5	Adrasten
sicher	ADJD, ADJA	5	sicherer, sichersten, sicher
versprechen	VVPP, VVFIN	5	versprochen, versprechen, versprach
einen	ADJA	5	einen
dasjenige	PDS	5	dasjenige
Gewalt	NN	5	Gewalt
Verbindung	NN	5	Verbindung
vielmehr	ADV	5	vielmehr
fangen	VVFIN, VVINF	5	Fingst, fängt, fange, fangen
Verachtung	NN	5	Verachtung
wenig	ADV	5	wenig
vernünftig	ADJA, ADJD	5	vernünftiges, vernünftige, vernünftig
jetzo	ADJD	5	jetzo
Geschlecht	NN	5	Geschlecht, Geschlechts, Geschlechte, Geschlechtern
gönnen	VVFIN, VVINF	5	gönne, gönnen
kosten	VVINF, VVFIN	5	kosten, kostet
weiblich	ADJA	5	weiblichen, weibliche
leiden	VVINF, VVFIN	5	leiden, leidet
fort	PTKVZ, ADV	5	fort, Fort
führen	VVINF, VVFIN, VVPP	5	führen, Führen, geführt
selber	ADV	5	selber
Probe	NN	5	Probe
Nacht	NN	5	Nacht
Ansehen	NN	5	Ansehens, Ansehen
schlecht	ADJA, ADJD	5	schlechte, schlecht, Schlechtere
freuen	VVINF, VVFIN	5	freuen, Freuen
verachten	VVFIN, VVINF, VVPP	5	verachte, verachten, verachtet
fallen|fällen	VVFIN	5	fällt, Fällt
darin	PAV	5	darin, Darin
ungerecht	ADJA, ADJD	5	ungerechtes, ungerecht, ungerechte
artig	ADJA	5	artige, artiges, artigste, artigen
fein	ADJA, ADJD	5	feine, fein, Fein
empfinden	VVPP, VVFIN, VVINF	5	empfunden, empfindet, empfinden
Schönheit	NN	5	Schönheit, Schönheiten
Aberglaube	NN	5	Aberglaubens, Aberglauben
Ehre	NN	5	Ehre
Verdruss	NN	5	Verdruß
Stille	NN	5	Stille
elend	ADJA, ADJD	5	elenden, elend, Elende, elendes
Kleinigkeit	NN	5	Kleinigkeit
Wein	NN	5	Wein, Weine
rächen	VVINF, VVFIN	5	rächen, räche
darum	PAV	5	darum
edel	ADJD, ADJA	5	edel, edlere, edles
weißen	VVFIN	5	weißt
ablegen	VVINF, VVIZU, VVPP	5	ablegen, abzulegen, abgelegt
zufrieden	ADJD	5	zufrieden
fromm	ADJA, ADJD	5	fromme, frommen, fromm
ruhig	ADJA, ADJD	5	ruhige, ruhig, Ruhig
überall	ADV	5	überall
Irrtum	NN	5	Irrtümern, Irrtümer, Irrtum
fühlen	VVFIN, VVINF	5	fühlte, fühle, fühlt, fühlen
hinter	APPR	5	hinter
helfen	VVFIN, VVINF	5	Hülfe, helfen, Helfen, hilft
Begierde	NN	5	Begierde
Kredit	NN	5	Kredit
schmeicheln	VVINF, VVFIN	5	schmeicheln, schmeichle
liebenswürdig	ADJA, ADJD	5	liebenswürdige, liebenswürdigste, liebenswürdigere, liebenswürdig
morgen	ADV	5	morgen, Morgen
verächtlich	ADJA, ADJD	5	verächtlicher, verächtlich
einerlei	PIAT, ADV	5	einerlei
vorstellen	VVIZU, VVFIN, VVINF	5	vorzustellen, vorstellten, vorstellen
Pöbel	NN	5	Pöbel
zeigen	VVINF, VVFIN	5	zeigen, zeigt
spotten	VVINF, VVFIN	5	spotten, spottet
allezeit	ADV	5	allezeit
scherzen	VVFIN, VVINF	5	scherzen, scherze, scherzt
Überlegung	NN	5	Überlegung, Überlegungen
wild	ADJA	5	wilde, wilder, wilden, wildes
Zierde	NN	5	Zierde
Hochachtung	NN	5	Hochachtung
Wohltat	NN	5	Wohltat, Wohltaten
Spötterei	NN	5	Spöttereien, Spötterei
unterbrechen	VVFIN, VVINF	5	unterbreche, unterbrechen
Lust	NN	5	Lüsten, Lust
niederträchtig	ADJA, ADJD	4	niederträchtigen, niederträchtige, niederträchtig
Charakter	NN	4	Charakter
Richter	NN, NE	4	Richter
Bürgschaft	NN	4	Bürgschaft, Bürgschaften
Lärm	NN	4	Lärm
Miene	NN	4	Miene
A	NN, FM	4	A
richtig	ADJA, ADJD	4	richtige, richtig
Hülfe	NN	4	Hülfe
überladen	VVPP, ADJA, VVINF	4	überladen, überladene
unterscheiden	VVINF, VVPP, VVFIN	4	unterscheiden, unterschieden, unterscheide
Freigeist	NN	4	Freigeist, Freigeister, Freigeistes
verraten	VVFIN, VVPP	4	verrät, verraten
entschuldigen	VVINF, VVFIN	4	entschuldigen, entschuldige
angenehm	ADJA, ADJD	4	angenehme, angenehmste, angenehm
Einfall	NN	4	Einfall, Einfälle
Fromme	NN	4	Fromme
Erlaubnis	NN	4	Erlaubnis
legen	VVPP, VVINF, VVFIN	4	gelegt, legen, lege
unglücklich	ADJD, ADJA	4	unglücklich, unglückliche, unglückliches
dieselb	PDAT	4	derselben, demselben
Eigenschaft	NN	4	Eigenschaften
gewinnen	VVFIN, VVINF	4	gewinnt, gewinnen
Punkt	NN	4	Punkt, Punkte
Ho	NE	4	Ho
stecken	VVINF, VVFIN	4	stecken, Stecken
Geständnis	NN	4	Geständnis, Geständnisse
Stück	NN	4	Stücken, Stücke
Schwachheit	NN	4	Schwachheiten, Schwachheit
scharf	ADJD, ADJA	4	schärfer, scharf, scharfe
Schuldner	NN	4	Schuldner
zeihen|ziehen	VVFIN	4	Zieht, ziehen, zieht
behaupten	VVFIN, VVINF	4	behauptet, behaupten
fehlen	VVFIN	4	fehlt, fehlte
Vermögen	NN	4	Vermögens, Vermögen
verlieben	VVPP	4	verliebt
schlimm	ADJD, ADJA	4	schlimmer, schlimm, schlimmsten, schlimme
Larve	NN	4	Larve
halb	ADJA, ADJD	4	halben, halb
erweisen	VVPP, VVINF, VVFIN	4	erwiesen, erweisen
ihrige	PPOSAT	4	Ihrige, ihrigen
behalten	VVFIN, VVINF	4	behalte, behalten
Ermahnung	NN	4	Ermahnung
fassen	VVINF, VVFIN	4	fassen, Fassen
betrachten	VVPP, VVFIN, VVINF	4	betrachtet, betrachten
Güte	NN	4	Güte
Lustige	NN	4	Lustige
Spitzbube	NN	4	Spitzbube
zittern	VVFIN, VVINF, VVPP	4	zittert, zittere, zittern, gezittert
begegnen	VVPP, VVINF	4	begegnet, begegnen
Stelle|Stellen	NN	4	Stellen
hieher	NN	4	hieher
entgegen	PTKVZ, APPR	4	entgegen
erinnern	VVFIN	4	erinnern, erinnere
zanken	VVINF, VVPP	4	zanken, gezankt
gesetzt	ADJA, ADJD	4	gesetzte, gesetztes, Gesetzt
notwendig	ADJD, ADJA	4	Notwendig, notwendigen, notwendig
wohin	PWAV	4	wohin, Wohin
ersparen	VVFIN, VVINF	4	ersparen, erspare
Körper	NN	4	Körper, Körpers
grausam	ADJA, ADJD	4	grausames, grausame, grausam
eilen	VVFIN, VVINF	4	eile, eilen
aufs	APPRART	4	aufs, Aufs
verliebt	ADJD	4	verliebt
nimmermehr	ADV	4	nimmermehr
Vollkommenheiten	NN	4	Vollkommenheiten
Streitigkeit	NN	4	Streitigkeit
dumm	ADJD, ADJA	4	dumm, dummer, dummen
fähig	ADJD	4	fähig
klug	ADJD	4	klug
Kind	NN	4	Kind, Kinder
weder	KON	4	weder
Natur	NN	4	Natur
beweisen	VVINF, VVPP	4	beweisen, bewiesen
Aufrichtigkeit	NN	4	Aufrichtigkeit
gelingen	VVINF	4	gelingen
vermuten	VVINF, VVFIN	4	vermuten, Vermuten, vermute
schwatzen	VVINF, VVPP, VVFIN	4	schwatzen, geschwatzt, schwatzt
erteilen	VVINF, VVPP, VVFIN	4	erteilen, erteilt, erteile
Versicherung	NN	4	Versicherungen, Versicherung
Lobrede	NN	4	Lobrede
Johann	NE	4	Johann
Hochzeit	NN	4	Hochzeit
zwischen	APPR	4	zwischen
klar	ADJA, ADJD	4	klarer, klar
Erklärung	NN	4	Erklärung
ausdrücken	VVIZU, VVPP	4	auszudrücken, ausgedrückt
Beleidigung	NN	4	Beleidigungen
fröhlich	ADJA	4	fröhlichen, fröhliche
Kompliment	NN	4	Kompliment
Anfang	NN	4	Anfänge, Anfangs, Anfang
heilig	ADJA, ADJD	4	heilige, heilig, heiligen
ists	VVFIN	4	ists
gefallen	VVFIN, VVINF	4	gefällt, gefallen, gefalle
Schwierigkeit	NN	4	Schwierigkeit
besinnen	VVFIN, VVPP, VVINF	4	besinnen, besinnst, besonnen
Vorwurf	NN	4	Vorwürfe
längst	ADV	4	längst
entdecken	VVPP, VVINF	4	entdeckt, entdecken
Einbildung	NN	4	Einbildungen
Geld	NN	4	Geld, Gelde, Geldes
diejenige	PDS	4	Derjenige, diejenige, derjenige, derjenigen
ankömmt	VVFIN	4	ankömmt
ho	VVFIN	4	ho
Sprache	NN	3	Sprache
pflegen	VVFIN, VVINF	3	pflegt, pflegen
Misstrauen	NN	3	Mißtrauen
überzeugen	VVPP, VVINF	3	überzeugt, überzeugen
Gleiche	NN	3	Gleiches, Gleichem, Gleichen
Gegenstand	NN	3	Gegenstand, Gegenstande
nachteilig	ADJA	3	nachteiligen, nachteiliger, nachteilige
Winkel	NN	3	Winkel
Blut	NN	3	Blut, Bluts, Blute
Weise	NN	3	Weise
Bäcker	NN	3	Bäcker
falsch	ADJA	3	falsche, falschen
dieselbe	PDS	3	demselben, dieselben, derselben
Widerspruch	NN	3	Widersprüche, Widerspruch
armselig	ADJA	3	armseligen, armselige
raten	VVFIN, VVINF	3	rate, raten
deutsch	ADJD	3	deutsch
herkommen	VVPP, VVINF	3	hergekommen, herkommen
verbieten	VVFIN, VVINF, VVPP	3	verbiete, verbieten, verboten
Gang	NN	3	Gang
durchaus	ADV	3	durchaus
leugnen	VVPP, VVINF, VVFIN	3	geleugnet, leugnen, leugnet
Empfindung	NN	3	Empfindungen, Empfindung
Gegenteil	NN	3	Gegenteil, Gegenteile
Schwören	NN	3	Schwören
brennen	VVFIN	3	brennt, brenne
erhalten	VVFIN, VVINF	3	erhielte, erhalten, erhält
fürchten	VVFIN	3	fürchten, fürchtest, fürchte
verdrießlich	ADJD, ADJA	3	verdrießlich, verdrießlichen
ehrwürdig	ADJA	3	ehrwürdige, ehrwürdigen
Überzeugung	NN	3	Überzeugung
fest	ADJD	3	fest
erzählen	VVFIN, VVINF	3	erzählen
ankommen	VVINF, VVFIN	3	ankommen, ankäme
Beweis	NN	3	Beweis, Beweise
Lache|Lachen	NN	3	Lachen
stoßen	VVPP, VVFIN	3	gestoßen, stößt
Ton	NN	3	Tone, Töne, Ton
Bediente	NN	3	Bediente, Bedienten
Grad	NN	3	Grade, Grad
jemand	PIS	3	jemand, jemanden
Schwiegersohn	NN	3	Schwiegersohn, Schwiegersöhne
aufnehmen	VVFIN, VVINF	3	aufnimmt, aufnehmen
widerfahren	VVINF, VVPP	3	widerfahren
Erstaunen	NN	3	Erstaunen
Kanne	NN	3	Kanne
Falschheit	NN	3	Falschheit
Bedenklichkeit	NN	3	Bedenklichkeiten
Geistliche	NN	3	Geistlichen
Gute	NN	3	Gutes, Gute
aussetzen	VVIZU, VVPP	3	auszusetzen, ausgesetzt
vorsichtig	ADJD	3	vorsichtig
Freundlichkeit	NN	3	Freundlichkeit
beurteilen	VVINF, VVFIN	3	beurteilen
großmütig	ADJD, ADJA	3	großmütig, großmütiger
stolz	ADJA, ADJD	3	stolzen, stolz
Lisidors	NN	3	Lisidors
Mamsells	NN, NE	3	Mamsells
menschlich	ADJA	3	menschlichen, menschliche
still	ADJA, ADJD	3	stillen, Still, still
meiste	PIS	3	meisten
tauschen	VVFIN, VVINF	3	tauscht, tauschen
werfen	VVINF, VVFIN	3	werfen, wirft
irre	ADJD, PTKVZ	3	irre
Gerechtigkeit	NN	3	Gerechtigkeit
List	NN	3	List
umsehen	VVPP, VVFIN	3	umgesehen, umsieht
schlagen	VVINF, VVPP	3	schlagen, geschlagen
ähnlich	ADJA	3	ähnlicher, ähnlichen
ewig	ADJD	3	ewig
wert	ADJD	3	wert
unterdessen	ADV	3	Unterdessen, unterdessen
Vierte	NN	3	Vierten
geschwind	ADJD	3	geschwind, Geschwind
Bitte	NN	3	Bitte
aufsuchen	VVINF, VVIZU	3	aufsuchen, aufzusuchen
Mädel	NN	3	Mädel
Werk	NN	3	Werk, Werken
Glücke	NN	3	Glücke
herum	APZR, PTKVZ	3	herum
sauer	ADJD	3	sauer
zugleich	ADV	3	zugleich
sinnen	VVFIN, VVPP	3	sinnen, sann, gesonnen
seufzen	VVPP, VVINF	3	geseufzt, seufzen
Frömmigkeit	NN	3	Frömmigkeit
Trinkgeld	NN	3	Trinkgeld, Trinkgeldern, Trinkgelder
erzeigen	VVFIN, VVINF	3	erzeigen
schicken	VVFIN	3	schickte, schickt
meinet	VVFIN	3	meinet
tausendmal	ADV	3	tausendmal
Neigung	NN	3	Neigung
zürnen	VVFIN, VVINF, VVPP	3	Zürne, zürnen, gezürnt
ehe	KOUS	3	ehe
euer	PPOSAT	3	eure, euer
Schwager	NN	3	Schwager
pfui	ITJ	3	Pfui, pfui
schätzen	VVPP, VVINF	3	geschätzt, schätzen
gibts	NN	3	gibts
heftig	ADJD, ADJA	3	heftig, heftigen
empfindlich	ADJD	3	empfindlicher, empfindlich
Vorzug	NN	3	Vorzüge, Vorzug
derselbe	PDS	3	denselben, desselben
laut	ADJD	3	lauter, laut
hervor	ADV, PTKVZ	3	Hervor, hervor
Liebhaber	NN	3	Liebhaber
Türe	NN	3	Türe
vernichten	VVINF, VVFIN	3	vernichten, vernichte, vernichtet
lustig	ADJD	3	lustig, Lustig
Bezahlung	NN	3	Bezahlung
französisch	ADJD	3	Französisch, französisch
gegenwärtig	ADJD, ADJA	3	gegenwärtig, gegenwärtige
Geliebte	NN	3	Geliebte
rasend	ADJD, ADJA	3	rasend, Rasendes
deutlich	ADJD	3	deutlich
Schlingel	NN	3	Schlingel
Tausch	NN	3	Tausche, Tausch
heiraten	VVINF, VVFIN	3	heiraten, heiratet
Anblick	NN	3	Anblick, Anblicke
tausend	CARD	3	tausend
Rat	NN	3	Rat
diejenig	PDAT	3	derjenigen, diejenige
Schritt	NN	3	Schritt
Haar	NN	3	Haaren, Haar, Haare
irren	VVINF, VVFIN	3	irren
riechen	VVFIN	3	rieche, riechst
Atomis	NN	3	Atomis
äußern	VVINF, VVPP	3	äußern, geäußert
urteilen	VVINF, VVFIN	3	urteilen, Urteilen
unterdrücken	VVINF, VVFIN	3	unterdrücken, unterdrückte
getrost	ADV	3	getrost
Glied|Gliedern	NN	3	Gliedern
Großmut	NN	3	Großmut
Notwendigkeit	NN	3	Notwendigkeit
Henriettens	NN, NE	3	Henriettens
Dank	NN	3	Dank
zusammen	PTKVZ, ADV	3	zusammen
Jungfer	NN	3	Jungfer, Jungfern
Heirat	NN	3	Heirat
Bitterkeit	NN	3	Bitterkeit
fällen	VVINF, VVPP	3	fällen, gefällt
ungewiss	ADJD	3	ungewiß
Dienst	NN	3	Dienst
seinetwegen	ADV	3	seinetwegen
verleugnen	VVPP, VVINF	3	verleugnet, verleugnen
meinetwegen	ADV	3	meinetwegen
Papa	NN	3	Papa
Betragen	NN	3	Betragen, Betragens
leicht	ADJD, ADJA	3	leicht, leichte
fallen|gefallen	VVPP	3	gefallen
Schurke	NN	3	Schurke
verfallen	VVPP	3	verfallen
verwirren	VVFIN, VVINF, VVPP	3	verwirren, verwirrt
rauben	VVINF, VVPP	3	rauben, geraubt
Weib	NN	3	Weib
Ruhm	NN	3	Ruhm
reich	ADJA, ADJD	3	reichen, reich
gütig	ADJD	3	gütig
befehlen	VVPP, VVINF	3	befohlen, befehlen
verschonen	VVINF, VVFIN	3	verschonen, verschone, verschont
paar	PIAT, PIS	3	Paar
Folge	NN	3	Folgen, Folge
gleichgültig	ADJD	3	Gleichgültig, gleichgültig
warten	VVFIN	3	warten, Warte, Warten
reißen	VVPP, VVFIN, VVINF	3	gerissen, reißt, reißen
Philosoph	NN	3	Philosoph, Philosophen
Teil	NN	3	Teil
kaum	ADV	3	kaum, Kaum
Narr	NN	3	Narr, Narren
einnehmen	VVPP	3	eingenommen
wunderlich	ADJD, ADJA	3	wunderlich, Wunderlicher, wunderliches
gedenken	VVFIN, VVINF	3	gedenkt, gedenke, gedenken
dahin	PAV	3	dahin
hässlich	ADJD, ADJA	3	häßlicher, häßlich, häßlichen
Glas	NN	3	Glase, Glas
Schluss	NN	3	Schluß
dawider	ADV	3	dawider
Stelle	NN	3	Stelle
vier	CARD	3	viere, vier
bessern	VVFIN, VVINF	3	bessern
fremd	ADJA	3	fremden, fremder
Ungeheuer	NN	3	Ungeheuer
Entfernung	NN	3	Entfernung
Kopf	NN	3	Kopf, Kopfe
vermehren	VVINF	3	vermehren
Grundsatz	NN	3	Grundsätzen, Grundsätze
Schwiegervater	NN	3	Schwiegervater, Schwiegervaters
Hassen	NN	3	Hassen
handeln	VVINF	3	handeln
oben	ADV	3	oben
eins	CARD	3	eins
drein	ADV	3	drein
übrig	ADJA, ADJD	3	übrigen, übrig
zweifeln	VVINF, VVFIN	3	zweifeln, zweifelt, Zweifeln
treten	VVINF, VVFIN	3	treten, tritt
vorschreiben	VVIZU	2	vorzuschreiben
Ehe	NN	2	Ehe
Liebste	NN	2	Liebster, Liebste
Platz	NN	2	Platze
Tausend	NN	2	Tausend
recht|rechts	ADJA	2	rechte, rechten
Umgang	NN	2	Umganges, Umgang
Wörtchen	NN	2	Wörtchen
verfolgen	VVPP, VVFIN	2	verfolgt
Überfluss	NN	2	Überflusse, Überfluß
Zeug	NN	2	Zeug
vorig	ADJA	2	vorigen
allzuwohl	ADJD	2	allzuwohl
Nachsicht	NN	2	Nachsicht
los	ADJD, PTKVZ	2	los
zuwider	PTKVZ, APPO	2	zuwider
Stube	NN	2	Stube
Geschäft	NN	2	Geschäfte
fortgehen	VVINF	2	fortgehen
springen	VVINF, VVFIN	2	springen, springe
Abschied	NN	2	Abschied
Großmutter	NN	2	Großmutter
hundert	CARD	2	hundert
schwesterlich	ADJA	2	schwesterliche
gebieten	VVFIN	2	gebietet
gelassen	ADJD	2	gelassen
Proselyt	NN	2	Proselyten
zuschwören	VVFIN	2	zuschwören
Gestalt	NN	2	Gestalt
beklagen	VVFIN, VVINF	2	beklage, beklagen
anlegen	VVPP, VVINF	2	angelegt, anlegen
Julchen	NN	2	Julchen
scheinet	VVFIN	2	scheinet
Urteil	NN	2	Urteils, Urteil
Horn	NN	2	Hörner
Ernste	NN	2	Ernste
mürrisch	ADJA	2	mürrisches, mürrischen
gefährlich	ADJA	2	gefährlichste, gefährliche
Freigeisterei	NN	2	Freigeisterei
laufen	VVFIN	2	läuft
albern	ADJD	2	albern
Schwarzrock	NN	2	Schwarzröcken, Schwarzröcke
kitzeln	VVPP	2	gekitzelt, Gekitzelt
Unmöglichkeit	NN	2	Unmöglichkeit
Anschlag	NN	2	Anschlag
Lobspruch	NN	2	Lobsprüche, Lobspruch
herauskommen	VVINF	2	herauskommen
Macht	NN	2	Macht
erben	VVFIN	2	erbt, erbte
de	NE	2	de
gehn	VVFIN	2	gehn
Mademoisell	VVFIN, ADJA	2	Mademoisell
Zins	NN	2	Zinsen
abbrechen	VVINF, VVPP	2	abbrechen, abgebrochen
wachsen	VVPP	2	gewachsen
schreiben	VVINF	2	schreiben
enthalten	VVPP, VVFIN	2	enthalten, enthält
brav	ADJA	2	brave, braver
Wendung	NN	2	Wendung
freundlich	ADJA, ADJD	2	freundlichen, freundlich
Vorurteil	NN	2	Vorurteil, Vorurteile
Wut	NN	2	Wut
Trinken	NN	2	Trinken
Krankheit	NN	2	Krankheit
wenden	VVFIN	2	wenden, wendet
manche	PIAT	2	manche, manches
strengen	VVFIN	2	strenge
Unternehmen	NN	2	Unternehmen
Adrasts	NN	2	Adrasts
Verwandtschaft	NN	2	Verwandtschaft
ohngefähr	ADJD	2	ohngefähr
Lächeln	NN	2	Lächeln
verlangt	ADJA	2	verlangte
Leidenschaft	NN	2	Leidenschaften
hierher	PAV	2	hierher
bereit	ADJD	2	bereit
ersetzen	VVINF	2	ersetzen
Versprechen	NN	2	Versprechen
missbrauchen	VVINF	2	mißbrauchen
Beste	NN	2	Beste
Billigkeit	NN	2	Billigkeit
überwinden	VVPP	2	überwunden
Volk	NN	2	Völkern, Volk
Ehemann	NN	2	Ehemänner, Ehemann
entfallen	VVFIN	2	entfielen, entfallen
Verstellung	NN	2	Verstellung
Eifersucht	NN	2	Eifersucht
gehören	VVFIN	2	gehören, gehöre
nachsagen	VVINF	2	nachsagen
hurtig	ADJD	2	hurtig, Hurtig
Juchhei	NE	2	Juchhei
Pünktchen	NN	2	Pünktchen
entzücken	VVFIN, VVINF	2	entzücken
schwerlich	ADJD	2	schwerlich
Kömmt	VVFIN, NN	2	Kömmt
bezeugen	VVPP, VVFIN	2	bezeugt, bezeugte
Rank	NN	2	Ränke
sogar	ADV	2	sogar
schrecklich	ADJA, ADJD	2	schreckliches, schrecklich
wiederholen	VVINF, VVFIN	2	wiederholen, wiederhole
Unrecht	NN	2	Unrecht
Verächter	NN	2	Verächter
versuchen	VVINF, VVFIN	2	versuchen
Übereinstimmung	NN	2	Übereinstimmung
Ihret	NE	2	Ihret
unparteiisch	ADJA, ADJD	2	unparteiisches, unparteiischer
worüber	PWAV	2	worüber
Wirkung	NN	2	Wirkung
entfernen	VVFIN, VVPP	2	entferne, entfernt
bestreben	VVINF	2	bestreben
Sage	NE	2	Sage
würdig	ADJD, ADJA	2	würdig, würdigen
Narre	NN	2	Narre
ungläubig	ADJA, ADJD	2	ungläubigen, ungläubig
unwürdig	ADJD	2	unwürdig
schieben	VVFIN, VVINF	2	schob, schieben
Vieh	NN	2	Vieh
erträglich	ADJD	2	erträglich, erträglicher
Stärke	NN	2	Stärke
betrügen	VVPP	2	betrogen
beibringen	VVIZU	2	beizubringen
drücken	VVPP, VVINF	2	gedrückt, drücken
Ordnung	NN	2	Ordnung
außer	KOUS, APPR	2	außer
schmecken	VVFIN	2	schmeckt
schuldig	ADJD	2	schuldig
Dummkopf	NN	2	Dummkopf
Stellung	NN	2	Stellung
vorbringen	VVIZU, VVFIN	2	vorzubringen, vorbringe
bemerken	VVPP	2	bemerkt
beschämen	VVFIN, VVINF	2	beschämt, beschämen
Bescheidenheit	NN	2	Bescheidenheit
Kerl	NN	2	Kerl
unsrig	PPOSAT	2	unsrigen
erregen	VVPP	2	erregt
vielweniger	ADJD	2	vielweniger
bekümmern	VVINF	2	bekümmern
Großmama	NN	2	Großmama
aufhören	VVFIN	2	aufhören, aufhört
Heuchler	NN	2	Heuchler
schwer	ADJD	2	schwer, schwerer
Vorstellung	NN	2	Vorstellungen, Vorstellung
Ecke	NN	2	Ecke
versichern	VVPP, VVINF	2	versichert, versichern
Wert	NN	2	Wert
wohlweiser	ADJA	2	wohlweiser
gehörig	ADJA	2	gehörige
verwünschen	VVINF, VVFIN	2	verwünschen, verwünscht
verdammen	VVPP, VVINF	2	Verdammt, verdammen
Armut	NN	2	Armut
Verteidiger	NN	2	Verteidiger
krank	ADJD	2	krank
Verteidigung	NN	2	Verteidigung
erschaffen	VVPP	2	erschaffen
ausstellen	VVFIN, VVINF	2	ausstellten, ausstellen
entstehen	VVINF	2	entstehen
Abend	NN	2	Abend
bereden	VVFIN	2	beredet, bereden
anwenden	VVFIN, VVINF	2	anwendest, anwenden
Falle	NN	2	Falle
auslachen	VVINF, VVIZU	2	auslachen, auszulachen
Fremde	NN	2	Fremden
Knieen	NN	2	Knieen
wozu	PWAV	2	wozu
destoweniger	ADJA, VVFIN	2	destoweniger
Geringste	NN	2	Geringste
Beschaffenheit	NN	2	Beschaffenheit
liegend	ADJA	2	liegende
Nächste	NN	2	Nächsten
gebrauchen	VVFIN, VVINF	2	gebrauchen
Betrachtung	NN	2	Betrachtung
diejenigen	PDAT, PDS	2	diejenigen
einlassen	VVINF, VVPP	2	einlassen, eingelassen
fodern	VVINF, NN	2	fodern
beibehalten	VVPP	2	beibehalten
worauf	PWAV	2	Worauf, worauf
Spiel	NN	2	Spiel
Gründlichkeit	NN	2	Gründlichkeit
redlich	ADJA, ADJD	2	redlichen, redlich
dienen	VVINF	2	dienen
verleiten	VVINF, VVFIN	2	verleiten, verleitet
billig	ADJD	2	billig
gewaltig	ADJD	2	gewaltig
schade	ADJD	2	Schade
begleiten	VVINF	2	begleiten
leichtsinnig	ADJA, ADJD	2	leichtsinnigen, leichtsinniger
Freimütigkeit	NN	2	Freimütigkeit
verzweifeln	VVPP, VVFIN	2	Verzweifelt, verzweifle
Verdienst	NN	2	Verdienste, Verdienst
besitzen	VVFIN	2	besitzen
ausmachen	VVFIN, VVINF	2	ausmacht, ausmachen
streiten	VVFIN, VVPP	2	streitet, gestritten
erheben	VVFIN, VVPP	2	erhob, erhoben
Gewissen	NN	2	Gewissen
St	NE	2	St
Lauterkeit	NN	2	Lauterkeit
herunter	PTKVZ	2	herunter
Bedacht	NN	2	Bedacht
betauren	ADJA, NN	2	betauren
widersprechen	VVFIN, VVINF	2	widersprechen
Knoten	NN	2	Knoten
Fall	NN	2	Fall
übergehen	VVPP	2	übergangen
zehnmal	ADV	2	zehnmal
abscheulich	ADJA	2	abscheuliche, abscheulicher
Schwesterchen	NN	2	Schwesterchen
gleichsam	ADJD	2	gleichsam
Wechsler	NN	2	Wechsler
flüchtig	ADJA	2	flüchtigen, flüchtige
Fuchs	NN	2	Fuchs
Julianens	NN	2	Julianens
dirs	NN	2	dirs
Muster	NN	2	Muster
kriegen	VVPP, VVFIN	2	gekriegt, kriegen
abführen	VVPP	2	abgeführt
brüderlich	ADJA	2	brüderlichen, brüderlicher
Unterscheid	NN	2	Unterscheid
unruhig	ADJD, ADJA	2	unruhig, unruhiger
irret	VVFIN	2	irret
Überladung	NN	2	Überladung
Henker	NN	2	Henker
Handel	NN	2	Handel
wofür	PWAV	2	wofür
ausgehen	VVINF, VVPP	2	ausgehen, ausgegangen
Feiertag	NN	2	Feiertag
verdrießen	VVFIN, VVINF	2	verdroß, verdrießen
überreden	VVINF	2	überreden
beständig	ADJA, ADJD	2	beständige, beständig
lehren	VVINF	2	lehren
blenden	VVPP, VVFIN	2	geblendet, blendet
Freiheit	NN	2	Freiheit
erbarmen	VVFIN	2	erbarmte
genießen	VVINF	2	genießen
beruhigen	VVINF	2	beruhigen
treiben	VVINF	2	treiben
allerlieb	ADJA	2	allerliebste, allerliebstes
arg	ADJD	2	ärger, arg
Mama	NN	2	Mama
arm	ADJA	2	armen, armer
seh	FM	2	seh, Seh
strafen	VVPP	2	gestraft
Unmögliche	NN	2	Unmögliche, Unmögliches
gefaßt	ADJD	2	gefaßt
geringschätzig	ADJD, ADJA	2	geringschätzig, geringschätzige
Zank	NN	2	Zank, Zanks
erraten	VVPP, VVFIN	2	erraten, erriet
nähern	VVFIN	2	nähern
Gegenwart	NN	2	Gegenwart
bewegen	VVPP	2	bewogen
Entdeckung	NN	2	Entdeckung
Versuch	NN	2	Versuch
Liebhaberin	NN	2	Liebhaberin
nachhängen	VVINF	2	nachhängen
aufwachsen	VVINF	2	aufwachsen
Last	NN	2	Last
Alte	NN	2	Alte
Heftigkeit	NN	2	Heftigkeit
erwarten	VVFIN, VVINF	2	erwarte, erwarten
Zufall	NN	2	Zufall
männlich	ADJA	2	männliche
Szene	NN	2	Szene
Lobrednerin	NN	2	Lobrednerin
Geschwätze	NN	2	Geschwätze
Gefallen	NN	2	Gefallen
ausdrücklich	ADJD	2	ausdrücklich
gehorsam	ADJD	2	gehorsam
Schicksal	NN	2	Schicksal
spielend	ADJA	2	spielendes, spielende
besorgen	VVINF, VVFIN	2	besorgen, Besorgen
Unterschrift	NN	2	Unterschrift
dran	PAV, PTKVZ	2	dran
langsam	ADJD	2	langsam
holen	VVFIN, VVINF	2	hole, holen
wiederkommen	VVPP, VVINF	2	wiedergekommen, wiederkommen
lenken	VVINF	2	lenken
Holland	NE	2	Holland
Natürlichste	NN	2	Natürlichste
begreifen	VVPP	2	begriffen
Triumph	NN	2	Triumph
beliebt	ADJD	2	beliebt
behorchen	VVINF	2	behorchen
Bruder	NN	2	Brüdern
Vorsatz	NN	2	Vorsatz
Stolze	NN	2	Stolze
Frankreich	NE	2	Frankreich
verschwenden	VVFIN, VVPP	2	Verschwenden, verschwendet
Land	NN	2	Land
zureden	VVFIN, VVINF	2	zureden
neigen	VVFIN	2	neigen
verteidiget	VVFIN	2	verteidiget
beilegen	VVFIN, VVPP	2	beilegten, beigelegt
rechtschaffen	ADJA, ADJD	2	rechtschaffener, rechtschaffen
umgehen	VVINF	2	umgehen
spöttisch	ADJA, ADJD	2	spöttischen, spöttisch
Harmonie	NN	2	Harmonie
fahren|führen	VVFIN	2	führe
Beispiel	NN	2	Beispielen, Beispiele
bieten|gebieten	VVPP	2	geboten
hinderlich	ADJD	2	hinderlich
Bestimmung	NN	2	Bestimmung
Frau	NN	2	Frau
Gesellschaft	NN	2	Gesellschaft
dünken	VVFIN	2	dünkt, deucht
aussprechen	VVINF, VVPP	2	aussprechen, ausgesprochen
lebendig	ADJD	2	lebendig
ichs	ADJD	2	ichs
munter	ADJD, ADJA	2	munter, muntern
Werkzeug	NN	2	Werkzeuge, Werkzeug
Schimpfwort	NN	2	Schimpfworts, Schimpfworte
neugierig	ADJD	2	neugierig
Nachttisch	NN	2	Nachttische, Nachttischen
Schelm	NN	2	Schelm
packen	VVIMP, VVFIN	2	pack, packen
auseinander	PTKVZ	2	auseinander
sparen	VVPP, VVFIN	2	gespart, Spare
Anstiften	NN	2	Anstiften
überwerfen	VVINF	2	überwerfen
entziehen	VVINF	2	entziehen
ziehen	VVINF	2	ziehen
Verliebte	NN	2	Verliebten
beschreiben	VVPP, VVINF	2	beschrieben, beschreiben
nachdrücklich	ADJD, ADJA	2	nachdrücklicher, nachdrücklichste
Schwäger	NN	2	Schwäger
Orden	NN	2	Ordens
Verzweiflung	NN	2	Verzweiflung
Zunge	NN	2	Zunge
bewundern	VVFIN	2	Bewundern, bewundere
aufdringen	VVINF	2	aufdringen
England	NE	2	England
höflich	ADJD, ADJA	2	höflich, höfliche
verkennen	VVINF, VVFIN	2	verkennen
Anverwandte	NN	2	Anverwandten
denken|gedenken	VVPP	2	gedacht
durchbringen	VVPP	2	durchgebracht
gemein	ADJD	2	gemein
wetten	VVFIN	2	wette
dahinter	PAV	2	dahinter
fahren	VVFIN, VVPP	2	Fahren, gefahren
Maul	NN	2	Maul
einig	ADJD	2	einig
Segen	NN	2	Segen
geheim	ADJD	2	geheim
erstaunt	ADJD	2	erstaunt
zeitig	ADJD	2	zeitig
verweisen	VVFIN, VVPP	2	verweise, verwiesen
he	ITJ	2	he, He
Sonderbare	NN	2	Sonderbare
Nachricht	NN	2	Nachricht
Schuld	NN	2	Schuld, Schulden
Alsdann	NE	2	Alsdann
barmherzig	ADJA, ADJD	2	barmherzige, barmherzig
verhungern	VVPP	1	verhungert
steigen	VVINF	1	steigen
Sprunge	NN	1	Sprunge
Trotz	NN	1	Trotze
Verbindliche	NN	1	Verbindliches
staubigten	ADJA	1	staubigten
vertraut	ADJA	1	vertrautesten
träumen	VVINF	1	träumen
Denkungsart	NN	1	Denkungsart
versetzen	VVFIN	1	versetze
Übel	NN	1	übeln
desperat	ADJA	1	desperate
zuletzt	ADV	1	zuletzt
Ärmel	NN	1	Ärmel
plagst	VVFIN	1	plagst
Pfaffengeschmeiß	NN	1	Pfaffengeschmeiß
Flattergeist	NN	1	Flattergeist
verwahren	VVINF	1	verwahren
ruchlos	ADJA	1	ruchlose
Urheber	NN	1	Urheber
ungefähr	ADJD	1	ungefähr
Anerbietens	NN	1	Anerbietens
Vorteil	NN	1	Vorteil
gottlos	ADJA	1	gottlose
Mangel	NN	1	Mangel
Recht|Rechte	NN	1	Rechten
reichen	VVFIN	1	reicht
Gefälligkeit	NN	1	Gefälligkeit
Satan	NN	1	Satan
beweiset	NN	1	beweiset
bedächtig	ADJD	1	bedächtig
Erziehung	NN	1	Erziehung
Licht	NN	1	Licht
vermögen	VVINF	1	vermögen
Aufopferung	NN	1	Aufopferung
Plaudern	NN	1	Plaudern
beleidigend	ADJA	1	beleidigende
Blume	NN	1	Blumen
nichtswürdig	ADJD	1	nichtswürdig
bewusst	ADJA	1	bewußten
ausschreien	VVFIN	1	ausschreien
Deutschland	NE	1	Deutschland
herabstürzen	VVINF	1	herabstürzen
er|es	PPER	1	Ihm
Coup	NN	1	coups
auskundschaften	VVPP	1	ausgekundschaftet
hintergehen	VVFIN	1	hintergehen
Le	NE	1	Le
Rabenaas	NN	1	Rabenaas
Uneigennützigkeit	NN	1	Uneigennützigkeit
anstehen	VVINF	1	anstehen
zeither	ADJD	1	zeither
eng	ADJA	1	engen
Neue	NN	1	Neue
Neugierde	NN	1	Neugierde
erstemal	ADV	1	erstemal
herumhudeln	VVFIN	1	herumhudeln
Bestehet	VVFIN	1	Bestehet
hüten	VVINF	1	hüten
Scham	NN	1	Scham
Reiz|Reizen	NN	1	Reizen
persönlich	ADJA	1	persönlichen
Empfindlichkeit	NN	1	Empfindlichkeit
schneiden	VVPP	1	geschnitten
Monat	NN	1	Monaten
Sohn	NN	1	Sohn
verzeihen|verziehen	VVFIN	1	Verziehen
Trost	NN	1	Trost
herausziehen	VVFIN	1	herauszieht
Frage	NN	1	Fragen
wollend	ADJA	1	wollende
Ausdruck	NN	1	Ausdrücke
Verlieret	VVFIN	1	Verlieret
Antwort	NN	1	Antwort
fix	ADJD	1	fix
tragen	VVFIN	1	trägt
Geheime	NN	1	Geheimes
Lisettchen	NN	1	Lisettchen
antun	VVFIN	1	antut
plötzlich	ADJA	1	plötzliche
Widerwille	NN	1	Widerwillen
Ziel	NN	1	Ziele
erzeugen	VVPP	1	erzeugt
unzüchtig	ADJA	1	unzüchtigen
unzuerklärenden	ADJA	1	unzuerklärenden
Brocken	NN	1	Brocken
voraussetzen	VVPP	1	vorausgesetzt
vernehmen	VVINF	1	vernehmen
Kannibal	NN	1	Kannibal
Holz	NN	1	Holz
Rindvieh	NN	1	Rindvieh
Madame	NN	1	Madame
erziehen	VVPP	1	erzogen
Verzeihen	NN	1	Verzeihen
letztern	NN	1	letztern
Bemühung	NN	1	Bemühung
unbequem	ADJA	1	unbequemen
Nötigers	NN	1	Nötigers
Bequemlichkeit	NN	1	Bequemlichkeit
beißen	VVIMP	1	beiß
unversöhnlich	ADJD	1	unversöhnlich
Bekenntnis	NN	1	Bekenntnis
gemächlich	ADJA	1	gemächlichen
widerrufen	VVINF	1	widerrufen
kömmst	VVFIN	1	kömmst
angehen	VVINF	1	angehen
Gesichtszug	NN	1	Gesichtszüge
geliebet	NE	1	geliebet
höchstbegierig	ADJD	1	höchstbegierig
nichtswürdiges	ADJA	1	nichtswürdiges
nichtswürdiger	ADJA	1	Nichtswürdiger
darnach	ADV	1	darnach
Erbschaft	NN	1	Erbschaft
lauter	PIAT	1	lauter
Fahne	NN	1	Fahne
ungeheuer	ADJD	1	ungeheuer
vorgehen	VVPP	1	vorgegangen
Hinderung	NN	1	Hinderung
drunter	PAV	1	drunter
Kapitel	NN	1	Kapitel
sprengen	VVINF	1	sprengen
bitter	ADJD	1	bitter
traktieren	VVINF	1	traktieren
erreichen	VVPP	1	erreicht
Knie|Knien	NN	1	Knien
Rühmliche	NN	1	Rühmliches
lüderlicher	ADJA	1	lüderlicher
nahe	APPR	1	nahe
Viertelstunde	NN	1	Viertelstunden
Schein	NN	1	Scheine
bedanken	VVINF	1	bedanken
Gleichgültigkeit	NN	1	Gleichgültigkeit
Priester	NN	1	Priestern
abgeschmackt	ADJA	1	abgeschmackte
Schwude	NE	1	Schwude
leihen	VVPP	1	geliehen
aufmutzen	VVINF	1	aufmutzen
Eigennutz	NN	1	Eigennutz
nachfolgen	VVIZU	1	nachzufolgen
Wildfang	NN	1	Wildfang
Ungewissheit	NN	1	Ungewißheit
geendigt	ADJD	1	geendigt
herrschen	VVFIN	1	herrscht
ungetreu	ADJA	1	ungetreuer
Hundsfott	NN	1	Hundsfott
hingehen	VVINF	1	hingehen
Einfalt	NN	1	Einfalt
herbei	PTKVZ	1	herbei
angewandt	ADJA	1	angewandte
Tausendste	NN	1	Tausendste
Trauung	NN	1	Trauung
Weltweisheit	NN	1	Weltweisheit
einladen	VVPP	1	eingeladen
erleuchten	VVPP	1	erleuchtet
Sicherheit	NN	1	Sicherheit
unbeantwortet	ADJD	1	unbeantwortet
Kurtisieren	NN	1	Kurtisieren
Wand	NN	1	Wand
Bürschchen	NN	1	Bürschchen
Abschilderungen	NN	1	Abschilderungen
singen	VVFIN	1	singt
verweilen	VVFIN	1	verweilen
mitten	ADV	1	mitten
beratschlagen	VVINF	1	beratschlagen
gemäß	APPO	1	gemäß
schenken	VVFIN	1	schenkte
ausgeben	VVINF	1	ausgeben
höchstens	ADV	1	höchstens
Brand	NN	1	Brand
Streit	NN	1	Streiten
Knie	NE	1	Knie
Neubegierde	NN	1	Neubegierde
Unbiegsamer	NN	1	Unbiegsamer
demütig	ADJA	1	demütigen
schlichten	VVFIN	1	schlichte
Bestreben	NN	1	Bestreben
Wollte	ADJA	1	Wollte
christlich	ADJA	1	christliche
Lehre	NN	1	Lehre
verteidigen	VVINF	1	verteidigen
nichte	ADJA	1	nichte
mitteilet	ADJD	1	mitteilet
Mamsellchen	NN	1	Mamsellchen
schimpflich	ADJA	1	schimpflichen
erfinden	VVPP	1	erfunden
Zaum	NN	1	Zaume
auslassen	VVINF	1	auslassen
blicken	VVFIN	1	blickt
Schleicher	NN	1	Schleicher
Bockshorn	NN	1	Bockshorn
hiesig	ADJA	1	hiesigen
Seelenkannibal	NE	1	Seelenkannibal
wohlbedächtig	ADJD	1	wohlbedächtig
Ehrgeiz	NN	1	Ehrgeiz
bekannt	ADJD	1	bekannt
Verschonen	NN	1	Verschonen
Blödsinnigsten	NN	1	Blödsinnigsten
rufen	VVPP	1	gerufen
Umfang	NN	1	Umfange
Entschuldigung	NN	1	Entschuldigungen
parteiisch	ADJD	1	parteiisch
Nichtswürdigkeit	NN	1	Nichtswürdigkeit
geraten|raten	VVPP	1	geraten
kriechend	ADJA	1	kriechenden
sorglos	ADJA	1	sorglosesten
Abscheu	NN	1	Abscheu
begreiflich	ADJD	1	begreiflich
une	ADJA	1	une
Kopie	NN	1	Kopien
Stoß	NN	1	Stoß
Kunstgriff	NN	1	Kunstgriff
Lump|Lumpen	NN	1	Lumpen
anflehen	VVINF	1	anflehen
derentwegen	VVFIN	1	derentwegen
Allernichtswürdigste	NN	1	Allernichtswürdigste
vornehmen	VVPP	1	vorgenommen
belieben	VVPP	1	beliebt
vornehmlich	ADJD	1	vornehmlich
Pfaffe	NN	1	Pfaffen
à	FM	1	à
Schule	NN	1	Schule
abkühlen	VVPP	1	abgekühlt
abgeleget	VVPP	1	abgeleget
unfruchtbar	ADJA	1	unfruchtbaren
Hälfte	NN	1	Hälfte
Hiersein	NN	1	Hierseins
Vorwitz	NN	1	Vorwitz
Besorgung	NN	1	Besorgung
servir	NE	1	servir
verletzen	VVINF	1	verletzen
Wichtige	NN	1	Wichtiges
entehren	VVFIN	1	entehren
strengern	ADJA	1	strengern
ordentlich	ADJD	1	ordentlich
Dolch	NN	1	Dolch
allzugern	NN	1	allzugern
beten	VVFIN	1	bete
geirret	NE	1	geirret
Reichtum	NN	1	Reichtum
verlornen	ADJA	1	verlornen
hierinne	VVFIN	1	hierinne
Mine	NN	1	Mine
Anherkunft	NN	1	Anherkunft
anrechnen	VVINF	1	anrechnen
Schmeichlerin	NN	1	Schmeichlerin
Untier	NN	1	Untier
gefällig	ADJA	1	gefällige
kalt	ADJA	1	kaltem
eindrückt	VVFIN	1	eindrückt
Karnevalserfahrung	NN	1	Karnevalserfahrung
richterlich	ADJA	1	richterliche
stampfen	VVINF	1	stampfen
lästerlich	ADJA	1	lästerliches
borgen	VVINF	1	borgen
allerklein	ADJA	1	allerkleinste
schalten	VVINF	1	schalten
dankbar	ADJD	1	dankbar
beunruhiget	VVFIN	1	beunruhiget
wankend	ADJA	1	wankendem
Geier	NE	1	Geier
Wind	NN	1	Wind
erstenmale	NN	1	erstenmale
Stolz	NN	1	Stolz
füllen	VVINF	1	füllen
Arm	NN	1	Arm
darzu	VVIZU	1	darzu
Anstand	NN	1	Anstand
Zeuge	NN	1	Zeugen
Französische	NN	1	Französische
abzielen	VVINF	1	abzielen
misstrauisch	ADJD	1	mißtrauisch
niedrig	ADJA	1	niedrigsten
beneiden	VVFIN	1	beneide
Beschäftigung	NN	1	Beschäftigung
Gläubiger	NN	1	Gläubiger
stiften	VVINF	1	stiften
hundertmal	ADV	1	hundertmal
Prezeln	NN	1	Prezeln
absondern	VVPP	1	abgesondert
binden	VVINF	1	binden
wachsend	ADJA	1	wachsende
tyrannisieren	VVINF	1	tyrannisieren
regelmäßig	ADJD	1	regelmäßig
seicht	ADJA	1	seichten
Formalität	NN	1	Formalität
Acht	NN	1	Acht
Bürge	NN	1	Bürge
woran	PWAV	1	woran
drüber	PAV	1	drüber
Unmensch	NN	1	Unmensch
Verändrung	NN	1	Verändrung
verbunden	ADJD	1	verbunden
Hang	NN	1	Hanges
unterm	APPRART	1	unterm
vermengen	VVINF	1	vermengen
hübsch	ADJD	1	Hübsch
zugehören	VVFIN	1	zugehöre
Spotte	NN	1	Spotte
Richterin	NN	1	Richterin
wohlgemachtesten	ADJA	1	wohlgemachtesten
Verleugner	NN	1	Verleugner
abermal	ADJD	1	abermal
stürmisch	ADJD	1	stürmisch
verantworten	VVINF	1	verantworten
löset	VVFIN	1	löset
aushalten	VVIZU	1	auszuhalten
übereilen	VVINF	1	übereilen
Hundertste	NN	1	Hundertste
unwert	ADJD	1	unwert
Taler	NN	1	Taler
Vermittelung	NN	1	Vermittelung
treuherziges	ADJA	1	treuherziges
bekehren	VVINF	1	bekehren
erholen	VVINF	1	erholen
gehöret	ADJA	1	gehöret
erstaunlich	ADJA	1	erstaunlichste
Umkehr	NN	1	Umkehr
Wohlstande	NN	1	Wohlstande
Hund	NN	1	Hund
unschmackhaft	ADJD	1	unschmackhaft
Schmerz	NN	1	Schmerzen
Pferd	NN	1	Pferd
verdächtig	ADJD	1	verdächtig
Äußerste	NN	1	Äußerste
bearbeiten	VVPP	1	bearbeitet
anhaltend	ADJA	1	anhaltendes
hierzu	PAV	1	hierzu
lächelnd	ADJD	1	Lächelnd
unwissend	ADJA	1	unwissenden
dringender	ADJD	1	dringender
Abschlag	NN	1	Abschlag
Katzenkopf	NN	1	Katzenkopf
unsichtbar	ADJA	1	unsichtbare
inbrünstig	ADJD	1	inbrünstiger
Anhänger	NN	1	Anhänger
Blutsfreunde	NN	1	Blutsfreunde
Stilleschweigen	NN	1	Stilleschweigen
wählen	VVINF	1	wählen
Grausamkeit	NN	1	Grausamkeit
hinunter	ADV	1	hinunter
übergeben	VVPP	1	übergeben
streng	ADJA	1	strenge
Wohlstand	NN	1	Wohlstand
beredtern	ADJA	1	beredtern
Wahn	NN	1	Wahn
Spotten	NN	1	Spotten
Wiederholung	NN	1	Wiederholung
verblinden	VVFIN	1	verblinden
beurlauben	VVINF	1	beurlauben
aufbringen	VVPP	1	aufgebracht
Sachte	NN	1	Sachte
Groll	NN	1	Groll
verstecken	VVINF	1	verstecken
aufziehen	VVIZU	1	aufzuziehen
Franzose	NN	1	Franzosen
zuziehen	VVINF	1	zuziehen
Benennung	NN	1	Benennungen
fliehen	VVINF	1	fliehen
gelangen|langen	VVPP	1	gelangt
Wisch	NN	1	Wische
abzwingen	VVIZU	1	abzuzwingen
höhnisch	ADJD	1	höhnisch
Pest	NN	1	Pest
schlucken	VVINF	1	schlucken
Streitköpfe	NN	1	Streitköpfe
ausliefern	VVINF	1	ausliefern
verbergen	VVINF	1	verbergen
Verlangen	NN	1	Verlangen
belustigen	VVINF	1	belustigen
stören	VVINF	1	stören
glückseligem	ADJA	1	glückseligem
eingefleischt	ADJA	1	eingefleischten
lesen	VVPP	1	gelesen
schaden	VVINF	1	schaden
pere	ADJA	1	pere
schleppen	VVFIN	1	schleppte
denkend	ADJA	1	denkende
lächerlich	ADJD	1	lächerlich
Revansche	NN	1	Revansche
Vorwerk	NN	1	Vorwerk
würdigen	VVINF	1	würdigen
Schüler	NN	1	Schüler
kriechende	ADJA	1	kriechende
Handschrift	NN	1	Handschriften
Backofen	NN	1	Backofen
Bösewichter	ADJD	1	Bösewichter
abgeborgt	VVPP	1	abgeborgt
Schwiegersohne	NN	1	Schwiegersohne
bestrebet	VVFIN	1	bestrebet
Balthasarn	NE	1	Balthasarn
Rodomontade	NE	1	Rodomontade
aufräumen	VVPP	1	aufgeräumt
kritisch	ADJA	1	kritischen
Unnatürlichste	NN	1	Unnatürlichste
Verklagung	NN	1	Verklagung
zerrissen	ADJA	1	zerrissenen
grob	ADJD	1	grob
strittest	VVFIN	1	strittest
zugestoßener	ADJA	1	zugestoßener
Gebot	NN	1	Gebotes
abgekartet	ADJA	1	abgekartetes
abermals	ADV	1	Abermals
größre	ADJA	1	größre
innern	ADJA	1	innern
Gunst	NN	1	Gunst
Unbesonnenheit	NN	1	Unbesonnenheit
berechtiget	VVFIN	1	berechtiget
Verleumder	NN	1	Verleumder
anbieten	VVPP	1	angeboten
entbehren	VVINF	1	entbehren
Länge	NN	1	Länge
Schlaue	NN	1	Schlaue
bunt	ADJD	1	bunt
halt	ADV	1	Halt
vergeblich	ADJA	1	vergeblichen
Nötiges	NN	1	Nötiges
vorbei	ADV	1	vorbei
ruhen	VVINF	1	ruhen
herumschleichen	VVFIN	1	herumschleicht
gequälet	VVPP	1	gequälet
Bündel|Bündeln	NN	1	Bündeln
erwerben	VVINF	1	erwerben
Klasse	NN	1	Klasse
Kette	NN	1	Kette
itzt	ADJD	1	itzt
Gelassenheit	NN	1	Gelassenheit
ungestalteten	ADJA	1	ungestalteten
deinigen	ADJA	1	deinigen
verkleidet	ADJA	1	verkleideten
auftragen	VVINF	1	auftragen
et	FM	1	et
bekömmt	VVFIN	1	bekömmt
zurückkommen	VVINF	1	zurückkommen
Edelste	NN	1	Edelste
Beteurung	NN	1	Beteurung
ungeschimpft	ADJD	1	ungeschimpft
unanständig	ADJD	1	unanständig
kühnern	ADJA	1	kühnern
Wesen	NN	1	Wesen
Schöps	NN	1	Schöps
Keines	NN	1	Keines
zweit	ADJA	1	zweite
zugetrauet	VVFIN	1	zugetrauet
Blind	NE	1	Blind
wetterwendisch	ADJA	1	wetterwendischen
dürr	ADJA	1	dürren
wirken	VVFIN	1	wirkt
Heiligkeit	NN	1	Heiligkeit
beiher	NN	1	beiher
einschränken	VVIZU	1	einzuschränken
freundschaftlichste	ADJA	1	freundschaftlichste
murren	VVFIN	1	murre
Engländsch	NN	1	Engländsch
nachsehend	ADJD	1	nachsehend
vorfallen	VVFIN	1	vorfallen
Atem	NN	1	Atem
Lohn	NN	1	Lohn
Münze	NN	1	Münze
Post	NN	1	Post
Meile	NN	1	Meilen
Märtyrer	NN	1	Märtyrer
Feuer	NN	1	Feuer
liebenswert	ADJD	1	liebenswerter
unterlassen	VVPP	1	unterlassen
Stehen	NN	1	Stehen
verwirrt	ADJD	1	verwirrt
Bürger	NN	1	Bürgern
Puppe	NN	1	Puppe
vornehm	ADJA	1	vornehmsten
ans	APPRART	1	ans
ehrbar	ADJA	1	ehrbares
Allzugütige	ADJA	1	Allzugütige
Hals	NN	1	Hals
fertig	ADJD	1	fertig
Verlust	NN	1	Verlust
Höhe	NN	1	Höhe
carogne	ADJA	1	carogne
Mitleiden	NN	1	Mitleiden
ohnedem	VVFIN	1	ohnedem
rückgängige	ADJA	1	rückgängige
fille	NN	1	fille
wunderbar	ADJA	1	Wunderbarer
einsehen	VVINF	1	einsehen
ernähren	VVINF	1	ernähren
Rocke	NN	1	Rocke
garstig	ADJA	1	garstige
Brocke	NN	1	Brocke
unbeschreiblich	ADJA	1	unbeschreibliche
abjagen	VVPP	1	abgejagt
Nachrede	NN	1	Nachrede
vorzüglich	ADJA	1	vorzügliche
verachtet	ADJA	1	verachteten
erzürnen	VVINF	1	erzürnen
Krank	NE	1	Krank
Religiöse	NN	1	Religiöse
Niederträchtige	NN	1	Niederträchtige
Joch	NN	1	Joch
wütend	ADJA	1	wütenden
Schwanz	NN	1	Schwanz
behutsam	ADJD	1	behutsamer
erkundigen	VVFIN	1	erkundigte
stärkern	NN	1	stärkern
lebhaft	ADJA	1	lebhaftes
schreien	VVFIN	1	schreit
Lineamente	NN	1	Lineamente
Kröte	NN	1	Kröte
Bewegung	NN	1	Bewegung
weiden	VVFIN	1	weiden
angenommen	ADJA	1	angenommene
Anspruch	NN	1	Ansprüche
absprechen	VVINF	1	absprechen
Partei	NN	1	Partei
versäumen	VVINF	1	versäumen
Zwang	NN	1	Zwang
Abscheuliches	NN	1	Abscheuliches
Glückes	NN	1	Glückes
wahrern	ADJA	1	wahrern
damals	ADV	1	damals
verdammt	ADJA	1	verdammter
Jahr	NN	1	Jahr
dahinreißt	VVFIN	1	dahinreißt
Vorzuge	NN	1	Vorzuge
Grobheit	NN	1	Grobheit
Kreatur	NN	1	Kreatur
eitel	ADJA	1	eitles
Hässlichkeit	NN	1	Häßlichkeit
befriediget	VVFIN	1	befriediget
Eigensinn	NN	1	Eigensinn
Deist	NN	1	Deist
Aufschub	NN	1	Aufschub
Erste	NN	1	Erste
Abgeborgt	VVPP	1	Abgeborgt
gelangen	VVINF	1	gelangen
verhelfen	VVPP	1	verholfen
dergleichen	PIS	1	dergleichen
hernach	ADV	1	hernach
Dorn	NN	1	Dorn
drohend	ADJD	1	Drohend
ferne	ADV	1	ferne
Rolle	NN	1	Rolle
sogleich	ADV	1	sogleich
Bettel	NN	1	Bettel
eigennützig	ADJD	1	eigennützig
Antichrist	NN	1	Antichrist
samt	APPR	1	samt
unvernünftig	ADJA	1	unvernünftigen
marternd	ADJA	1	marternde
verkaufen	VVINF	1	verkaufen
Wechselbalg	NN	1	Wechselbalg
Weisheit	NN	1	Weisheit
Gerät	NN	1	Geräte
schießen	VVINF	1	schießen
Schwäche	NN	1	Schwäche
Männerchen	NN	1	Männerchen
Verächtliche	NN	1	Verächtliche
Stuhl	NN	1	Stuhl
Uph	NE	1	Uph
erstenmal	NN	1	erstenmal
beißend	ADJA	1	beißenden
Bravo	NN	1	Bravo
vergelten	VVFIN	1	vergilt
kriechen	VVINF	1	kriechen
ohnmächtig	ADJD	1	ohnmächtig
Dummheit	NN	1	Dummheit
rückgängig	ADJD	1	rückgängig
Kur	NN	1	Kur
Luft	NN	1	Luft
Engel	NN	1	Engel
Gebieterin	NN	1	Gebieterin
befördern	VVINF	1	befördern
anständig	ADJA	1	anständigere
vergeben	VVINF	1	vergeben
Höflichkeit	NN	1	Höflichkeit
fechten	VVFIN	1	ficht
Postwagen	NN	1	Postwagen
jagen	VVINF	1	jagen
englisch	ADJD	1	englisch
nötigen	VVFIN	1	nötigten
allzuvorsichtig	ADJD	1	allzuvorsichtig
ausreden	VVINF	1	ausreden
befriedigen	VVINF	1	befriedigen
zernichten	VVFIN	1	zernichten
Mut	NN	1	Mut
prellen	VVINF	1	prellen
Beruhigung	NN	1	Beruhigung
essen	VVFIN	1	ißt
entspringen	VVFIN	1	entspringt
Predigen	NN	1	Predigen
vergangen	ADJA	1	vergangene
ausklagen	NN	1	ausklagen
heucheln	VVINF	1	heucheln
beleidigt	ADJA	1	beleidigten
Prediger	NN	1	Prediger
überzeugt	ADJD	1	überzeugt
Wurf	NN	1	Würfe
Kleine	NN	1	Kleine
Mutmaßung	NN	1	Mutmaßungen
belehren	VVFIN	1	belehre
wohlgefällt	VVPP	1	wohlgefällt
Labsal	NN	1	Labsal
allerfein	ADJA	1	allerfeinste
Gewissheit	NN	1	Gewißheit
bereichern	VVFIN	1	bereichere
gehört	ADJD	1	gehört
Aussöhnung	NN	1	Aussöhnung
Tropfen	NN	1	Tropfen
Bekehrung	NN	1	Bekehrung
am	PTKA	1	am
kleiden	VVINF	1	kleiden
angehörst	VVFIN	1	angehörst
Magen	NN	1	Magen
verderbter	ADJA	1	verderbter
woraus	PWAV	1	woraus
entkleiden	VVINF	1	entkleiden
hölzern	ADJD	1	hölzern
wackern	VVFIN	1	wackern
Element	NN	1	Elemente
dunkel	ADJD	1	dunkler
leisten	VVINF	1	leisten
diable	ADJA	1	diable
leichtsinniger	ADJA	1	leichtsinniger
Stunde|Stunden	NN	1	Stunden
Dingerchen	NN	1	Dingerchen
gestehen|stehen	VVPP	1	gestanden
Annehmlichkeit	NN	1	Annehmlichkeiten
Wesentlichsten	NN	1	Wesentlichsten
baton	NE	1	baton
hinein	PTKVZ	1	hinein
Verachtungen	NN	1	Verachtungen
hinhängt	VVFIN	1	hinhängt
drehen	VVINF	1	drehen
jederzeit	ADV	1	jederzeit
gewahr	ADJD	1	gewahr
Reise	NN	1	Reise
Breite	NN	1	Breite
einfältig	ADJA	1	Einfältiger
Schreck	NN	1	Schreck
Bär	NN	1	Bär
Strafe	NN	1	Strafe
hinaus	ADV	1	hinaus
leibhafte	ADJA	1	leibhafte
berühmt	ADJA	1	berühmter
anschwatzen	VVFIN	1	anschwatzen
hinreichet	ADJA	1	hinreichet
leid	ADJD	1	leid
heben	VVFIN	1	hebe
einigermaßen	ADV	1	einigermaßen
Reise|Reisen	NN	1	Reisen
bürden	VVFIN	1	bürden
geliebt	ADJA	1	geliebten
ungestört	ADJD	1	ungestört
Gehts	NN	1	Gehts
versauerst	VVFIN	1	versauerst
widern	VVIMP	1	wider
wohnen	VVFIN	1	wohnen
übersehen	VVINF	1	übersehen
Tor	NN	1	Toren
Grillenfänger	NN	1	Grillenfänger
Schminke	NN	1	Schminke
Tod	NN	1	Tode
Mosjeu	NN	1	Mosjeu
verdrungen	NN	1	verdrungen
Brunnen	NN	1	Brunnen
alsdenn	NE	1	alsdenn
wehmütig	ADJA	1	wehmütigen
Genüge	NN	1	Genüge
Privilegium	NN	1	Privilegium
sahe	VVFIN	1	sahe
Dreustigkeit	NN	1	Dreustigkeit
Adel	NN	1	Adel
fressen	VVINF	1	fressen
taub	ADJA	1	taubes
klagen	VVFIN	1	klagt
Absatze	NN	1	Absatze
klimpertst	VVFIN	1	klimpertst
gelehrt	ADJA	1	gelehrter
Falte|Falten	NN	1	Falten
Annehmung	NN	1	Annehmung
herab	PTKVZ	1	herab
überlästigen	ADJA	1	überlästigen
anbringen	VVPP	1	angebracht
prophezeien	VVFIN	1	prophezeien
Geblüte	NN	1	Geblüte
Meisterstück	NN	1	Meisterstück
Zweiflerin	NN	1	Zweiflerin
unmenschlich	ADJD	1	unmenschlicher
Anständigkeit	NN	1	Anständigkeit
Erde	NN	1	Erde
Laus	NN	1	Laus
Vorschlag	NN	1	Vorschlag
versehen	VVINF	1	versehen
getreuern	NN	1	getreuern
listig	ADJA	1	listiger
vollends	ADV	1	vollends
Ekel	NN	1	Ekel
Schwarzrocke	NN	1	Schwarzrocke
Fehl	NN	1	Fehl
Leib	NN	1	Leibe
abhalten	VVINF	1	abhalten
Rechtfertigung	NN	1	Rechtfertigungen
Leid	NN	1	Leid
Konkurs	NN	1	Konkurse
Stein	NN	1	Steine
voran	ADV	1	voran
närrisch	ADJA	1	närrische
dichten	VVFIN	1	dichte
Hauptsache	NN	1	Hauptsache
Hass	NN	1	Hasse
Bau	NN	1	Baue
Erschrecken	NN	1	Erschrecken
malen	VVFIN	1	male
entfernt	ADJD	1	entfernt
aufrichten	VVINF	1	aufrichten
Bessere	NN	1	Besseres
klatschen	VVPP	1	geklatscht
Freite	NN	1	Freite
erstern	NN	1	erstern
Holunke	NN	1	Holunke
Anliegen	NN	1	Anliegen
Lumpenhund	NN	1	Lumpenhund
verschieden	ADJA	1	verschiedenen
unverdient	ADJA	1	unverdienten
stillen	VVFIN	1	stille
ernsthaft	ADJA	1	ernsthaften
unvorsichtig	ADJD	1	unvorsichtig
bedeuten	VVINF	1	bedeuten
Zeugnis	NN	1	Zeugnis
Verkehr	NN	1	Verkehr
missen	VVINF	1	missen
zugestehet	VVFIN	1	zugestehet
hoffentlich	ADV	1	hoffentlich
ungeschickt	ADJD	1	ungeschickt
Nutz	NN	1	Nutze
Irrung	NN	1	Irrungen
Fähigkeit	NN	1	Fähigkeit
backen	VVINF	1	backen
Ei	NN	1	Ei
vorzuzählen	VVIZU	1	vorzuzählen
Theolog	NN	1	Theolog
geschworne	ADJA	1	geschworne
wagen	VVINF	1	wagen
boshaft	ADJD	1	boshaft
Dämmerung	NN	1	Dämmerung
dingen	VVPP	1	gedungen
fischen	VVFIN	1	fische
Topp	NN	1	Topp
vorteilhaft	ADJD	1	vorteilhaft
Raub	NN	1	Raub
bestellen	VVINF	1	bestellen
Aufführung	NN	1	Aufführung
gereiset	ADJD	1	gereiset
schmachtendes	ADJA	1	schmachtendes
bedenken	VVFIN	1	Bedenken
Schlüssel	NN	1	Schlüssel
Theophane	NE	1	Theophane
Entzückungen	NN	1	Entzückungen
jetzig	ADJA	1	jetzigen
unverschämt	ADJA	1	unverschämter
passen	VVINF	1	passen
darreichen	VVFIN	1	darreicht
Närrin	NN	1	Närrin
scheußlich	ADJA	1	scheußlichsten
Ohrenbläser	NN	1	Ohrenbläser
Schäkerinnen	NN	1	Schäkerinnen
unbeständig	ADJA	1	unbeständiger
ungehalten	ADJD	1	ungehalten
karg	ADJD	1	karg
spintisiert	VVFIN	1	spintisiert
abholen	VVINF	1	abholen
Witz	NN	1	Witz
Vornehmste	NN	1	Vornehmste
Futter	NN	1	Futter
Erfahrung	NN	1	Erfahrung
wiedersehen	VVINF	1	wiedersehen
biegen	VVFIN	1	biegt
unrecht	ADJD	1	unrecht
Neuigkeit	NN	1	Neuigkeit
schwatze	VVFIN	1	schwatze
Allerboshafteste	NN	1	Allerboshafteste
abmalen	VVPP	1	abgemalt
kostbar	ADJD	1	kostbarer
erkannt	ADJA	1	erkannten
todsterbenskrank	ADJD	1	todsterbenskrank
Verbrecher	NN	1	Verbrecher
abtreten	VVINF	1	abtreten
Hassenswürdigste	NN	1	Hassenswürdigste
Verbrechen	NN	1	Verbrechen
zerreißen	VVPP	1	zerrissen
Spöttisch	NN	1	Spöttisch
Fischbeinröcken	NN	1	Fischbeinröcken
Zipfel	NN	1	Zipfel
küssen	VVINF	1	küssen
Heiligste	NN	1	Heiligste
Julianchen	NN	1	Julianchen
irgend	ADV	1	irgend
Narrheit	NN	1	Narrheit
vergnügt	ADJD	1	vergnügt
Frankreichsch	NN	1	Frankreichsch
Taschenbuch	NN	1	Taschenbuch
schmälern	VVINF	1	schmälern
Widerrede	NN	1	Widerrede
Saufen	NN	1	Saufen
Gehorsam	NN	1	Gehorsam
durchgerannt	VVPP	1	durchgerannt
zwanzigmal	ADV	1	zwanzigmal
Beobachtung	NN	1	Beobachtung
manchmal	ADV	1	manchmal
herstellen	VVINF	1	herstellen
abzirkeln	VVINF	1	abzirkeln
egales	ADJA	1	egales
Ausspruch	NN	1	Aussprüche
ausgelassen	ADJD	1	ausgelassen
infam	ADJD	1	Infamer
ernstlich	ADJD	1	ernstlich
hungrig	ADJA	1	hungriger
Gescheutes	NN	1	Gescheutes
schmeißen	VVPP	1	geschmissen
Unruhe	NN	1	Unruhe
Hundsfötter	NN	1	Hundsfötter
Collin	NN	1	Collin
Ungereimtheit	NN	1	Ungereimtheiten
schwören	VVFIN	1	Schwören
Besondere	NN	1	Besondere
rücken	VVPP	1	gerückt
stürzen	VVFIN	1	stürzen
verwandeln	VVINF	1	verwandeln
Ergebenheit	NN	1	Ergebenheit
Ruchlosen	NN	1	Ruchlosen
erhaben	ADJD	1	erhaben
bestärken	VVFIN	1	bestärkten
Schlimmste	NN	1	Schlimmste
verbeiße	VVFIN	1	verbeiße
Vergehungen	NN	1	Vergehungen
bewahren	VVFIN	1	bewahre
beleidigen	VVINF	1	beleidigen
Schimmer	NN	1	Schimmer
gewöhnlich	ADJD	1	gewöhnlich
hegen	VVINF	1	hegen
Eigentum	NN	1	Eigentum
Frauenzimmerauge	NN	1	Frauenzimmerauge
allerwenig	ADJA	1	allerwenigsten
Ruin	NN	1	Ruin
ausrechnen	VVINF	1	ausrechnen
herein	PTKVZ	1	herein
Verschweigung	NN	1	Verschweigung
Widriges	NN	1	Widriges
Falte	NN	1	Falte
Übereilung	NN	1	Übereilung
Schlucker	NN	1	Schlucker
untergraben	VVINF	1	untergraben
ungezwungen	ADJA	1	ungezwungene
andermal	ADV	1	andermal
hineinbringen	VVPP	1	hineingebracht
pathetisch	ADJD	1	pathetischer
Anschein	NN	1	Anschein
sittsam	ADJA	1	sittsame
Ernsthaftigkeit	NN	1	Ernsthaftigkeit
beschäftiget	VVFIN	1	beschäftiget
beschäftigen	VVFIN	1	beschäftigten
versäufst	VVFIN	1	versäufst
vorgefaßt	ADJA	1	vorgefaßten
Kenntnis	NN	1	Kenntnis
beteuern	VVFIN	1	beteuern
tanzen	VVFIN	1	tanzt
begierig	ADJD	1	begierig
ledig	ADJD	1	ledig
Weide	NN	1	Weide
reizend	ADJD	1	reizend
fesseln	VVINF	1	fesseln
Staat	NN	1	Staates
sanft	ADJA	1	sanften
erschrecken	VVFIN	1	erschrecken
verändert	ADJD	1	verändert
Poete	NN	1	Poete
angelangen	VVPP	1	angelangt
Besitz	NN	1	Besitz
absteigen	VVPP	1	abgestiegen
Augapfel	NN	1	Augapfel
Erbe	NN	1	Erbe
beschwören	VVFIN	1	beschwöre
weinen	VVFIN	1	weinen
Maulaffe	NN	1	Maulaffe
Linke	NN	1	Linken
Wehe	NN	1	Wehe
meinig	PPOSS	1	meinige
Bosheit	NN	1	Bosheit
Herrschaft	NN	1	Herrschaft
allzu	PTKA	1	allzu
Jenen	NN	1	Jenen
verziehen	VVFIN	1	verziehst
Sammelplatz	NN	1	Sammelplatz
unleugbar	ADJD	1	unleugbar
predigen	VVINF	1	predigen
Bild	NN	1	Bilder
hitzig	ADJD	1	hitzig
überlassen	VVPP	1	überlassen
Pulver	NN	1	Pulver
Comment	ADJD	1	Comment
pfeifen	VVFIN	1	pfeifen
verdeckt	ADJA	1	verdeckten
stückweise	ADJD	1	stückweise
zerstreuen	VVFIN	1	zerstreut
lassend	ADJA	1	lassende
schaffen	VVFIN	1	schafft
verderben	VVFIN	1	verderbt
Galgendieb	NN	1	Galgendieb
aufwallend	ADJA	1	aufwallende
vorzupredigen	VVIZU	1	vorzupredigen
weggehen	VVINF	1	weggehen
Bedünkens	NN	1	Bedünkens
Beunruhigen	NN	1	Beunruhigen
scheinend	ADJA	1	scheinende
Geheimnis	NN	1	Geheimnis
Temperament	NN	1	Temperamente
vorweisen	VVPP	1	vorgewiesen
diesesmal	ADV	1	diesesmal
Plunder	NN	1	Plunder
Gemütsart	NN	1	Gemütsart
erlangen	VVINF	1	erlangen
Lernen	NN	1	Lernen
unverrichtet	ADJA	1	unverrichteter
schmelzen	VVPP	1	geschmolzen
maraut	VVFIN	1	maraut
Verlegenheit	NN	1	Verlegenheit
herausgejagt	VVPP	1	herausgejagt
Abschreckungen	NN	1	Abschreckungen
verwenden	VVPP	1	verwandt
vous	NE	1	vous
Sonnenstrahl	NN	1	Sonnenstrahlen
bemerkt	ADJA	1	bemerkter
Gemahl	NN	1	Gemahl
Fröhliche	NN	1	Fröhliches
angeborne	ADJA	1	angeborne
mächtig	ADJA	1	mächtige
zurücken	VVFIN	1	zurücke
Allgemeinheit	NN	1	Allgemeinheit
schnurrig	ADJA	1	schnurrige
großmütigsten	ADJA	1	großmütigsten
wollts	VVFIN	1	wollts
dringen	VVFIN	1	dringt
Höllenbrand	NN	1	Höllenbrand
Liebkosung	NN	1	Liebkosung
Zug	NN	1	Zug
auskommen	VVINF	1	auskommen
argwöhnisch	ADJD	1	argwöhnisch
Abwesenheit	NN	1	Abwesenheit
Kaltsinn	NN	1	Kaltsinn
strafbar	ADJD	1	strafbar
Ausnahme	NN	1	Ausnahmen
unverzüglich	ADJD	1	unverzüglich
absagen	VVIZU	1	abzusagen
Errettung	NN	1	Errettung
witzig	ADJD	1	witzig
allerfrömmsten	ADJA	1	allerfrömmsten
trüben	VVINF	1	trüben
Nachdenken	NN	1	Nachdenken
Schöpfer	NN	1	Schöpfer
blöd	ADJA	1	blöde
Verzweifeltste	NN	1	Verzweifeltste
aufgeräumt	ADJD	1	aufgeräumt
Klügerm	NN	1	Klügerm
Erhebung	NN	1	Erhebung
Leber	NN	1	Leber
lenket	VVFIN	1	lenket
sparsam	ADJD	1	sparsamer
zuhören	VVINF	1	zuhören
Not	NN	1	Not
Wollust	NN	1	Wollust
Ruhe	NN	1	Ruhe
Schlange	NN	1	Schlange
verrichten	VVINF	1	verrichten
Stimme	NN	1	Stimme
Bocksfüße	NN	1	Bocksfüße
umzechig	ADJD	1	umzechig
Blitz	NN	1	Blitz
Ochse	NN	1	Ochse
gesprächig	ADJD	1	gesprächig
begnügen	VVINF	1	begnügen
Nachmittagspredigt	NN	1	Nachmittagspredigt
Gemüt	NN	1	Gemüter
betäuben	VVINF	1	betäuben
Summe|Summen	NN	1	Summen
übermorgen	ADV	1	übermorgen
betaure	VVFIN	1	betaure
finsterm	ADJA	1	finsterm
Bedenken	NN	1	Bedenken
Blutsfreund	NN	1	Blutsfreund
Einwilligung	NN	1	Einwilligung
weitre	ADJA	1	weitre
aufschlagen	VVFIN	1	aufschlägt
Wunsch	NN	1	Wunsch
Seufzen	NN	1	Seufzen
Revers	NN	1	Revers
anbeten	VVFIN	1	anbete
ergeben	VVPP	1	ergeben
Verführung	NN	1	Verführung
gehts	VVFIN	1	gehts
anhalten	VVINF	1	anhalten
redt	ADJD	1	redt
voll	ADJA	1	voller
überführet	VVFIN	1	überführet
Niederträchtigen	NN	1	Niederträchtigen
überführen	VVINF	1	überführen
Menschheit	NN	1	Menschheit
Soll	NN	1	solls
verachtend	ADJA	1	verachtenden
Hum	NN	1	Hum
Wohl	NN	1	Wohl
sachte	ADV	1	sachte
göttlich	ADJA	1	göttlichen
Aufmerksamkeit	NN	1	Aufmerksamkeit
zornig	ADJD	1	zornig
Nachdruck	NN	1	Nachdruck
Lehrer	NN	1	Lehrer
Betschwester	NN	1	Betschwester
Nase	NN	1	Nase
stechen	VVFIN	1	stechen
Sorge|Sorgen	NN	1	Sorgen
widerlegt	ADJA	1	widerlegte
ablenken	VVIZU	1	abzulenken
est-il	ADJD	1	est-il
Zahn	NN	1	Zahn
Quelle	NN	1	Quelle
gründlich	ADJA	1	gründlichen
gegenseitig	ADJA	1	gegenseitigen
Unordnung	NN	1	Unordnung
vergnügen	VVINF	1	vergnügen
Schwur	NN	1	Schwur
widerrufst	VVFIN	1	widerrufst
fett	ADJA	1	fetten
Schnippchen	NN	1	Schnippchen
Lösungswort	NN	1	Lösungswort
gewärtig	ADJD	1	gewärtig
waret	ADJA	1	waret
Veränderung	NN	1	Veränderung
langen	VVFIN	1	langt
Aufenthalt	NN	1	Aufenthalt
Einlenkungen	NN	1	Einlenkungen
hindern	VVFIN	1	hindert
Priesterfrau	NN	1	Priesterfrau
rechtschaffnen	ADJA	1	rechtschaffnen
merklich	ADJA	1	merkliche
Pfarr	NE	1	Pfarr
worin	PWAV	1	worin
wohinter	PWAV	1	wohinter
herumschweifen	VVINF	1	herumschweifen
Fallstrick	NN	1	Fallstricke
wundern	VVFIN	1	wundern
la	FM	1	la
Endzwecke	NN	1	Endzwecke
gesund	ADJA	1	gesunder
Sinn	NN	1	Sinne
streitig	ADJD	1	streitig
Nähzeuge	NN	1	Nähzeuge
Beschuldigung	NN	1	Beschuldigungen
Flitterwoche	NN	1	Flitterwochen
ausrichten	VVINF	1	ausrichten
verknüpfet	VVFIN	1	verknüpfet
Posthause	NN	1	Posthause
Schuss	NN	1	Schuß
schnakisch	ADJD	1	schnakisch
Geistlichkeit	NN	1	Geistlichkeit
verhehlen	VVFIN	1	verhehlte
Woche	NN	1	Woche
rennen	VVINF	1	rennen
hochbefehlenden	ADJA	1	hochbefehlenden
Pfeife	NN	1	Pfeife
umarmen	VVINF	1	umarmen
schimpflichsten	ADJA	1	schimpflichsten
Geschicklichkeit	NN	1	Geschicklichkeit
gegeben	ADJA	1	gegebenes
gefärbt	ADJA	1	gefärbte
Gefahr	NN	1	Gefahr
Vers	NN	1	Vers
bitte	PTKANT	1	bitte
gegeneinander	ADV	1	gegeneinander
Zeisig	NN	1	Zeisig
schönern	NN	1	schönern
vorwerfen	VVIZU	1	vorzuwerfen
unartig	ADJA	1	Unartige
bestätigen	VVINF	1	bestätigen
bilden	VVINF	1	bilden
Vorschrift	NN	1	Vorschriften
überfallen	VVINF	1	überfallen
wovon	PWAV	1	Wovon
vorhergehen	VVINF	1	vorhergehen
Skrupel	NN	1	Skrupel
prahlend	ADJA	1	prahlenden
herauf	ADV	1	herauf
erwägen	VVFIN	1	erwäge
Vorrecht	NN	1	Vorrechte
erhabenern	ADJA	1	erhabenern
Halssachen	NN	1	Halssachen
Verwünschung	NN	1	Verwünschungen
Auslegung	NN	1	Auslegungen
aufgeben	VVINF	1	aufgeben
Spaß	NN	1	Spaß
Tier	NN	1	Tiere
verjüngt	ADJA	1	verjüngte
Paar	NN	1	Paar
gereuet	VVFIN	1	gereuet
Orakel	NN	1	Orakel
aufstoßen	VVFIN	1	aufstößt
Leere	NN	1	Leere
Reife	NN	1	Reife
Lieblingsmeinung	NN	1	Lieblingsmeinung
Entzückende	NN	1	Entzückende
überdrüssig	ADJD	1	überdrüssig
aufrichtig	ADJD	1	aufrichtig
Unfall	NN	1	Unfälle
Gereist	NN	1	Gereist
Brut	NN	1	Brut
überraschen	VVINF	1	überraschen
Pah	NE	1	Pah
Zorn	NN	1	Zorn
Wahre	NN	1	Wahre
coquin	ADJD	1	coquin
unhöflich	ADJD	1	unhöflich
Zuflucht	NN	1	Zuflucht
hinterbrechen	VVFIN	1	hinterbracht
mitleidig	ADJA	1	mitleidiges
Studierstube	NN	1	Studierstube
hämtückischen	ADJA	1	hämtückischen
rein	ADJA	1	reinen
melden	VVINF	1	melden
verschieben	VVIMP	1	Verschieb
zärtlich	ADJA	1	zärtlichste
fliegen	VVINF	1	fliegen
adieu	ADV	1	Adieu
Neckerei	NN	1	Neckereien
Wahrscheinlichkeit	NN	1	Wahrscheinlichkeit
Mode	NN	1	Mode
Wohnung	NN	1	Wohnung
Ernst	NE	1	Ernst
rege	ADJD	1	rege
plaudern	VVPP	1	geplaudert
Ohngefähr	NN	1	Ohngefähr
Anfall	NN	1	Anfälle
erwecket	VVFIN	1	erwecket
Bibel	NN	1	Bibel
Einwurf	NN	1	Einwurf
rechnen	VVINF	1	rechnen
Äußere	NN	1	Äußeres
widerstehen	VVINF	1	widerstehen
Schloss	NN	1	Schlosse
Korb	NN	1	Korb
begehen	VVINF	1	begehen
glänzend	ADJA	1	glänzenden
allerweitesten	ADJA	1	allerweitesten
aufgedeckt	ADJD	1	aufgedeckt
gewürdiget	VVPP	1	gewürdiget
Erschreckliches	NN	1	Erschreckliches
gebunden	ADJA	1	gebundenen
willkürlich	ADJA	1	willkürliche
Gebet	NN	1	Gebet
Bestätigung	NN	1	Bestätigung
geborne	ADJA	1	geborne
stimmen	VVFIN	1	stimmt
Danksagung	NN	1	Danksagung
verlorne	ADJA	1	verlorne
reif	ADJD	1	reif
trauen	VVFIN	1	traue
herausspringen	VVFIN	1	herausspringt
herschrieben	VVFIN	1	herschrieben
Entschluss	NN	1	Entschluß
bezaubert	ADJA	1	bezauberte
allzusehr	ADJD	1	allzusehr
kindisch	ADJA	1	kindischen
wirs	ADJD	1	wirs
verhindern	VVFIN	1	verhindert
Ausflucht	NN	1	Ausflucht
Minute	NN	1	Minute
Gesetz	NN	1	Gesetzes
Stütze	NN	1	Stütze
drum	PAV	1	Drum
dargegen	ADV	1	dargegen
vergebens	ADV	1	vergebens
Anlage	NN	1	Anlage
aufgebracht	ADJA	1	aufgebrachte
Heu	NN	1	Heu
Haupt	NN	1	Haupt
Strahl|Strahlen	NN	1	Strahlen
heimlich	ADJA	1	heimliche
Schwätzerin	NN	1	Schwätzerin
Ganze	NN	1	Ganzes
Geschöpfchen	NN	1	Geschöpfchen
kahl	ADJA	1	Kahle
vielmal	ADV	1	vielmal
lockrer	ADJA	1	lockrer
Munterkeit	NN	1	Munterkeit
allmählig	ADJD	1	allmählig
Anmut	NN	1	Anmut
Stadt	NN	1	Stadt
selten	ADJD	1	selten
schmackhaft	ADJD	1	schmackhaft
getrauen	VVFIN	1	getraue
verlästern	VVPP	1	verlästert
leer	ADJA	1	leere
Verwirrung	NN	1	Verwirrung
Hoffnung	NN	1	Hoffnung
bestürzen	VVINF	1	bestürzen
ändern	VVFIN	1	ändert
Unkosten	NN	1	Unkosten
greifen	VVFIN	1	greift
Gefährt|Gefährte	NN	1	Gefährten
hervorbringen	VVINF	1	hervorbringen
unendlich	ADJD	1	unendlich
verstellen	VVINF	1	verstellen
vorzöge	VVFIN	1	vorzöge
leichtfertig	ADJD	1	leichtfertig
Reiz	NN	1	Reize
siebenmal	ADV	1	siebenmal
entfärben	VVFIN	1	entfärben
anmelden	VVINF	1	anmelden
tauern	VVFIN	1	tauern
retten	VVFIN	1	rettete
schelten	VVPP	1	gescholten
Tasche	NN	1	Tasche
untersuchen	VVINF	1	untersuchen
schriftlich	ADJA	1	schriftliche
Mundwerk	NN	1	Mundwerk
eingezogen	ADJD	1	eingezogener
heitern	VVFIN	1	Heitern
Stern	NN	1	Stern
siehts	NN	1	siehts
Unabhängigkeit	NN	1	Unabhängigkeit
Bösewicht	NN	1	Bösewicht
scheuen	VVPP	1	gescheut
Freidenker	NN	1	Freidenker
heuern	VVFIN	1	heure
abwarten	VVINF	1	abwarten
martern	VVINF	1	martern
vorschlagen	VVINF	1	vorschlagen
verwechseln	VVFIN	1	verwechseln
umkehren	VVFIN	1	umkehrt
peinigen	VVINF	1	peinigen
Männchen	NN	1	Männchen
Beischlaf	NN	1	Beischlaf
verhärten	VVINF	1	verhärten
brechen	VVFIN	1	bricht
Geschmack	NN	1	Geschmack
Blitzmädel	NN	1	Blitzmädel
aufrichtigern	ADJA	1	aufrichtigern
ersuchen	VVINF	1	ersuchen
Gabe	NN	1	Gabe
womit	PWAV	1	womit
dennoch	ADV	1	dennoch
Fortgehen	NN	1	Fortgehen
Ohr	NN	1	Ohren
Gesetzgeber	NN	1	Gesetzgeber
streichen	VVFIN	1	Streichen
Freigeiste	NN	1	Freigeiste
Geschick	NN	1	Geschick
Diantre	ADJA	1	Diantre
wünschet	ADJD	1	wünschet
nachgeben	VVINF	1	nachgeben
verderblich	ADJA	1	verderbliche
Rätsel	NN	1	Rätsel
erheiraten	VVFIN	1	erheiratet
nackend	ADJD	1	nackend
rechtfertigen	VVINF	1	rechtfertigen
Jugend	NN	1	Jugend
neidisch	ADJD	1	neidisch
vorschießen	VVINF	1	vorschießen
betauern	VVFIN	1	betauern
hetzen	VVINF	1	hetzen
aufstehen	VVFIN	1	aufsteht
Hauch	NN	1	Hauch
Bocke	NN	1	Bocke
anbeißen	VVINF	1	anbeißen
mere	ADJA	1	mere
würzen	VVPP	1	gewürzt
hierauf	PAV	1	Hierauf
inner	ADJA	1	innere
ehemals	ADV	1	ehemals
Geplärre	NN	1	Geplärre
austeilen	VVINF	1	austeilen
Wald	NN	1	Wäldern
davor	PAV	1	davor
Diener	NN	1	Diener
Potz	NN	1	Potz
ärgerlich	ADJD	1	ärgerlich
vorsätzlich	ADJD	1	vorsätzlich
loben	VVINF	1	loben
Heuchelei	NN	1	Heuchelei
süß	ADJA	1	süßen
stundenlang	ADJA	1	stundenlanges
Aushalten	NN	1	Aushalten
jung	ADJA	1	junger
Jüngling	NN	1	Jüngling
reinigen	VVINF	1	reinigen
Vorsorge	NN	1	Vorsorge
Gründliches	NN	1	Gründliches
Mäßigung	NN	1	Mäßigung
verstorben	ADJA	1	verstorbenen
Kitzelung	NN	1	Kitzelung
