Title: Die alte Jungfer
Number of all lemmas: 3369
Nummber of different lemmas: 1301

Lemma	POS	Frequency	Tokens
Herr	NN	84	Herr, Herren, Herrn
Capitaine	NN	41	Capitaine
sagen	VVFIN, VVINF, VVPP	39	sagt, Sage, sagen, sagst, gesagt, sagte, Sagen, sage, sagten
gut	ADJD, ADJA	37	gut, besten, beste, Gut, besser, guten, gute, guter
Schlag	NN	36	Schlag, Schlage
ach	ITJ	36	Ach
Mann	NN	33	Mann, Männer, Manne, Männern, Mannes
wohl	ADV	33	wohl, Wohl
Jahr	NN	32	Jahr, Jahren, Jahrs, Jahre
wissen	VVFIN, VVINF	30	weiß, wissen, wüßtest, wüßte, Weiß
Jungfer	NN	27	Jungfer, Jungfern
alt	ADJD, ADJA	26	alt, ältesten, altes, alten, alte, altem, Alte
nehmen	VVFIN, VVINF, VVIMP, VVPP	25	nimmt, Nehmen, nehme, nähme, nehmen, nimm, genommen
heiraten	VVINF, VVFIN, VVPP	23	heiraten, Heirate, heirate, geheiratet
gar	ADV	23	gar, Gar
lieb	ADJA, ADJD	23	lieber, liebe, lieb, lieben
nu	ITJ	21	nu, Nu
sehen	VVFIN, VVINF, VVPP	20	sehe, sehen, sieht, gesehen, siehst, Sieht, sahen, sähe
Lelio	NE	19	Lelio
denken	VVFIN, VVINF	19	denke, denkt, denken, dächte, dächten, dachte, Denken
glauben	VVINF, VVFIN, VVPP	19	glauben, glaube, glaubst, Glauben, Glaubst, geglaubt
gewiss	ADJD	18	gewiß, Gewiß
Gott	NN	18	Gott, Gottes
wahr	ADJD	18	wahr
ha	NE	17	ha
wenige	PIS, PIAT	16	wenig, weniger
heißen	VVFIN, VVINF	16	hieße, heißt, heißen
Kind	NN	16	Kinder, Kind
Muhme	NN, NE	16	Muhme
Lisette	NE	16	Lisette
Mademoiselle	NN	15	Mademoiselle
sonst	ADV	15	sonst, Sonst
schuldig	ADJD	15	schuldig
recht	ADJD, ADJA	15	recht, rechter
hören	VVFIN, VVINF	14	hört, hören, höre, Hören, hörte, Hört
Bräutigam	NN	13	Bräutigam, Bräutigams
reden	VVFIN, VVINF, VVPP	13	reden, Reden, geredet, rede, redet, redest
Ohldin	NE, NN	13	Ohldin
erst	ADV, ADJA	13	erst, ersten, erste
Frau	NN	12	Frau
Peter	NE	12	Peter
Sache	NN	12	Sachen, Sache
Teufel	NN	11	Teufels, Teufel
Braut	NN	11	Braut
versprechen	VVFIN	11	versprach, verspreche, verspricht, Versprechen, versprechen
itzo	ADJD, VVFIN, VVIMP, NN	11	itzo
bald	ADV	11	bald
Ha	NE	11	Ha
Hand	NN	11	Händen, Hand, Hände
Vetter	NN, NE	10	Vetters, Vetter
Schneider	NE	10	Schneider
Henker	NN	10	Henker
Poete	NN	10	Poete
Kerl	NN	10	Kerl, Kerlen
Heirat	NN	10	Heirat
Geld	NN	10	Geld, Gelde, Gelder
bezahlen	VVINF, VVFIN, VVPP	9	bezahlen, bezahlt, bezahle
Poet	NN	9	Poeten
Wort	NN	9	Wort, Worte, Wörter
bekommen	VVFIN, VVINF	9	bekomme, bekommen, Bekomme, bekäme
Name	NN	9	Namen, Name, Namens
lange	ADV	9	lange
kömmt	VVFIN, ADJD	9	kömmt
Zeit	NN	9	Zeit, Zeiten
etwan	NE, NN	9	etwan
Weib	NN	8	Weib, Weiber
Augenblick	NN	8	Augenblick
@card@	CARD	8	1724, 1748, 34
Oronte	VVFIN, VVINF, ADJD	8	Oronte
Ei	NN	8	Ei
sehnen	VVIMP	8	sehn
närrisch	ADJA, ADJD	8	närrische, närrisch
heute	ADV	8	heute
Freund	NN	8	Freund, Freunden, Freunde
Kopf	NN	8	Kopf, Kopfe, Köpfe
vielleicht	ADV	8	Vielleicht, vielleicht
fort	PTKVZ, ADV	8	fort
ehrlich	ADJA	7	ehrlichen, ehrliches, ehrliche, ehrlicher
er|es	PPER	7	Ihm
eben	ADV	7	eben, Eben
Narr	NN	7	Narr, Narren
bitten	VVINF, VVFIN	7	bitten, bitte
klein	ADJA	7	kleine, kleinen, kleinste, kleiner
unsre	PPOSAT	7	unsre, unsern
genug	ADV	7	genug
vortrefflich	ADJD, ADJA	7	vortrefflich, vortrefflichen, vortreffliche
Art	NN	7	Art
artig	ADJA, ADJD	7	artige, artigen, artiger, artig, artigsten
Haus	NN	7	Hause, Haus
verstehen	VVFIN, VVIMP, VVPP	7	verstehen, versteh, verstanden
richtig	ADJD	6	richtig
übel	ADJD	6	übel
Tat	NN	6	Tat
Tag	NN	6	Tage, Tag, Tagen, Tags
sachte	ADV	6	sachte, Sachte
groß	ADJA, ADJD	6	großer, großen, groß
Narre	NN	6	Narre
kaufen	VVFIN, VVPP	6	kauft, Kaufen, kaufte, kaufe, gekauft
Unglück	NN	6	Unglück, Unglücke
warten	VVFIN, VVINF, VVPP	6	Warte, warten, Warten, gewartet
Erbschaft	NN	6	Erbschaft
stehen	VVFIN	6	stünde, steht, Steht, stehe
Glück	NN	6	Glück
verzeihen	VVFIN	6	verzeihe, verzeihen, Verzeihen
Geschlecht	NN	6	Geschlecht, Geschlechte
weg	ADV, PTKVZ	6	weg
Stand	NN	6	Standes, Stande
kennen	VVPP, VVFIN, VVINF	6	gekannt, kennst, kennen, kennt
schicken	VVPP, VVINF, VVFIN	6	geschickt, schicken, schickt
Korb	NN	6	Korb
Hochzeit	NN	6	Hochzeit
Nu	NN	6	Nu
Frauenzimmer	NN	6	Frauenzimmer, Frauenzimmern
lang	ADJA, ADJD	6	lange, lang, länger
Mensch	NN	6	Mensch, Menschen
Vermögen	NN	5	Vermögen
brauchen	VVFIN	5	brauche, brauchst, brauchen, braucht
Neue	NN	5	Neues
paar	PIS, PIAT	5	Paar
kurz	ADJD	5	kurz, Kurz
24	CARD	5	24
zehn	CARD	5	zehn
Seite	NN	5	Seite
Taler	NN	5	Taler
gehn	VVFIN	5	gehn
Fuß	NN	5	Füßen, Fuß, Füße
ansehen	VVFIN, VVINF	5	ansieht, ansehen
Leute	NN	5	Leuten, Leute
lachen	VVFIN, VVINF	5	lachst, lachen, lacht
allerlieb	ADJA	5	allerliebstes, allerliebste, allerliebster
dumm	ADJA, ADJD	5	dumme, dumm, dümmer
verdammt	ADJA	5	verdammte, verdammter
Schuld	NN	5	Schuld, Schulden
einzig	ADJA, ADJD	5	einziges, einzige, einzigen, einziger, einzig
Sies	NN	5	Sies
unglücklich	ADJD, ADJA	5	unglücklich, unglückliche
zwei	CARD	5	zwei
Gesicht	NN	5	Gesichte, Gesicht
stecken	VVINF, VVFIN	5	stecken, steckt, steckten
Hund	NN	5	Hund
dergleichen	PIS	5	dergleichen
wohnen	VVFIN, VVPP	4	wohnt, gewohnt
gütig	ADJA, ADJD	4	gütige, gütig
drei	CARD	4	drei
Seele	NN	4	Seele, Seelen
glücklich	ADJA, ADJD	4	glücklichen, glücklich, glückliche
gern	ADV	4	gern
900	CARD	4	900
schön	ADJA, ADJD	4	schönes, schöne, schön
Person	NN	4	Person, Personen
Stube	NN	4	Stube
niemand	PIS	4	niemand
deutlich	ADJD, ADJA	4	deutlich, deutlichen, deutlichsten
breit	ADJA, ADJD	4	breiten, breit, breite
leben	VVFIN, VVINF	4	Leben, lebe, leben
böse	ADJA	4	böses, böse
behüten	VVFIN	4	behüte, Behüte
kehren	VVFIN	4	Kehren, kehren
@ord@	ADV, ADJA	4	1724., 45.
spielen	VVINF, VVPP	4	spielen, gespielt
Hölle	NN	4	Hölle
entschließen	VVINF, VVFIN, VVPP	4	entschließen, entschlossen
schmecken	VVPP, VVFIN	4	geschmeckt, schmeckt, schmeckte
Schritt	NN	4	Schritte, Schritt
Gedanke	NN	4	Gedanken
Carmen	NE	4	Carmen
bürgerlich	ADJA	4	bürgerlichen
wert	ADJD	4	wert
fertig	ADJD, PTKVZ	4	fertig
adieu	ADV	4	Adieu
Makrone	NN	4	Makronen
setzen	VVFIN, VVPP	4	setzt, Gesetzt
genießen	VVINF, VVPP, VVFIN	4	genießen, genossen
Stelle	NN	4	Stelle
vier	CARD	4	Vier, vier, vieren
Heirat|Heiraten	NN	4	Heiraten
fürchten	VVINF, VVFIN	4	fürchten, fürchte
Dank	NN	4	Dank
Fehler	NN	4	Fehler
besinnen	VVFIN, VVINF	4	besinne, besinnen
Gedicht	NN	4	Gedicht, Gedichte
borgen	VVINF, VVPP	4	borgen, Geborgt, geborgt
zwanzig	CARD	4	zwanzig
allzu	PTKA	4	allzu
Neuigkeit	NN	4	Neuigkeit, Neuigkeiten
Wechsel	NN	4	Wechsel
wünschen	VVINF	4	wünschen
erbaulich	ADJA, ADJD	4	erbaulichem, Erbaulich, erbaulich, erbauliche
zählen	VVFIN, VVINF	4	Zähle, zählen
einander	PRF	4	einander
Vertrauen	NN	4	Vertrauen
et	FM	4	et
Ehre	NN	4	Ehre
jung	ADJD, ADJA	4	jung, jünger, jungen
Stadt	NN	4	Stadt
schade	ADJD	3	Schade
recht|rechts	ADJA	3	rechte, rechten
nachlaufen	VVINF	3	nachlaufen
Krafttörtchen	NN	3	Krafttörtchen
weißen	VVFIN	3	Weißt, weißt
gottlos	ADJA, ADJD	3	gottloses, gottlos, gottlose
Freier	NN	3	Freier, Freiers
Recht|Rechte	NN	3	Rechte, Rechten
aufs	APPRART	3	Aufs, aufs
Tod	NN	3	Tode, Todes, Tod
erklären	VVPP	3	erklärt
befehlen	VVFIN, VVPP, VVINF	3	befehlen, befohlen
mirs	ADJD	3	mirs
gestern	ADV	3	gestern, Gestern
Haar	NN	3	Haare, Haar
hinderlich	ADJD	3	hinderlich
anstehen	VVFIN	3	ansteht, anstehe
sterben	VVFIN, VVINF	3	stirbt, sterben
hundert	CARD	3	hundert
erzählen	VVINF, VVFIN	3	erzählen, Erzähle, erzähle
danken	VVINF, VVFIN	3	danken, Danken
erstemal	ADV	3	erstemal
entsprießen	VVPP	3	entsprossen
verlangen	VVFIN	3	verlangen
Frage	NN	3	Fragen, Frage
25	CARD	3	25
uralt	ADJA	3	uralten
halt	ADV	3	halt, Halt
Höh	NN	3	Höh
Rat	NN	3	Rat
Gassenlied	NN	3	Gassenlied
Kompliment	NN	3	Kompliment
nimmermehr	ADV	3	nimmermehr
heraus	ADV, PTKVZ	3	heraus
irren	VVFIN, VVPP	3	irrst, irren, geirrt
wirds	VVFIN, ADJD	3	wirds
behalten	VVFIN, VVINF	3	behalte, behalten, Behalten
Münze	NN	3	Münzen
laufen	VVFIN	3	laufen, läuft
wenigstens	ADV	3	Wenigstens, wenigstens
schlecht	ADJD	3	schlecht
Straße	NN	3	Straße
Dukaten	NN	3	Dukaten
Vergnügen	NN	3	Vergnügen
Runzel|Runzeln	NN	3	Runzeln
stellen	VVFIN	3	Stelle, stelle
Hundsfott	NN	3	Hundsfott
antworten	VVINF, VVFIN	3	antworten, Antworte
vorhin	ADV	3	vorhin
Einfall	NN	3	Einfall
helfen	VVFIN, VVINF	3	hilft, helfen
adlichen	ADJA	3	adlichen
übrig	ADJA, ADJD	3	übriges, übrige, übrig
Weg	NN	3	Weg, Wege
Spritzkuchen	NN	3	Spritzkuchen
Streich	NN	3	Streich, Streiche
arg	ADJD	3	arg
schreiben	VVPP, VVFIN	3	geschrieben, schreibst
fremd	ADJA	3	fremden
etliche	PIAT	3	etliche
suchen	VVFIN, VVINF	3	suchen, suche
stehn	ADJD, VVPP, NN	3	stehn
Pas	NN	3	Pas
Rechnung	NN	3	Rechnung
46.	ADJA	3	46.
herum	APZR, PTKVZ	3	herum
wenig	ADV	3	wenig
Zweifel	NN	3	Zweifel
pap	NE	3	pap
Zimmer	NN	3	Zimmer
Hals	NN	3	Hals, Halse
legen	VVFIN, VVPP	3	legen, gelegt, lege
ankommen	VVINF, VVPP	3	ankommen, angekommen
44	CARD	3	44
Hochwohlgeborne	ADJA	3	Hochwohlgeborne
finden	VVINF, VVFIN, VVPP	3	finden, finde, gefunden
gering	ADJA	3	geringste, geringe
Gelegenheit	NN	3	Gelegenheiten, Gelegenheit
stoßen	VVFIN, VVINF, VVPP	3	stößt, stoßen, gestoßen
Ohr	NN	3	Ohre, Ohren
kosten	VVINF	3	kosten
Zuckerbretzeln	NN	3	Zuckerbretzeln
Treppe	NN	3	Treppen, Treppe
darzu	VVIZU, ADV	3	darzu
hintertreiben	VVINF	3	hintertreiben
Rock	NN	3	Rock
euer	PPOSAT	3	eure, eurer, Eure
Himmel	NN	3	Himmel
beisammen	ADV, PTKVZ	3	beisammen
48	CARD	3	48
Nacht	NN	3	Nächte, Nacht
unbesonnen	ADJA, ADJD	3	unbesonnene, unbesonnen
weder	KON	3	weder
Meister	NN	3	Meister
47.	ADJA	3	47.
holen	VVINF, VVFIN	3	holen, holte
Clitander	NE	3	Clitander
sicher	ADJA, ADJD	2	sichern, sicherer
Nase	NN	2	Nase
Nachdenken	NN	2	Nachdenken
Ehe	NN	2	Ehe
alleweile	ADV	2	alleweile
gesteh	NE	2	gesteh
nachsagen	VVIZU	2	nachzusagen
Wein	NN	2	Wein
Familie	NN	2	Familien, Familie
voraus	PTKVZ, ADV	2	voraus
verflucht	ADJA	2	verfluchte
wählen	VVFIN	2	Wählen
zeihen|ziehen	VVFIN	2	zieht
schwerlich	ADJD	2	schwerlich
antragen	VVINF	2	antragen
Verhaft	NN	2	Verhaft
Übel	NN	2	Übels, Übel
laut	ADJD, ADJA	2	lauter, lautem
Galgenschwengel	NN	2	Galgenschwengel
Posse	NN	2	Possen
deutsch	ADJD, ADJA	2	deutsch, deutschen
Beschreibung	NN	2	Beschreibung
toll	ADJD, ADJA	2	toll, tollen
leid	ADJD	2	leid
verzweifelt	ADJA	2	verzweifelten, verzweifelte
unvergleichlich	ADJA	2	Unvergleichlicher, unvergleichlicher
treffen	VVFIN	2	treffe, treffen
unterschieden	ADJA	2	unterschiedene
Gnade	NN	2	Gnaden
beantworten	VVINF	2	beantworten
Corinna	NE	2	Corinna
anmutig	ADJD	2	anmutig
alsdann	ADJD	2	alsdann
hintenraus	VVFIN	2	hintenraus
Grab	NN	2	Grabe, Grab
dreißig	CARD	2	dreißig
verstehens	VVFIN	2	verstehens
Schatz	NN	2	Schatzes, Schatz
geschehen	VVINF, VVFIN	2	geschehen, geschieht
Quodlibet	NN	2	Quodlibet
Jugend	NN	2	Jugend
verlieren	VVFIN, VVPP	2	verlöre, verloren
Habseligkeit	NN	2	Habseligkeit
Bezahlung	NN	2	Bezahlung
Bart	NN	2	Bart
fein	ADJA, ADJD	2	feinen, fein
Ehestands	NN	2	Ehestands
widersprechen	VVINF	2	widersprechen
erdroßle	VVFIN	2	erdroßle
Verstand	NN	2	Verstand
tief	ADJD	2	tief, tiefer
fünfzig	CARD	2	fünfzig
ausdrücken	VVINF	2	ausdrücken
abhelfen	VVIZU, VVINF	2	abzuhelfen, abhelfen
anzusehn	VVIZU	2	anzusehn
Gesellschaft	NN	2	Gesellschaft
ärgern	VVINF	2	ärgern
rechtschaffen	ADJA	2	rechtschaffene
dreifach	ADJA	2	dreifachen
Stärke	NN	2	Stärke
Stelzfuß	NN	2	Stelzfuß
bins	VVFIN	2	bins
Leib	NN	2	Leib
wollens	VVFIN	2	wollens
26	CARD	2	26
anwenden	VVFIN, VVPP	2	anwende, angewandt
Stunde	NN	2	Stunde
Hypothesin	NN	2	Hypothesin
Cabinet	ADJA	2	Cabinet
dienen	VVINF, VVPP	2	dienen, gedient
Torheit	NN	2	Torheit
plötzlich	ADJD	2	plötzlich
halb	ADJA	2	halbe, halben
versichre	VVFIN	2	versichre
ei	FM, NE	2	Ei
fahren|führen	VVFIN	2	führe
Vers	NN	2	Vers
dirs	NN	2	dirs
List	NN	2	List
Schicksal	NN	2	Schicksal
kriegen	VVINF, VVFIN	2	kriegen
beißen	VVINF, VVFIN	2	beißen, beißt
versöhnen	VVPP, VVINF	2	versöhnt, versöhnen
Rede|Reden	NN	2	Reden
Thesin	NN	2	Thesin
wagen	VVINF	2	wagen
Dienerin	NN	2	Dienerin
ehe	KOUS	2	ehe
nennen	VVINF, VVFIN	2	nennen, nenne
jen	PDAT, PDS	2	jenem, jener
Mittel	NN	2	Mittel
Gang	NN	2	Gange, Gang
abgeschmackt	ADJD	2	abgeschmackt
packen	VVIMP, VVINF	2	Pack, packen
werter	ADJA	2	werter
beständig	ADJD, ADJA	2	beständig, beständige
umgehen	VVIZU, VVFIN	2	umzugehen, umgeht
Bein	NN	2	Bein
ists	VVFIN	2	ists
Gebackens	NN	2	Gebackens
oft	ADV	2	oft
jemand	PIS	2	jemanden, jemand
höflich	ADJD	2	höflicher, höflich
Gedult	NN	2	Gedult
lernen	VVINF, VVFIN	2	lernen, Lernen
Freiheit	NN	2	Freiheit
erstlich	ADJD	2	erstlich
ohngefähr	ADJD	2	ohngefähr
Freude	NN	2	Freuden
willigen	VVINF, VVFIN	2	willigen, willige
christlich	ADJD, ADJA	2	christlich, christlichen
12	CARD	2	12
zeigen	VVINF	2	zeigen
schwer	ADJD	2	schwer
dachts	VVFIN	2	dachts
stets	ADV	2	stets
Sorge	NN	2	Sorge
Inhalt	NN	2	Inhalte
arm	ADJA	2	armes, arme
bekannt	ADJD	2	bekannt
reizend	ADJA	2	reizende
Rede	NN	2	Rede
Billard	NN	2	Billard
verdenken	VVINF	2	verdenken
überlegen	VVINF, VVPP	2	überlegen, überlegt
Behüts	NN	2	Behüts
Abscheu	NN	2	Abscheu
gedulden	VVFIN	2	Gedulden, Gedulde
gescheit	ADJA	2	gescheiten, gescheite
Irrtum	NN	2	Irrtum
unschuldig	ADJA	2	unschuldiges
Überlegung	NN	2	Überlegung
fest	ADJD, ADJA	2	fest, feste
Tanzen	NN	2	Tanzen
missbrauchen	VVINF	2	mißbrauchen
Gebackensherumträger	NN	2	Gebackensherumträger
sauer	ADJD, ADJA	2	sauer, sauren
vernünftig	ADJA	2	vernünftigen
Beistand	NN	2	Beistand
unvernünftig	ADJA	2	unvernünftiger, unvernünftiges
manche	PIAT	2	manchem, manchen
verfluchter	ADJA	2	Verfluchter
alleine	ADV	2	alleine
Weise	NN	2	Weisen, Weise
fallen|gefallen	VVPP	2	gefallen
Gemahlin	NN	2	Gemahlin
künftig	ADJD, ADJA	2	künftig, künftigen
lehren	VVINF	2	lehren
tanzen	VVINF	2	tanzen
Schimpf	NN	2	Schimpf
Schmause	NN	2	Schmause
Dienst	NN	2	Diensten, Dienst
träumen	VVINF	2	träumen
gewinnen	VVFIN, VVPP	2	gewinnt, gewonnen
Auge	NN	2	Augen
Ort|Orten	NN	2	Orten
Spiegel	NN	2	Spiegel
Ausdrückungen	NN	2	Ausdrückungen
Mägdgen	NN	2	Mägdgen
begegnen	VVFIN	2	begegnete, Begegnet
Gabe	NN	2	Gabe
weiß	ADJD	2	weiß
verstehn	ADJD, VVFIN	2	verstehn
54	CARD	2	54
Spötterei	NN	2	Spötterei
50	CARD	2	50
lesen	VVFIN, VVPP	2	liest, gelesen
wider	APPR	2	wider
schalkhaftem	ADJA	2	schalkhaftem
Ho	NE	2	Ho
hundertmal	ADV	2	hundertmal
acht	CARD, ADJA	2	acht
entgegen	PTKVZ	2	entgegen
feurig	ADJA	2	feurigen, feurige
fahren	VVFIN, VVPP	2	fahren, gefahren
funfzig	NN, CARD	2	funfzig
Maul	NN	2	Maul, Maule
sichs	NE	2	sichs
freilich	ADV	2	freilich
schaffen	VVFIN, VVINF	2	schafft, schaffen
abfinden	VVINF	2	abfinden
besondern	VVFIN	2	besondre
Feind	NN	2	Feinden, Feindes
fassen	VVFIN	2	faßte, fassen
Punkt	NN	2	Punkte
Rtlr	NN	2	Rtlr
besorgen	VVFIN	2	besorge
Fenster	NN	2	Fenster, Fenstern
Stück	NN	2	Stück
treten	VVFIN	2	treten
zanken	VVINF	2	zanken
Freundin	NN	2	Freundin, Freundinnen
vorsagen	VVFIN	2	vorsagt, vorsagte
Pfennig	NN	2	Pfennig
gehören	VVFIN	2	gehört, gehöre
Exempel	NN	2	Exempel
unser	PPOSAT	2	unserer, unsrer
allein	ADV	2	allein
notwendig	ADJD	2	notwendig
Cabinettüre	NN	1	Cabinettüre
darinne	NN	1	darinne
abgesetzt	ADJA	1	abgesetzte
zerplatzen	VVINF	1	zerplatzen
ziehn	VVFIN	1	ziehn
leichtsinniger	ADJA	1	leichtsinniger
mild	ADJA	1	milde
Traum	NN	1	Traum
Ostern	NN	1	Ostern
Stückgen	NN	1	Stückgen
hingehen	VVINF	1	hingehen
anakreontische	ADJA	1	anakreontische
wahrlich	ADV	1	Wahrlich
auslesen	VVPP	1	ausgelesen
einfließen	VVINF	1	einfließen
Kleid	NN	1	Kleider
deswegen	PAV	1	deswegen
drauf	PAV	1	drauf
Hochzeitabend	NN	1	Hochzeitabend
zuhören	VVIZU	1	zuzuhören
Leben	NN	1	Leben
draus	PAV	1	draus
Platz	NN	1	Platz
hierinnen	NN	1	hierinnen
Wesentliche	NN	1	Wesentliche
jemals	ADV	1	jemals
gewaltig	ADJD	1	gewaltig
vertraut	ADJD	1	vertraut
pflegen	VVFIN	1	pflegt
Schmaus	NN	1	Schmaus
Verbindung	NN	1	Verbindung
lächerlich	ADJD	1	lächerlich
Verzeihen	NN	1	Verzeihen
Wahl	NN	1	Wahl
selber	ADV	1	selber
außer	APPR	1	außer
anstehet	VVFIN	1	anstehet
abfertigen	VVINF	1	abfertigen
viertens	ADV	1	Viertens
Wörtchen	NN	1	Wörtchen
desperat	ADJD	1	desperat
Stoßen	NN	1	Stoßen
Rücken	NN	1	Rücken
Narrenspossen	NN	1	Narrenspossen
Widersprechen	NN	1	Widersprechen
fehlen	VVFIN	1	fehlt
Feinheit	NN	1	Feinheit
Vorstellen	NN	1	Vorstellen
aufbringen	VVINF	1	aufbringen
Hexe	NN	1	Hexe
benennen	VVINF	1	benennen
bescheiden	ADJD	1	bescheidener
Arrest	NN	1	Arrest
Figur	NN	1	Figur
eigensinnig	ADJD	1	eigensinnig
herzlich	ADJD	1	herzlich
eindringen	VVINF	1	eindringen
Theater	NN	1	Theater
Appetit	NN	1	Appetit
gestehen	VVINF	1	gestehen
Bruder	NN	1	Bruder
Gute	NN	1	Gutes
unterstehen	VVINF	1	unterstehen
Unrecht	NN	1	Unrecht
Liebhaber	NN	1	Liebhaber
Ehestand	NN	1	Ehestand
Franzose	NN	1	Franzosen
Ort	NN	1	Orte
Kräusel	NN	1	Kräusel
zuziehen	VVFIN	1	zuzieht
verschwendrischen	ADJA	1	verschwendrischen
Benennung	NN	1	Benennung
Schuldhausen	NN	1	Schuldhausen
Dingergen	NN	1	Dingergen
Wasser	NN	1	Wasser
annehmen	VVINF	1	annehmen
unbekümmert	ADJD	1	unbekümmert
Überfluss	NN	1	Überflusse
vorig	ADJA	1	vorige
Türe	NN	1	Türe
fliehen	VVFIN	1	floh
Schlingel	NN	1	Schlingel
michs	NE	1	michs
Herz	NN	1	Herzen
ergeben	ADJA	1	Ergebene
Worinne	NN	1	Worinne
bange	ADJD	1	bange
Verlangen	NN	1	Verlangen
30	CARD	1	30
besitzen	VVFIN	1	besitze
Hochzeitcarmen	NN	1	Hochzeitcarmen
mythologisch	ADJA	1	mythologischem
schalkhaft	ADJD	1	schalkhaft
hurtig	ADJA	1	hurtiger
Erzürne	VVFIN	1	Erzürne
übertreffen	VVPP	1	übertroffen
stören	VVINF	1	stören
vorstellen	VVPP	1	vorgestellt
übern	APPRART	1	übern
Sapienti	NN	1	Sapienti
Anspruch	NN	1	Anspruch
voll	ADJD	1	voll
Mühe	NN	1	Mühe
verlieben	VVPP	1	verliebt
Anstalt	NN	1	Anstalt
fernern	ADJA	1	fernern
Finger	NN	1	Finger
Tatze	NN	1	Tatzen
quaerunt	VVFIN	1	quaerunt
schaden	VVFIN	1	schadet
wertesten	ADJA	1	wertesten
hartnäckig	ADJD	1	hartnäckig
niederträchtig	ADJA	1	niederträchtige
Hut	NN	1	Hut
nütze	ADV	1	nütze
darum	PAV	1	darum
Madame	NN	1	Madame
wertester	ADJA	1	wertester
Feld	NN	1	Felde
Offizier	NN	1	Offizier
Land	NN	1	Länder
worüber	PWAV	1	worüber
widersetzen	VVINF	1	widersetzen
Universalerbe	NN	1	Universalerbe
hingehn	ADJD	1	hingehn
Hörest	VVFIN	1	Hörest
verschonen	VVPP	1	verschont
Angriff	NN	1	Angriff
bedauren	NN	1	bedauren
Gut	NN	1	Gut
Adel	NN	1	Adel
lachend	ADJA	1	lachende
Annehmlichkeit	NN	1	Annehmlichkeiten
Erbe|Erben	NN	1	Erben
Madam	NN	1	Madam
munter	ADJA	1	muntern
begreifen	VVFIN	1	begreife
Lied	NN	1	Lieder
Text	NN	1	Text
anderswo	ADV	1	anderswo
erschlagen	VVFIN	1	erschlage
trotz	APPR	1	trotz
bekümmern	VVFIN	1	bekümmern
unmöglich	ADJD	1	Unmöglich
laß	ADJD	1	Laß
Männersucht	NN	1	Männersucht
vergraben	VVPP	1	vergraben
Sachse	NN	1	Sachsen
Leutchen	NN	1	Leutchen
tummeln	VVINF	1	tummeln
beitragen	VVPP	1	beigetragen
belieben	VVINF	1	belieben
lammen	ADJD	1	lammen
Zahn	NN	1	Zähne
vergessen	VVPP	1	vergessen
Sara	NE	1	Sara
Krame	NN	1	Krame
zumal	KOUS	1	Zumal
Erwägung	NN	1	Erwägung
zielen	VVFIN	1	ziele
Korbe	NN	1	Korbe
widerrufst	VVFIN	1	widerrufst
fortpflanzen	VVINF	1	fortpflanzen
gekrönt	ADJA	1	gekrönten
spitzbübisch	ADJD	1	spitzbübisch
hoffen	VVFIN	1	hoffe
merken	VVFIN	1	merkt
ehrliebender	ADJA	1	ehrliebender
rasend	ADJD	1	rasend
Meisterstück	NN	1	Meisterstück
Zuckerlecken	NN	1	Zuckerlecken
willens	ADJD	1	willens
einig	ADJD	1	einig
verfertiget	VVFIN	1	verfertiget
grob	ADJA	1	grobes
Bettler	NN	1	Bettler
Schuh	NN	1	Schuh
Tanz	NN	1	Tänze
überheben	VVFIN	1	überheben
Laus	NN	1	Laus
wegkommen	VVFIN	1	wegkomme
vorenthalten	VVPP	1	vorenthalten
dreimal	ADV	1	dreimal
Vorschlag	NN	1	Vorschläge
nötigen	VVFIN	1	nötigen
Unwissenheit	NN	1	Unwissenheit
Probe	NN	1	Probe
Poesie	NN	1	Poesie
Übergang	NN	1	Übergänge
Menge	NN	1	Menge
abgedankt	ADJA	1	abgedankten
Monat	NN	1	Monaten
ausgäbst	VVFIN	1	ausgäbst
Täubchen	NN	1	Täubchen
Nachbarschaft	NN	1	Nachbarschaft
Trost	NN	1	Trost
verzählen	VVPP	1	verzählt
Jawort	NN	1	Jawort
16	CARD	1	16
Gutheit	NN	1	Gutheit
Wille	NN	1	Wille
Alter	NN	1	Alter
ältern	VVINF	1	ältern
Antwort	NN	1	Antwort
Rekompenz	NN	1	Rekompenz
abgewinnen	VVPP	1	abgewonnen
gesund	ADJD	1	gesund
tragen	VVINF	1	tragen
Sinn	NN	1	Sinne
entkommen	VVINF	1	entkommen
17	CARD	1	17
eingeständig	ADJD	1	eingeständig
diejenigen	PDAT	1	diejenigen
Holländer	NN	1	Holländern
Grube	NN	1	Grube
neumodisch	ADJA	1	neumodische
bunt	ADJD	1	bunt
Flegel	NN	1	Flegel
Motion	NN	1	Motion
Geschmacke	NN	1	Geschmacke
antreffen	VVINF	1	antreffen
not	PTKVZ	1	not
irre	PTKVZ	1	irre
erzeugen	VVFIN	1	erzeugt
Woche	NN	1	Woche
geschehn	VVFIN	1	geschehn
Titel	NN	1	Titel
rechtschaffner	ADJA	1	rechtschaffner
erwerben	VVPP	1	erworben
Tändelei	NN	1	Tändelei
verliebt	ADJA	1	verliebte
Neidische	NN	1	Neidische
Dero	NE	1	Dero
bedeuten	VVINF	1	bedeuten
Ermunterung	NN	1	Ermunterung
Bessers	NN	1	Bessers
Aufsetzerin	NN	1	Aufsetzerin
Spitzenmanne	NN	1	Spitzenmanne
aufsetzen	VVPP	1	aufgesetzt
Lumpenhund	NN	1	Lumpenhund
bessern	VVINF	1	bessern
Mut	NN	1	Mut
appetitlich	ADJA	1	Appetitliche
anhängen	VVINF	1	anhängen
ablaufen	VVINF	1	ablaufen
Arm|Arme	NN	1	Arme
Gehn	VVFIN	1	Gehn
Henne	NN	1	Henne
allzuviel	PIS	1	allzuviel
schimpfen	VVINF	1	schimpfen
Gefahr	NN	1	Gefahr
kommend	ADJA	1	kommende
Affengesichte	NN	1	Affengesichte
Beispiel	NN	1	Beispiele
Reichtum	NN	1	Reichtum
Ordnung	NN	1	Ordnung
probieren	VVPP	1	probiert
Hahn	NN	1	Hahn
Österreicher	NN	1	Österreichern
Vaterland	NN	1	Vaterland
Prozent	NN	1	Prozent
verruckt	ADJD	1	verruckt
hochadliches	ADJA	1	hochadliches
herankriechen	VVFIN	1	herankriechen
betriegen	VVFIN	1	betriegen
reißen	VVFIN	1	reißt
unbekannt	ADJA	1	unbekannter
Köpfchen	NN	1	Köpfchen
bekennen	VVFIN	1	bekennen
Ware	NN	1	Ware
Reden	NN	1	Redens
frei	PTKVZ	1	frei
Kapitel	NN	1	Kapitel
Bauch	NN	1	Bauch
geheim	ADJD	1	geheim
Muster	NN	1	Muster
bißgen	NN	1	bißgen
24.	ADJA	1	24.
Erstlich	ADJD	1	Erstlich
allzuwohl	ADJD	1	allzuwohl
Mus|Muse	NN	1	Musen
kaum	ADV	1	kaum
umhängen	VVINF	1	umhängen
Kätz	NN	1	Kätz
theologisch-polemisch-poetischen	ADJA	1	theologisch-polemisch-poetischen
Licht	NN	1	Licht
ertragen	VVINF	1	ertragen
Brot	NN	1	Brote
verstellen	VVPP	1	verstellt
Abschied	NN	1	Abschied
Kunst	NN	1	Kunst
kömmst	VVFIN	1	kömmst
zufrieden	ADJD	1	zufrieden
angehen	VVFIN	1	angeht
fallen	VVFIN	1	falle
vorläufig	ADJD	1	vorläufig
Betrieb	NN	1	Betrieb
zittre	ADJD	1	zittre
dahinter	PAV	1	Dahinter
Vorrecht	NN	1	Vorrecht
22	CARD	1	22
geschieden	ADJA	1	geschiedene
zukünftig	ADJA	1	zukünftigen
Verkleidung	NN	1	Verkleidung
darnach	ADV	1	darnach
Schalkhaften	NN	1	Schalkhaften
Quere	NN	1	Quere
beschlagen	VVPP	1	beschlagen
einen	ADJA	1	einen
einziehen	VVPP	1	eingezogen
Topp	NN	1	Topp
währen	VVINF	1	währen
gedenken	VVFIN	1	gedenke
vorgehen	VVFIN	1	vorgeht
ausführen	VVINF	1	ausführen
scherzen	VVINF	1	scherzen
sonderlich	ADJD	1	Sonderlich
dahin	PAV	1	dahin
Geplaudre	NN	1	Geplaudre
Freigeist	NN	1	Freigeister
erkundigen	VVINF	1	erkundigen
Capitains	NN	1	Capitains
derselb	PDAT	1	desselben
Post	NN	1	Post
Närrin	NN	1	Närrin
vorteilhaft	ADJA	1	vorteilhafte
Wette|Wetten	NN	1	Wetten
Omen	NN	1	Omen
Zettel	NN	1	Zettel
heiß	ADJD	1	heiß
lüderlichen	ADJA	1	lüderlichen
Clarice	NE	1	Clarice
unterlassen	VVINF	1	unterlassen
Prügel	NN	1	Prügel
bedenken	VVFIN	1	bedenkst
nackigte	ADJA	1	nackigte
Sachte	NN	1	Sachte
einerlei	ADV	1	einerlei
nahe	PTKVZ	1	nahe
Laster	NN	1	Laster
schamhaft	ADJD	1	schamhaft
nutzen	VVINF	1	nutzen
verraten	VVPP	1	verraten
jetzig	ADJA	1	jetziger
galant	ADJA	1	galante
19	CARD	1	19
freuen	VVFIN	1	Freuen
adliches	ADJA	1	adliches
Nichtswürdiger	NN	1	Nichtswürdiger
Ehekrüpel	NN	1	Ehekrüpel
sechs	CARD	1	sechs
Verrichtung	NN	1	Verrichtungen
unterdessen	ADV	1	unterdessen
Vortreffliches	NN	1	Vortreffliches
Bedingung	NN	1	Bedingungen
herumspringen	VVINF	1	herumspringen
Närrchen	NN	1	Närrchen
Bürger	NN	1	Bürger
Holla	NE	1	Holla
einbilden	VVINF	1	einbilden
lebendig	ADJD	1	lebendig
Tasche	NN	1	Tasche
neulich	ADV	1	neulich
überraschen	VVPP	1	überrascht
einfinden	VVINF	1	einfinden
schamrot	ADJD	1	schamrot
Käse	NN	1	Käse
Belieben	NN	1	Belieben
ichs	ADJA	1	ichs
Zorn	NN	1	Zorn
Bediente	NN	1	Bedienten
leugnen	VVINF	1	leugnen
hochöchst	ADJD	1	höchst
Müßiggänger	NN	1	Müßiggänger
Rechthaberin	NN	1	Rechthaberin
beklagen	VVINF	1	beklagen
Mutter	NN	1	Mutter
Reifrock	NN	1	Reifrock
Arbeit	NN	1	Arbeit
Naschmaul	NN	1	Naschmaul
zärtlich	ADJA	1	zärtliche
dünken	VVFIN	1	dünkt
Grille|Grillen	NN	1	Grillen
betrügen	VVINF	1	betrügen
unrecht	ADJD	1	unrecht
lebhaft	ADJA	1	lebhafte
Adlicher	NN	1	Adlicher
Erzeigen	VVFIN	1	Erzeigen
Cabinetstückchen	VVFIN	1	Cabinetstückchen
ansehnlich	ADJA	1	ansehnlichen
Tochter	NN	1	Tochter
schreien	VVFIN	1	schreit
Adlichen	NN	1	Adlichen
Intressen	NN	1	Intressen
überirdisch	ADJA	1	überirdische
verdienen	VVPP	1	verdient
zieren	VVFIN	1	ziert
Brunette	NN	1	Brunette
scribentis	NN	1	scribentis
Ton	NN	1	Ton
Erinnern	NN	1	Erinnern
strafbar	ADJD	1	strafbar
seufzet	VVFIN	1	seufzet
Verächter	NN	1	Verächter
Bene	NE	1	Bene
Geldborgern	NN	1	Geldborgern
Welt	NN	1	Welt
wunderbar	ADJD	1	wunderbar
unsinnig	ADJA	1	unsinniges
Säkulum	NN	1	Säkulum
führen	VVINF	1	führen
uneben	ADJD	1	uneben
Hören	NN	1	Hören
Schluss	NN	1	Schlusse
Anno	NE	1	Anno
umsonst	ADV	1	umsonst
unverständiger	ADJA	1	unverständiger
fünfhundert	CARD	1	fünfhundert
hats	NN	1	hats
Erklärung	NN	1	Erklärung
schenken	VVPP	1	geschenkt
König	NN	1	König
frisch	ADJD	1	Frisch
Gewohnheit	NN	1	Gewohnheit
jungüngst	ADJD	1	jüngst
otia	NE	1	otia
Plunder	NN	1	Plunder
Äußere	NN	1	Äußere
Kundmann	NN	1	Kundmann
Forderung	NN	1	Forderungen
Ärgste	NN	1	Ärgste
widerstehen	VVFIN	1	Widerstehen
seit	APPR	1	seit
abend	ADV	1	Abend
aufschlagen	VVPP	1	aufgeschlagen
Wenns	ADJD	1	Wenns
Betrügerei	NN	1	Betrügerei
hinterlassen	VVFIN	1	hinterläßt
Großmut	NN	1	Großmut
klug	ADJD	1	klug
Taufschein	NN	1	Taufschein
wässrig	ADJD	1	wäßrig
unzähligmal	ADV	1	unzähligmal
Hindernis	NN	1	Hindernis
Schelm	NN	1	Schelm
Lehre	NN	1	Lehre
obgleich	KOUS	1	Obgleich
hervortun	VVFIN	1	hervortut
Ausnahme	NN	1	Ausnahme
Lächerliche	NN	1	Lächerliches
weisen	VVFIN	1	Weise
Eheteufel	NN	1	Eheteufel
Blut	NN	1	Blut
mitteilen	VVIZU	1	mitzuteilen
Betteldorf	NN	1	Betteldorf
anfangen	VVIZU	1	anzufangen
schämen	VVFIN	1	Schämen
gelb	ADJA	1	gelber
ausweisen	VVINF	1	ausweisen
redst	ADJD	1	redst
90	CARD	1	90
Nebenzimmer	NN	1	Nebenzimmer
gefallen	VVFIN	1	Gefiel
kaiserlich	ADJA	1	kaiserliche
treiben	VVINF	1	treiben
irrest	VVFIN	1	irrest
Tochtermann	NE	1	Tochtermann
Schwanz	NN	1	Schwanze
manchmal	ADV	1	manchmal
sollens	VVFIN	1	sollens
fangen	VVFIN	1	fängst
glühend	ADJA	1	glühende
einst	ADV	1	einst
Zeile	NN	1	Zeile
diese	PDS	1	dieses
Ecke	NN	1	Ecke
allzusehr	VVFIN	1	allzusehr
Wache	NN	1	Wache
fallen|fällen	VVFIN	1	fällt
kriegerisch	ADJA	1	kriegerische
Geschicklichkeit	NN	1	Geschicklichkeit
versichern	VVFIN	1	versichere
achtzig	CARD	1	achtzig
verhasst	ADJD	1	verhaßt
zerfallen	VVPP	1	zerfallen
bemächtige	VVFIN	1	bemächtige
Falsche	NN	1	Falsche
Kellertür	NN	1	Kellertür
nützlich	ADJA	1	nützlicher
Kennzeichen	NN	1	Kennzeichen
Hitze	NN	1	Hitze
aufsuchen	VVPP	1	aufgesucht
aushelfen	VVPP	1	ausgeholfen
Umstand	NN	1	Umstände
Stoff	NN	1	Stoff
Entschließung	NN	1	Entschließungen
mans	ADJD	1	mans
entbehren	VVINF	1	entbehren
allezeit	ADV	1	allezeit
Glücke	NN	1	Glücke
herkommen	VVINF	1	herkommen
vergebens	ADV	1	vergebens
Katze	NN	1	Katze
untüchtig	ADJD	1	untüchtig
Dokument	NN	1	Dokumente
Ursache	NN	1	Ursache
zerlappte	ADJA	1	zerlappte
stinken	VVFIN	1	stinken
Ernsthafte	NN	1	Ernsthaften
Schaden	NN	1	Schaden
beschwerst	VVFIN	1	beschwerst
ungemein	ADJD	1	ungemein
Stoß	NN	1	Stoß
Zank	NN	1	Zank
teuer	ADJD	1	teuer
Wahrheit	NN	1	Wahrheit
Unwille	NN	1	Unwillen
beiderseits	APPR	1	beiderseits
erschrecken	VVFIN	1	Erschrak
Werk	NN	1	Werk
zusammen	PTKVZ	1	zusammen
Gesellschaftliche	NN	1	Gesellschaftliche
Grobheit	NN	1	Grobheit
walten	VVINF	1	walten
Schweig	NE	1	Schweig
erlösen	VVINF	1	erlösen
Sprung	NN	1	Sprünge
Schafbock	NN	1	Schafbock
abkaufen	VVPP	1	abgekauft
hinters	APPRART	1	hinters
Ohrfeige	NN	1	Ohrfeige
einfallen	VVINF	1	einfallen
Verbeugung	NN	1	Verbeugung
scherzhaftem	ADJA	1	scherzhaftem
eitel	ADJD	1	eitel
beteuren	NN	1	beteuren
Gefangen	NN	1	Gefangen
Ding	NN	1	Ding
Engländer	NN	1	Engländern
Fromme	NN	1	Frommen
Creditoren	NN	1	Creditoren
verewiget	VVFIN	1	verewiget
Vorhaben	NN	1	Vorhaben
Erlaubnis	NN	1	Erlaubnis
Nichtswitz	NN	1	Nichtswitz
Willkommen	NN	1	Willkommen
Menuet	NN	1	Menuet
Anstiften	NN	1	Anstiften
wild	ADJA	1	wilder
Creditores	NN	1	Creditores
krank	ADJD	1	krank
gewöhnen	VVPP	1	gewöhnt
Hoffnung	NN	1	Hoffnung
Rolle	NN	1	Rolle
überhören	VVINF	1	überhören
ausschlafen	VVPP	1	ausgeschlafen
beneidenswert	ADJD	1	beneidenswert
längst	ADV	1	längst
Nam	NE	1	Nam
gehören|hören	VVPP	1	gehört
Dichter	NN	1	Dichter
Klügste	NN	1	Klügste
Besuch	NN	1	Besuch
ändern	VVINF	1	ändern
Krankheit	NN	1	Krankheit
wievielste	ADJA	1	wievielste
Hausrat	NN	1	Hausrat
beweisen	VVINF	1	beweisen
Brücke	NN	1	Brücke
wenden	VVFIN	1	Wenden
Christi	NE	1	Christi
Mund	NN	1	Mund
Lauf	NN	1	Lauf
verzeihen|verziehen	VVFIN	1	Verziehen
zehnt	ADJA	1	zehnte
eigennützig	ADJD	1	eigennützig
Held	NN	1	Helden
Körper	NN	1	Körper
gehörig	ADJA	1	gehörige
beschreiben	VVINF	1	beschreiben
sat	VVFIN	1	sat
Ehrfurcht	NN	1	Ehrfurcht
schalten	VVINF	1	schalten
Rekommendation	NN	1	Rekommendation
andermal	ADV	1	andermal
Schande	NN	1	Schande
Stich	NN	1	Stich
satyrischem	ADJA	1	satyrischem
fürstlich	ADJA	1	fürstliche
zuzählen	VVPP	1	zugezählt
nie	ADV	1	nie
anmelden	VVPP	1	angemeldet
jetzo	ADJD	1	jetzo
Knebelbart	NN	1	Knebelbart
Kaffeehause	NN	1	Kaffeehause
gebührend	ADJA	1	gebührende
fressen	VVFIN	1	frißt
dreien	CARD	1	dreien
Schämen	NN	1	Schämen
beschäftiget	VVFIN	1	beschäftiget
erschaffen	VVPP	1	erschaffen
anderwärts	ADV	1	anderwärts
Anteil	NN	1	Anteil
majestätisch	ADJA	1	majestätischer
Moral	NN	1	Moral
Garten	NN	1	Garten
Leutgen	VVFIN	1	Leutgen
Kriegsmann	NN	1	Kriegsmann
Schätzchen	NN	1	Schätzchen
just	ADV	1	just
Streit	NN	1	Streit
wohlgetroffenen	ADJA	1	wohlgetroffenen
verfluchen	VVPP	1	verflucht
poetisch	ADJD	1	poetisch
herrschen	VVFIN	1	herrscht
Gerichtsherr	NN	1	Gerichtsherr
Erb-	TRUNC	1	Erb-
Anweisung	NN	1	Anweisung
dahinten	ADV	1	dahinten
adlichem	ADJA	1	adlichem
Vater	NN	1	Vaters
unten	ADV	1	unten
Achsel	NN	1	Achsel
Herausgehen	NN	1	Herausgehen
vertrösten	VVINF	1	vertrösten
sitzen	VVFIN	1	sitzen
Anderns	ADV	1	Anderns
einbringen	VVFIN	1	einbringt
Consequens	NE	1	Consequens
Kohle	NN	1	Kohlen
parat	ADJD	1	parat
Feldzuge	NN	1	Feldzuge
Weibchen	NN	1	Weibchen
Oronten	VVFIN	1	Oronten
Männchen	NN	1	Männchen
sechzehn	CARD	1	sechzehn
drittens	ADV	1	Drittens
Naturlehre	NN	1	Naturlehre
erkenntlich	ADJD	1	erkenntlich
Dutzend	NN	1	Dutzend
faul	ADJA	1	faulen
Schamröte	NN	1	Schamröte
beschweren	VVINF	1	beschweren
beißend	ADJA	1	beißenden
darbieten	VVFIN	1	darbiete
Schwäger	NN	1	Schwäger
Beredsamkeit	NN	1	Beredsamkeit
geschickt	ADJD	1	geschickt
verwünscht	ADJA	1	verwünschte
drucken	VVINF	1	drucken
Vogel	NN	1	Vogel
nachkommen	VVINF	1	nachkommen
blühend	ADJA	1	blühenden
Profession	NN	1	Profession
Armingen	NN	1	Armingen
Schuldmann	NN	1	Schuldmann
leidig	ADJA	1	leidige
schwarz	ADJA	1	schwarzer
ehlichen	ADJA	1	ehlichen
mannbar	ADJA	1	mannbare
Apfel	NN	1	Apfel
allenfalls	ADV	1	allenfalls
Zufall	NN	1	Zufall
Recht	NN	1	Recht
Montierung	NN	1	Montierung
mannhaft	ADJD	1	mannhafter
bloß	ADJD	1	Bloß
handeln	VVINF	1	handeln
Satire	NN	1	Satiren
Bemühen	NN	1	Bemühen
hinter	APPR	1	hinter
verderbst	VVFIN	1	verderbst
Miseriam	NE	1	Miseriam
drücken	VVFIN	1	drückt
Böhmen	NE	1	Böhmen
zwölft	ADJA	1	zwölfte
Ewr	NE	1	Ewr
davor	PAV	1	davor
wegnehmen	VVINF	1	wegnehmen
hinbegeben	VVINF	1	hinbegeben
Drolligtes	NN	1	Drolligtes
naschen	VVFIN	1	nascht
bemühen	VVINF	1	bemühen
Quark	NN	1	Quark
verziehen	VVINF	1	verziehen
stiften	VVPP	1	gestiftet
Geschwister	NN	1	Geschwister
gönnen	VVFIN	1	gönne
wetten	VVFIN	1	wetten
einräumen	VVINF	1	einräumen
Maus	NN	1	Maus
gegenen	ADJA	1	gegenen
Beschimpfung	NN	1	Beschimpfung
Ratschlag	NN	1	Ratschlägen
leiden	VVINF	1	leiden
hitzig	ADJD	1	hitzig
englisch	ADJA	1	englisches
oben	ADV	1	oben
fragen	VVINF	1	fragen
drollichter	ADJD	1	drollichter
Vorsehung	NN	1	Vorsehung
nötig	ADJD	1	nötig
Genug	NN	1	Genug
Gefallen	NN	1	Gefallen
Schlesien	NE	1	Schlesien
gebrauchen	VVINF	1	gebrauchen
Allusion	NN	1	Allusion
Einwilligung	NN	1	Einwilligung
dulden	VVINF	1	dulden
stückweise	ADJD	1	stückweise
gestrig	ADJA	1	gestrige
vollens	ADV	1	vollens
verfließen	VVPP	1	verflossen
denken|gedenken	VVPP	1	gedacht
anschreiben	VVPP	1	angeschrieben
erlauben	VVINF	1	erlauben
eins	CARD	1	eins
Komödie	NN	1	Komödie
Bildung	NN	1	Bildung
Gefälligkeit	NN	1	Gefälligkeit
Ernst	NN	1	Ernst
verfahren	VVPP	1	verfahren
eh	ADV	1	Eh
secessum	ADJA	1	secessum
aussinnen	VVPP	1	ausgesonnen
Entzückung	NN	1	Entzückung
Injurie	NN	1	Injurie
Gulden	NN	1	Gulden
stark	ADJD	1	stark
vorbringen	VVFIN	1	vorbringt
los	ADJA	1	Loser
göttlich	ADJA	1	göttlichen
Raserei	NN	1	Raserei
Zweck	NN	1	Zweck
hübsch	ADJD	1	hübsch
Topf	NN	1	Töpfen
Machts	NN	1	Machts
ohnedem	ADJD	1	ohnedem
Plappermaul	NN	1	Plappermaul
mannbares	ADJA	1	mannbares
Gemütsart	NN	1	Gemütsart
seh	XY	1	seh
schweigen	VVIMP	1	Schweig
erlangen	VVPP	1	erlangt
neutral	ADJD	1	neutral
Anfall	NN	1	Anfällen
eingehen	VVINF	1	eingehen
bezeigen	VVINF	1	bezeigen
Bauer	NE	1	Bauer
Darinne	NN	1	Darinne
Betragen	NN	1	Betragen
stürmisch	ADJD	1	stürmisch
Gold	NN	1	Golde
Diener	NN	1	Diener
gesehn	VVFIN	1	gesehn
Traktat	NN	1	Traktaten
leicht	ADJA	1	leichte
Reihe	NN	1	Reihen
500	CARD	1	500
dringend	ADJD	1	dringend
zweifeln	VVFIN	1	Zweifelst
Eheleute	NN	1	Eheleute
wohlgewachsenen	ADJA	1	wohlgewachsenen
fluchen	VVFIN	1	flucht
Frauenzimmers	NN	1	Frauenzimmers
willen	APPO	1	willen
erinnern	VVINF	1	erinnern
vors	APPRART	1	vors
Valer	NE	1	Valer
unterbringen	VVFIN	1	unterbringe
am	PTKA	1	am
Ehemann	NN	1	Ehemänner
verführst	VVFIN	1	verführst
kleiden	VVPP	1	gekleidet
ekeln	VVIMP	1	ekel
Freiersmann	NN	1	Freiersmann
Judas	NE	1	Judas
heben	VVFIN	1	hebt
goldnes	ADJA	1	goldnes
historisch	ADJA	1	historischem
Antecedens	NN	1	Antecedens
wacker	ADJD	1	wacker
pfui	ITJ	1	Pfui
erteilen	VVPP	1	erteilt
gelinde	ADJD	1	gelinder
unerträglich	ADJD	1	unerträglich
süß	ADJA	1	süße
lärmen	VVFIN	1	lärmen
Gewissers	NN	1	Gewissers
Edelmannen	NN	1	Edelmannen
hölzern	ADJA	1	hölzerne
Partie	NN	1	Partie
Blick	NN	1	Blicke
Anlass	NN	1	Anlaß
Beschwerlichkeiten	NN	1	Beschwerlichkeiten
Untüchtig	ADJD	1	Untüchtig
gelegnerer	ADJA	1	gelegnerer
Fleischerhund	NN	1	Fleischerhund
Hauptpunkt	NN	1	Hauptpunkten
gesagt	ADJD	1	gesagt
leisten	VVINF	1	leisten
unhöflich	ADJD	1	unhöflich
beiseite	PTKVZ	1	beiseite
Lehn-	TRUNC	1	Lehn-
zugreifen	VVINF	1	zugreifen
Musae	NN	1	Musae
Versehn	NN	1	Versehn
Lust	NN	1	Lust
gibts	NN	1	gibts
singen	VVPP	1	gesungen
