Title: Minna von Barnhelm, oder das Soldatenglück
Number of all lemmas: 8891
Nummber of different lemmas: 2687

Lemma	POS	Frequency	Tokens
Herr	NN	245	Herrn, Herr, Herren
Fräulein	NN	155	Fräulein, Fräuleins
Major	NN	139	Major, Majors
gut	ADJA, ADJD	116	Guten, guten, gut, Gut, besser, guter, beste, Guter, gute, besten, gutes, besseres
Mann	NN, NE	94	Mann, Manne, Mannes, Männer, Manns, Männern
sagen	VVINF, VVFIN, VVPP, VVIMP	90	sagen, Sage, sage, sagt, gesagt, sagte, sagten, sag, sagst, Sagen, Sag
wohl	ADV	83	wohl, Wohl
Franziska	NE	79	Franziska
hören	VVFIN, VVINF, VVIMP	77	hörte, Höre, hört, höre, hörst, hören, Hören, Hör, hör, Hörst, hörten, höret
gnädig	ADJA	77	gnädiger, gnädige, gnädiges, gnädigen, Gnädiges
Tellheim	NN	77	Tellheim, Tellheims
wissen	VVFIN, VVINF	74	wüßte, weiß, wissen, Wissen, Weiß, wußte, wüßten
sehen	VVIMP, VVFIN, VVINF, VVPP	65	sieh, Sieht, sehen, siehst, Siehst, Sieh, sehe, sieht, sah, sähe, gesehen, Sehen, Seht
Wirt	NN	57	Wirte, Wirt, Wirts
lieb	ADJA, ADJD	51	Lieber, lieb, lieber, liebe, liebste, lieben, liebsten
Ring	NN	51	Ring, Ringe, Ringes
nehmen	VVFIN, VVINF, VVIMP, VVPP	49	nimmt, nehmen, Nehmen, nimm, nehme, Nimm, nahm, nahmen, Nimmt, genommen
Geld	NN	47	Geld, Gelde, Gelder
kennen	VVFIN, VVIMP, VVINF, VVPP	41	kennen, Kennst, kenn, kennst, kennt, Kennen, kenne, gekannt, kannte, kennte, kennten
Just	NE	40	Just
Minna	NE	40	Minna
schön	ADJA, ADJD	40	schönen, schöne, schön, schönes, schönsten, Schön
Werner	NE	40	Werner
lieben	VVFIN, VVPP, VVINF	37	liebe, lieben, geliebt, liebt, Lieben, liebte, liebet
Ihro	NN, NE	36	Ihro
Wachtmeister	NN	34	Wachtmeister
Hand	NN	33	Händen, Hand, Hände
denken	VVFIN, VVINF, VVIMP	33	Denke, dächte, denken, dachte, denke, denkt, denkst, denk, Denken
eben	ADV	33	Eben, eben
gewiss	ADJD, ADJA	31	gewiß, Gewiß, gewisse, gewisses, gewissen
Frauenzimmerchen	NN	31	Frauenzimmerchen
Ehre	NN	31	Ehre
Kind	NN	29	Kind, Kinder
Freund	NN, NE	29	Freund, Freundes, Freunde
allein	PTKVZ, ADV	28	allein, Allein
unser	PPOSAT	27	unsers, Unsere, unserer, Unser, unsrer, unserm, unser, Unserer, unsere
gar	ADV	27	gar
gern	ADV	27	gern
glauben	VVFIN, VVINF, VVPP, VVIMP	27	glaube, glauben, glaubte, geglaubt, Glaub, glaubt
recht	ADJD, ADJA	26	recht, Recht, rechter
erst	ADV, ADJA	25	erst, erste, ersten, Erst
schuldig	ADJD	25	schuldig
wenige	PIS, PIAT	25	wenig, wenigen, weniger
Unglück	NN	25	Unglücks, Unglück, Unglücke
Brief	NN	25	Brief, Briefe
brauchen	VVFIN, VVINF, VVIMP	24	brauchte, brauchen, brauchst, brauche, braucht, brauch
kömmt	VVFIN, ADJD	24	kömmt
wahr	ADJD, ADJA	23	wahr, wahres, wahre
lesen	VVFIN, VVINF, VVPP, VVIMP	23	liest, lesen, gelesen, Lesen, Lies
glücklich	ADJA, ADJD	23	glückliche, glücklich, glücklichen, glücklicher, glücklichsten, glückliches
Gnade	NN	23	Gnaden, Gnade
finden	VVFIN, VVPP, VVINF	23	fand, gefunden, finden, finde, findet, fände, fanden
suchen	VVINF, VVFIN, VVPP	23	suchen, sucht, Suchen, suche, suchte, suchten, gesucht, suchst
vergessen	VVINF, VVPP, VVFIN	22	vergessen, Vergessen
unglücklich	ADJA, ADJD	22	unglücklicher, unglücklichen, unglückliche, unglücklich, Unglücklicher
Herz	NN	21	Herz, Herzen, Herzens
Auge	NN	21	Auge, Augen
bezahlen	VVINF, VVPP, VVFIN	20	bezahlen, bezahlt, bezahle, Bezahle
de	NE, FM	20	de
ah	ITJ	20	Ah
Zimmer	NN	20	Zimmer, Zimmers
Liebe	NN	20	Liebe, Lieber
Mademoiselle	NN	19	Mademoiselle
Dienst	NN	19	Diensten, Dienst, Dienste
hundert	CARD	18	hundert, Hundert
bitten	VVFIN, VVINF	18	bitte, bitten
geschwind	ADJD	18	Geschwind, geschwind
Taler	NN	17	Taler
verstehen	VVFIN, VVINF, VVIMP, VVPP	17	verstehe, verstehen, Versteh, versteht, versteh, verstanden, verstehst
groß	ADJA, ADJD	17	großen, Großen, große, groß, großer
Offizier	NN	17	Offizier, Offiziere, Offizieren
Welt	NN	17	Welt
Gnad	NN	16	Gnad
Tag	NN	16	Tag, Tagen, Tage, Tages
ehrlich	ADJA, ADJD	16	ehrlichen, ehrlicher, ehrliche, ehrlichste, ehrlich, ehrliches
Glück	NN	16	Glück, Glücks
sonst	ADV	16	sonst, Sonst
Mensch	NN	16	Mensch, Menschen
Mädchen	NN	15	Mädchen, Mädchens
weiter	PTKVZ, ADV	15	weiter
heißen	VVFIN, VVINF	15	heißt, heißen, heiße
Wort	NN	15	Wort, Worte
reden	VVFIN, VVINF, VVPP	15	Reden, redest, redet, reden, rede, Rede, geredet, Redet
le	ADJA, VVFIN	15	le
freilich	ADV	15	Freilich, freilich
Haus	NN	15	Haus, Hause
genug	ADV	14	Genug, genug
nie	ADV	14	nie
vielleicht	ADV	14	Vielleicht, vielleicht
arm	ADJA, ADJD	14	armen, Armes, arme, ärmer, arm
lang	ADJD, ADJA	14	länger, lang, langer, längste, lange
Finger	NN	14	Finger, Fingern
que	VVFIN, ADJA, NN	14	que
stehen	VVINF, VVFIN, VVIMP	14	stehen, stehet, stehe, steht, standen, stand, steh
ha	NE, ITJ, NN	14	ha, Ha
Barnhelm	NN	13	Barnhelm
wider	APPR	13	wider
ik	ADJA, ADJD	13	ik
Zeit	NN	13	Zeit, Zeiten
Ha	NE	13	Ha
Pistole	NN	13	Pistolen
Soldat	NN	13	Soldat, Soldaten
Name	NN	13	Name, Namen
Sache	NN	13	Sachen, Sache
nit	ADJD, ADJA	13	nit
darum	PAV	13	darum, Darum
nennen	VVFIN, VVINF, VVIMP	13	nennt, nennen, nenne, nenn
Herrschaft	NN	13	Herrschaft
mik	NN, ADJA, ADJD, NE	13	mik
Ik	ADJD, NE, ADJA, VVPP, VVINF	12	Ik
schreiben	VVPP, VVINF, VVFIN	12	geschrieben, schreiben, schreibt, schrieb, Schreibt, schrieben
fehlen	VVFIN, VVINF	12	fehlt, fehlte, fehlen
spielen	VVINF, VVFIN, VVIMP	12	spielen, spiel, spiele
verzeihen	VVFIN, VVINF, VVIMP	12	verzeihen, Verzeihen, Verzeih, verzeih
heute	ADV	12	heute, Heute, Heut
Vous	NN, NE	12	Vous
Seele	NN	12	Seele
la	FM	12	la
setzen	VVINF, VVFIN, VVIMP	12	setzen, setzet, setzte, setzt, setz
Krieg	NN	12	Kriege, Krieg, Krieges
versetzen	VVFIN, VVINF, VVPP	11	Versetze, versetzen, versetzt, Versetzt
wahrhaftig	ADJD	11	Wahrhaftig, wahrhaftig
er|es	PPER	11	Ihm
Augenblick	NN	11	Augenblicke, Augenblick
klein	ADJD, ADJA	11	klein, kleinen, kleines, kleine, kleiner
gehn	VVFIN, VVPP, ADJD, VVINF	11	gehn
Sachsen	NE	11	Sachsen
fort	ADV, PTKVZ	11	fort
Ding	NN	11	Dinge, Ding, Dingen, Dinger
einzig	ADJA, ADJD	11	einzige, einziger, einzigem, einzig
verlieren	VVFIN, VVPP, VVINF	11	verliert, verloren, verlieren
bekommen	VVINF, VVPP	11	bekommen
Leben	NN	11	Leben, Lebens
befehlen	VVPP, VVINF, VVFIN	11	befohlen, befehlen, befiehlt
zurück	PTKVZ, ADV	11	zurück
Oheim	NN	10	Oheim
brav	ADJA, ADJD	10	braver, braves, braven, brav
Bettler	NN	10	Bettler
ei	NE, FM	10	Ei, ei
aufheben	VVIZU, VVINF, VVPP, VVFIN	10	aufzuheben, aufheben, aufgehoben, aufhebt
schlecht	ADJA, ADJD	10	schlechte, schlechter, schlecht, schlechten
Leute	NN	10	Leute, Leuten, Leut
Kerl	NN	10	Kerl, Kerls
verdienen	VVFIN, VVPP	10	verdient, verdiene, verdienen, verdiente
König	NN	10	Könige, Königs, König
merken	VVFIN, VVINF, VVIMP, VVPP	10	Merkst, merke, merken, merk, gemerkt, merkte, merkt
bloß	ADJD, ADJA	10	bloß, Bloß, bloßer, bloßes
erinnern	VVFIN, VVINF, VVPP	10	erinnerte, erinnern, erinnert, erinnere, erinnerst
werfen	VVINF, VVPP, VVFIN	10	werfen, geworfen, warf, wirft
Bediente	NN	10	Bedienten, Bedienter, Bediente
seh	XY, FM, NE	10	seh, Seh
Vater	NN	10	Vater
voll	ADJD, ADJA	10	voll, voller, vollen, volles
heraus	PTKVZ, ADV	10	heraus
Frau	NN	10	Frau
leben	VVINF, VVFIN, VVPP	10	leben, lebt, gelebt, lebten, Leben, lebe
bald	ADV	10	bald, Bald
warten	VVINF, VVFIN	10	warten, Warte, warte
et	FM	10	et
Seite	NN	9	Seite
just	ADV	9	Just
Schuldner	NN	9	Schuldner
zeihen|ziehen	VVFIN	9	ziehet, ziehen, zieht, Zieht
hoffen	VVINF, VVPP, VVFIN	9	hoffen, gehofft, hoffe
Stand	NN	9	Stande, Standes, Ständen, Stände
behalten	VVINF, VVFIN	9	behalten, behalte, Behalte, behielten
Minister	NN	9	Minister
lernen	VVINF, VVPP, VVFIN	9	lernen, gelernt, lernt
los	ADJD, PTKVZ	9	los
wohin	PWAV	9	wohin, Wohin
erlauben	VVINF, VVFIN, VVPP	9	erlauben, Erlauben, erlaubt, erlaube
meinig	PPOSS	9	meinigen, Meinige, meinige
herein	ADV, PTKVZ	9	herein, Herein
morgen	ADV	9	morgen, Morgen
Spaß	NN	9	Spaß
euer	PPOSAT	9	Eurer, Eure, Eurem, Euer
einander	PRF	9	einander
Rechnung	NN	9	Rechnung, Rechnungen
ziehen	VVPP, VVFIN, VVINF	9	gezogen, zog, zogen, ziehen, Zöge
wünschen	VVINF, VVFIN, VVPP	9	wünschen, gewünscht, wünschte, wünscht, wünsche
erkennen	VVFIN, VVPP, VVINF	9	erkenne, Erkennst, erkannt, erkennen
drei	CARD	8	drei, Drei
laß	ADJD, ADJA	8	laß, lassen
tragen	VVFIN, VVINF	8	trug, tragen, trage, trägt
annehmen	VVINF, VVFIN, VVIZU	8	annehmen, annimmt, anzunehmen
bien	ADJA	8	bien
Polizei	NN	8	Polizei
lange	ADV	8	lange
Jahr	NN	8	Jahr, Jahre, Jahren
Madame	NN	8	Madame
zwanzig	CARD	8	zwanzig, Zwanzig
ce	ADJA	8	ce
übel	ADJD, ADJA	8	übel, übler, üble
Türe	NN	8	Türe, Tür
Gott	NN	8	Gott
erwarten	VVINF, VVFIN	8	erwarten, erwartet, erwarte, erwartete
Dame	NN	8	Dame, Damen
un	NE, FM	8	un
Himmel	NN	8	Himmels, Himmel
Nacht	NN	8	Nacht, Nächte
Not	NN	8	Not, nöten
entgegen	PTKVZ, ADV, APPO	8	entgegen
Gut	NN	8	Gütern, Gut
Dukaten	NN	8	Dukaten
ichs	ADJD	8	ichs
Persien	NE	8	Persien
Wernern	NN	8	Wernern
eins	CARD	8	eins, ein
Nachricht	NN	8	Nachricht, Nachrichten
Paul	NE	7	Paul
reichen	VVFIN	7	reicht, Reicht, reichte
ergreifen	VVFIN	7	ergreift, ergriff, Ergreift
Arm|Arme	NN	7	Armes, Armen, Arme
Gedanke	NN	7	Gedanke, Gedanken
erhalten	VVINF, VVFIN	7	erhalten, erhält
Schwester	NN	7	Schwester, Schwestern
stoßen	VVINF, VVPP, VVFIN	7	stoßen, gestoßen, stieß, Stößt, stieße, stößt
stecken	VVFIN, VVINF	7	stecke, steckt, steckst, stecken
Morgen	NN	7	Morgen
gefallen	VVINF, VVFIN	7	gefallen, gefiele, gefällt
wert	ADJD	7	wert
freuen	VVFIN, VVINF	7	Freue, freuen, freue
antworten	VVINF, VVPP, VVFIN	7	antworten, geantwortet, antworte, antworteten
Friede	NN	7	Friede
essen	VVINF, VVIMP	7	essen, Iß, iß
stark	ADJD, ADJA	7	stark, stärkere, stärkste
jammern	VVFIN	7	jammert, Jammert, jammerte
Ton	NN	7	Ton, Tone, Tones
verlassen	VVPP, VVFIN, VVIMP, ADJD	7	verlassen, verließ, Verlaß
Verlust	NN	7	Verlust, Verlusts
holen	VVFIN, VVIMP, VVINF	7	holt, hol, hole, holen
wohnen	VVPP, VVFIN, VVINF	7	gewohnt, wohnt, wohnen
indes	ADV	7	indes
Thüringen	NE	7	Thüringen
plaudern	VVINF, VVFIN	7	plaudern, Plaudert, plaudere
fremd	ADJA, ADJD	7	fremde, fremden, fremdes, fremd
zwei	CARD	7	zwei
fahren	VVPP, VVINF, VVFIN	7	gefahren, fahren, fuhr
Maul	NN	7	Maule, Maul, Mäuler, Mäulern
träumen	VVINF, VVPP, VVFIN	6	träumen, geträumt, Geträumt, träumt, träume
Heraklius	NE	6	Heraklius
Monat	NN	6	Monate, Monat, Monaten
laufen	VVFIN, VVIMP, VVINF	6	laufen, lauf, lief
Streich	NN	6	Streiche, Streich
fest	ADJD, ADJA	6	fest, festen, feste
erzählen	VVINF, VVPP, VVFIN, VVIMP	6	erzählen, erzählt, Erzähl
kalt	ADJD, ADJA	6	kalt, kalte, Kalt
borgen	VVPP, VVINF	6	geborgt, borgen
Stolz	NN	6	Stolz, Stolzes
Graf	NN	6	Graf, Grafen
Louisdor	NN	6	Louisdor
nochmals	ADV	6	nochmals
Ende	NN	6	Ende
woher	PWAV	6	Woher, woher
gehören	VVFIN	6	gehört
Gute	NN	6	Gutes, Gute
gestern	ADV	6	gestern
unmöglich	ADJD	6	unmöglich, Unmöglich
kurz	ADJD	6	kurz, Kurz
werd	VVFIN	6	ward
fassen	VVFIN, VVINF	6	faßt, Fassen, fassen, fasse
gering	ADJD, ADJA	6	gering, geringsten, geringste
erfahren	VVFIN, VVPP	6	erführen, erfährt, erfuhr, erfahren, erfahre
richtig	ADJD	6	richtig, richtiger
trinken	VVFIN, VVINF	6	trinkt, trinken, tranken
grausam	ADJD, ADJA	6	grausam, grausame, grausamen
Mühe	NN	6	Mühe
jen	PDAT, ADJA	6	jenem, Jenem, jenen, jen
ruhig	ADJD, ADJA	6	ruhig, ruhiger
Freude	NN	6	Freuden, Freude
lachen	VVINF, VVFIN	6	lachen, lache
zwingen	VVFIN, VVINF	6	zwingt, zwingen
Jungfer	NN	6	Jungfer
vermuten	VVFIN, VVPP, VVINF	6	vermute, vermutet, vermuten
Krüppel	NN	6	Krüppel
verkennen	VVINF, VVFIN	6	verkennen, verkennt
Geheimnis	NN	6	Geheimnisse, Geheimnis
Marloff	NE	6	Marloff
geschehen	VVINF, VVPP, VVFIN	6	geschehen, geschieht
früh	ADJD	6	früh, früher
Justen	VVFIN, ADJD, NE, ADJA	6	Justen
Bruder	NN	6	Bruder, Brüdern
umsonst	ADV	6	umsonst, Umsonst
erbrechen	VVPP, VVINF, VVFIN	6	erbrochen, erbrechen, Erbricht
vier	CARD	6	vier, Vier
Stadt	NN	6	Stadt, Städten
Budel	NN	6	Budel
Ohr	NN	6	Ohr, Ohren
Sohn	NN	5	Sohn
Weise	NN	5	Weise, Weisen
sahe	VVFIN	5	sahe
Vergnügen	NN	5	Vergnügen
Fuß	NN	5	Fuß, Fuße, Füßen, Füße
bar	ADJD, ADJA	5	bar, bares
schämen	VVINF	5	schämen
Schuld	NN	5	Schuld, Schulden
Zweifel	NN	5	Zweifel
il	FM, NE	5	il, Il
Lache|Lachen	NN	5	Lachen
Wechsel	NN	5	Wechsel
übergeben	VVFIN, VVINF	5	übergeben, übergebe
ziemen	VVFIN	5	ziemt, Ziemt, Ziemte, ziemte
würdig	ADJA, ADJD	5	würdiger, würdigen, würdig
Gesellschaft	NN	5	Gesellschaft
abgedankt	ADJA	5	abgedankten, abgedankter, abgedankte
Stelle	NN	5	Stelle
Beutel	NN	5	Beutel
en	FM	5	en
schlagen	VVFIN, VVINF	5	schlage, Schlägt, schlagen, schlug
Weg	NN	5	Weg, Wege
anstecken	VVFIN, VVIZU	5	ansteckten, ansteckte, anzustecken
versichern	VVPP, VVFIN	5	versichert, versichere, versicherte
aufsuchen	VVINF, VVIZU	5	aufsuchen, aufzusuchen
Güte	NN	5	Güte
drum	PAV	5	drum, Drum
tausend	CARD	5	tausend
schicken	VVPP, VVFIN, VVINF	5	geschickt, schickt, schicken, schickten
Spiel	NN	5	Spiel, Spiele
sodann	ADV	5	sodann
Wagen	NN	5	Wagen
gibts	NN	5	gibts
Jäger	NN	5	Jäger
dienen	VVINF, VVIMP	5	dienen, dien
alt	ADJA, ADJD	5	alter, alten, alt, altes
me	ADJA, NN	5	me
Verdienst	NN	5	Verdienst, Verdiensten
äußer	ADJA	5	äußersten, äußerste
St	NE	5	St
ernsthaft	ADJA, ADJD	5	ernsthafte, ernsthaften, ernsthaft
ersparen	VVFIN, VVINF	5	ersparen, ersparte
Umstand	NN	5	Umstände, Umständen
zerreißen	VVINF, VVFIN, VVPP	5	zerreißen, zerreißt, zerrissen
Dank	NN	5	Dank
reisen	VVFIN, VVINF	5	reise, Reisen, reisen
verdient	ADJA, ADJD	5	verdienter, verdiente, verdient
brechen	VVINF, VVFIN, VVPP	5	brechen, gebrochen
leicht	ADJD	5	leicht, Leicht
Wunsch	NN	5	Wünsche
erklären	VVFIN, VVINF	5	erklären, Erklären, erklärte
danken	VVINF, VVFIN	5	danken, danke
Verstand	NN	5	Verstande, Verstand
zehn	CARD	5	zehn, Zehn
Woche	NN	5	Wochen, Woche
Prinz	NN, NE	5	Prinzen, Prinz
reißen	VVFIN	5	reißen, Reißt, riß
wovon	PWAV	5	wovon
hässlich	ADJA, ADJD	5	häßlicher, häßlich, häßlichen
ehe	KOUS	5	ehe, Ehe
weisen	VVFIN, VVINF	5	Weisen, wies, weisen, weise
ists	VVFIN	5	ists
jemand	PIS	5	jemand, jemanden
Träne|Tränen	NN	5	Tränen
Wahrheit	NN	5	Wahrheit
wild	ADJA, ADJD	5	wildes, wilde, wilden, wild
Kopf	NN	5	Kopf
besehen	VVPP, VVFIN, VVINF	5	besehen, Besieht
seit	APPR	5	Seit, seit
jung	ADJA, ADJD	5	junge, jung, jungen
betteln	VVINF	4	betteln
voraus	ADV, PTKVZ	4	voraus
Gr	NN, NE	4	Gr
Wasser	NN	4	Wasser
ma	NE, FM	4	ma
ers	ADJD, VVFIN	4	ers
niemand	PIS	4	niemand
versprechen	VVPP, VVFIN, VVINF	4	versprochen, versprachen, versprechen, verspreche
recht|rechts	ADJA	4	rechten, rechte
Wille	NN	4	Willen
Läufer	NN	4	Läufer, Läufers
darnach	ADV	4	darnach
gefährlich	ADJD	4	gefährlich
Schlüssel	NN	4	Schlüssel
durchaus	ADV	4	durchaus
Große	NN	4	Großen
Mitleid	NN	4	Mitleid
entschuldigen	VVINF, VVFIN	4	entschuldigen
Vernunft	NN	4	Vernunft
Gewalt	NN	4	Gewalt
Tochter	NN	4	Tochter
vielmehr	ADV	4	vielmehr, Vielmehr
rufen	VVFIN	4	ruft, rief
achtzig	CARD	4	achtzig
Grund	NN	4	Grunde, Grund, Gründe
Grobian	NN	4	Grobian
gewinnen	VVINF, VVFIN, VVPP	4	gewinnen, gewinne, gewonnen
Art	NN	4	Art
lieset	VVFIN	4	lieset
jamais	NN	4	jamais
nu	ITJ	4	Nu, nu
Frieden	NN	4	Frieden, Friedens
Tat	NN	4	Tat
ihrige	PPOSAT	4	ihrigen, Ihrige
blind	ADJA, ADJD	4	blinde, blinden, blind
ewig	ADJD	4	ewig
Meile	NN	4	Meile, Meilen
fordern	VVPP, VVINF, VVFIN	4	gefordert, fordern, Fordere
sechs	CARD	4	sechs
vollends	ADV	4	vollends
schweigen	VVFIN, VVPP, VVIMP	4	schweige, geschwiegen, Schweig
untertänig	ADJA, ADJD	4	untertänigster, untertänigen, untertänigst
zugleich	ADV	4	zugleich
Chevalier	NN	4	Chevalier
vergeben	VVINF, VVIMP, VVFIN	4	vergeben, Vergib, Vergeben
jagen	VVINF, VVFIN	4	jagen, jagte, jagt
fragen	VVINF, VVFIN	4	fragen, fragt, fragte
helfen	VVINF, VVFIN, VVPP	4	helfen, hülfe, geholfen
sik	NN	4	sik
pfui	ITJ	4	Pfui, pfui
notwendig	ADJD	4	notwendig
gewahr	ADJD	4	gewahr
Schatulle	NN	4	Schatulle
räumen	VVPP, VVFIN, VVINF	4	geräumt, räumen, räume
Verzeihung	NN	4	Verzeihung
Bekanntschaft	NN	4	Bekanntschaften, Bekanntschaft
lustig	ADJD, ADJA	4	Lustig, lustig, lustige
à	FM	4	à
Fritz	NE	4	Fritz
Quartier	NN	4	Quartier, Quartiere
nimmermehr	ADV	4	nimmermehr, Nimmermehr
Ei	NN	4	Ei
heuen	VVFIN	4	heut
avec	NE	4	avec
überall	ADV	4	überall, Überall
Ursache	NN	4	Ursache, Ursachen
Notwendigkeit	NN	4	Notwendigkeit
empfangen	VVINF, VVFIN, VVPP	4	empfangen, Empfangen
weder	KON	4	weder
erraten	VVINF, VVPP, VVFIN	4	erraten, errate
Bank	NN	4	Bank
Unglückliche	NN	4	Unglückliche, Unglücklicher, Unglücklichen
Kutscher	NN	4	Kutscher
verkaufen	VVPP, VVFIN	4	verkauft, verkaufen
Treppe	NN	4	Treppe
Gesicht	NN	4	Gesicht
schaffen	VVFIN, VVPP, VVINF	4	schaffen, schafft, geschaffen
Kamerad	NN	4	Kamerad
lügen	VVPP, VVINF	4	gelogen, lügen
reich	ADJD	4	reicher, reich
wenigstens	ADV	4	wenigstens
Wilhelm	NE	4	Wilhelm
les	ADJA, VVFIN	4	les
willkommen	ADJD	4	willkommen, Willkommen
Reitknecht	NN	4	Reitknecht
Land	NN	4	Land, Lande
Schlag	NN	4	Schlag, Schlägen, Schlage
verlangen	VVFIN	4	verlangen, verlangt
gesund	ADJD, ADJA	4	gesund, gesunden
Riccaut	NE	4	Riccaut
étes	VVFIN, ADJA	4	étes
Türke	NN	4	Türken
betrügen	VVINF	4	betrügen
Sonne	NN	4	Sonne
Pf	NN	4	Pf
überlegen	VVPP, VVINF, VVFIN	4	überlegt, überlegen
Anteil	NN	4	Anteil
selten	ADJD	4	selten
Treue	NN	4	Treue
oft	ADV	4	oft
weg	PTKVZ, ADV	4	weg, Weg
übrig	ADJA, ADJD	4	übrige, übrig
Diener	NN	4	Diener
treten	VVFIN, VVINF	4	tritt, treten
genau	ADJD, ADJA	4	genauer, genau
vortrefflich	ADJA, ADJD	4	vortreffliche, vortrefflicher, vortrefflich, Vortrefflich
ausfahren	VVINF	3	ausfahren
jemals	ADV	3	jemals
pflegen	VVFIN, VVIMP	3	pflege, pflegt, pfleg
Misstrauen	NN	3	Mißtrauen
Regiment	NN	3	Regiments, Regiment
Miene	NN	3	Miene
toll	ADJD	3	toll
vorig	ADJA	3	Vorigen, vorige
mutwillig	ADJD, ADJA	3	mutwillig, mutwillige
mes	ADJA, VVFIN	3	mes
Mohr	NN	3	Mohr
putzen	VVINF, VVPP	3	putzen, geputzt
qui	NE, VVFIN	3	qui
Acht	NN	3	Acht
warm	ADJD, PTKVZ	3	warm
sterben	VVFIN, VVINF	3	sterbe, sterben
Bonne	NN	3	bonne
Excellence	NN	3	Excellence
wenden	VVFIN	3	wandte, wendet
trefflich	ADJD, ADJA	3	trefflich, trefflichen
Frage	NN	3	Fragen, Frage
beklagen	VVFIN	3	beklage
Geschwind	NN	3	Geschwind
weniger	ADV	3	weniger
Schreibepulte	NN	3	Schreibepulte
raten	VVFIN	3	rätst, rate, Raten
deutsch	ADJD, NN	3	deutsch, Deutsch
herkommen	VVFIN, VVINF, VVPP	3	herkomme, herkommen, hergekommen
galant	ADJD	3	galant
bedanken	VVFIN, VVINF	3	bedanken, bedanke
aufpassen	VVFIN, VVINF	3	aufpaßten, aufpassen
besuchen	VVFIN, VVINF	3	besuchte, besuchen
schenken	VVPP, VVIMP, VVFIN	3	geschenkt, schenk, schenkt
christlich	ADJD, ADJA	3	christlich, christlicher
anfangen	VVINF, VVIZU, VVPP	3	anfangen, anzufangen, angefangen
fait	ADJA, NE	3	fait
Kammerfrau	NN	3	Kammerfrau
Tasse	NN	3	Tasse
fürchten	VVFIN	3	fürchteten, Fürchten, fürchte
enthalten	VVFIN	3	enthält
Verachtung	NN	3	Verachtung
une	ADJA	3	une
Cest	NE	3	Cest
Beutelchen	NN	3	Beutelchen
stehlen	VVINF, VVFIN, VVPP	3	stehlen, stehle, gestohlen
vernünftig	ADJD, ADJA	3	vernünftig, vernünftiger, vernünftigen
manche	PIAT, PIS	3	manchen, manches, manche
legen	VVFIN, VVPP	3	legen, gelegt
ankommen	VVPP, VVFIN	3	angekommen, ankam
einlösen	VVIZU, VVINF	3	einzulösen, einlösen
sitzen	VVFIN, VVINF	3	sitzen
niemals	ADV	3	niemals
Tugend	NN	3	Tugend, Tugenden
Geschlecht	NN	3	Geschlechts, Geschlecht
hierher	PAV, ADV	3	hierher, Hierher
Arm	NN	3	Arm
Zärtlichkeit	NN	3	Zärtlichkeit
Punkt	NN	3	Punkte, Punkt
hundertmal	ADV	3	hundertmal
vertraulich	ADJA, ADJD	3	vertraulichen, vertrauliche, vertraulich
Wichtigste	NN	3	Wichtigste
verbunden	ADJD	3	verbunden
hübsch	ADJD, ADJA	3	hübsch, hübsche
nichtswürdig	ADJA	3	nichtswürdige
Erniedrigung	NN	3	Erniedrigung
hierzu	PAV	3	hierzu
selber	ADV	3	selber
versuchen	VVFIN, VVINF	3	versuchen
Summe	NN	3	Summe
vorsichtig	ADJA, ADJD	3	vorsichtigen, vorsichtig
verbergen	VVINF	3	verbergen
weigern	VVFIN, VVINF	3	weigert, weigern, weigerte
Gerechtigkeit	NN	3	Gerechtigkeit
Handschrift	NN	3	Handschrift
umarmen	VVINF, VVFIN	3	umarmen, Umarmen
schlimm	ADJD	3	schlimm, schlimmer
Martin	NE	3	Martin
ungern	ADV	3	ungern
Verleumder	NN	3	Verleumder
woran	PWAV	3	woran, Woran
königlich	ADJA	3	Königlichen, Königliches, Königliche
böse	ADJD, ADJA	3	böse, böser
wiedergeben	VVPP, VVINF	3	wiedergegeben, wiedergeben
halb	ADJA, ADJD	3	halben, halb
erweisen	VVPP	3	erwiesen
Verräter	NN	3	Verräter
ähnlich	ADJD, ADJA	3	ähnlich, ähnlichem
Gattin	NN	3	Gattin
Kurz	NE	3	Kurz
vornehm	ADJD, ADJA	3	vornehm, vornehmen, vornehme
ansehen	VVFIN, VVPP	3	ansieht, angesehen
ausräumen	VVIZU, VVPP	3	auszuräumen, ausgeräumt
Danziger	NN	3	Danziger
unsre	PPOSAT	3	unsern
herum	PTKVZ, APZR	3	herum
sogleich	ADV	3	sogleich
Bettel	NN	3	Bettel
pas	NE, FM	3	pas
Mund	NN	3	Munde, Mund
Spitzbube	NN	3	Spitzbube, Spitzbuben
Abend	NN	3	Abends, Abende
Oheims	NN	3	Oheims
moi	NE	3	moi
nötig	ADJD	3	nötig
verzehren	VVPP, VVFIN	3	verzehrt, verzehren
Vaterland	NN	3	Vaterlande, Vaterland
erwachen	VVFIN	3	erwacht
empfinden	VVINF, VVFIN	3	empfinden, empfinde
starr	ADJD, ADJA	3	starr, starren
Küche	NN	3	Küche
zurücknehmen	VVINF, VVPP	3	zurücknehmen, zurückgenommen
vors	APPRART	3	vors
au	ITJ	3	au
Briefchen	NN	3	Briefchen
Winter	NN	3	Winter
Stunde|Stunden	NN	3	Stunden
Liebhaber	NN	3	Liebhaber
zweimal	ADV	3	zweimal
verzweifelt	ADJA, ADJD	3	verzweifelte, verzweifelten, verzweifelt
treffen	VVINF, VVFIN	3	treffen, trifft
besitzen	VVINF, VVFIN	3	besitzen
Marliniere	NN	3	Marliniere
Tod	NN	3	Tod, Tode
Su	NE	3	su
mirs	ADJD	3	mirs
ohngeachtet	VVFIN, ADJA	3	ohngeachtet
Recht	NN	3	Recht, Rechts
herab	PTKVZ	3	herab
dreimal	ADV	3	dreimal
zweitausend	CARD	3	zweitausend
a	FM	3	a
Zeugnis	NN	3	Zeugnis
7	CARD	3	7
endlich	ADV	3	endlich, Endlich
irren	VVFIN	3	irren, irrt
wagen	VVINF, VVFIN	3	wagen, wage
frisieren	VVINF, VVPP	3	frisieren, frisiert
sehnen	VVIMP	3	Sehn, sehn
vollkommen	ADJD, ADJA	3	vollkommen, vollkommenste
Straße	NN	3	Straße
Galle	NN	3	Galle
Gleichheit	NN	3	Gleichheit
logier	NN, VVFIN	3	logier
Nit	VVFIN, ADJD	3	Nit
kostbar	ADJA	3	kostbaren, kostbarer
fallen|fällen	VVFIN	3	fällt
frisch	ADJD, ADJA	3	Frisch, frisches, frisch
Titel	NN	3	Titel
schüchtern	ADJD	3	schüchtern, Schüchtern
Landsmänninnen	NN	3	Landsmänninnen
Sünde	NN	3	Sünde
zurückgeben	VVFIN, VVPP	3	zurückgibt, zurückgegeben
9	CARD	3	9
andermal	ADV	3	andermal
Son	NE	3	Son
künftig	ADJA	3	Künftige, künftige
vollziehen	VVINF, VVPP, VVFIN	3	vollziehen, vollzogen, vollziehe
Band	NN	3	Band
erschrecken	VVFIN	3	erschrak, Erschrecke, erschrecke
steif	ADJD, ADJA	3	steif, steife
beschwören	VVFIN	3	beschwor, beschwöre
Zufall	NN	3	Zufall
hinter	APPR, ADJD	3	hinter
Exzellenz	NN	3	Exzellenz
Comment	NN	3	Comment
Roi	NE	3	Roi
Ordre	NN, ADJA	3	Ordre
wiederfinden	VVPP, VVINF	3	wiedergefunden, wiederfinden
Schicksal	NN	3	Schicksal, Schicksals
suis	NN, ADJA	3	suis
tüchtig	ADJA	3	tüchtige, tüchtiger
besorgen	VVFIN	3	besorgte, Besorgten, besorge
willen	APPO	3	willen
mächtig	ADJD, ADJA	3	mächtig, mächtigere
Schurke	NN	3	Schurke, Schurken
entgelten	VVINF	3	entgelten
Vormund	NN	3	Vormund, Vormünder
belohnen	VVINF, VVPP	3	belohnen, belohnt
Weib	NN	3	Weib, Weibe
Stimme	NN	3	Stimme
Eitelkeit	NN	3	Eitelkeit
begreifen	VVFIN, VVPP	3	begreife, begriffen, Begreifst
bedürfen	VVFIN, VVINF	3	bedarf, bedürfen
gehts	NN	3	gehts
Zahn	NN	3	Zähne, Zähnen
entsagen	VVINF, VVFIN	3	entsagen, entsagt
Sprak	NN	3	Sprak
Philipp	NE	3	Philipp
paar	PIAT	3	Paar
heiß	ADJA, ADJD	3	heißen, heiß
Kaffee	NN	3	Kaffee
wiß	ADJD	3	wiß
vierhundert	CARD	3	vierhundert
entschließen	VVPP, VVFIN	3	entschlossen
Kompliment	NN	3	Kompliment
verabschieden	VVFIN, VVPP	3	verabschiedete, verabschiedet
fluchen	VVINF	3	fluchen
zeigend	ADJD	3	zeigend
bilden	VVFIN	3	Bilden, bilde
verächtlich	ADJA, ADJD	3	verächtlichen, verächtlich
Abschied	NN	3	Abschied
Saal	NN	3	Saal, Saale
dahin	PAV	3	Dahin, dahin
dünken	VVFIN	3	dünkt
vorhin	ADV	3	vorhin
melden	VVFIN, VVINF	3	Melde, Meldet, melden
Ernst	NN, NE	3	Ernst
Franzose	NN	3	Franzosen, Franzose
etwa	ADV	3	etwa
zeigen	VVPP, VVINF, VVFIN	3	gezeigt, zeigen, Zeigen
Heller	NN	3	Heller
spotten	VVFIN	3	Spotte, Spotten
fünfhundert	CARD	3	fünfhundert
Rolle	NN	3	Rolle
besinnen	VVFIN, VVPP	3	besinne, besonnen
Wut	NN	3	Wut
Gelegenheit	NN	3	Gelegenheit
Interesse	NN	3	Interessen
höflich	ADJD, ADJA	3	höflicher, höflichen
Ihrigen	NN	3	Ihrigen
denken|gedenken	VVPP	3	gedacht
voilà	VVFIN, NN, ADJA	3	voilà
gleichfalls	ADV	3	gleichfalls, Gleichfalls
kriegen	VVFIN, VVPP	3	kriegt, gekriegt, kriegte
Rekrut	NN	3	Rekruten
Winterquartier	NN	3	Winterquartiere, Winterquartieren, Winterquartier
Vorsicht	NN	3	Vorsicht
ärgerlich	ADJD	3	ärgerlich, Ärgerlich
gutherzig	ADJA	3	gutherzige, gutherzigen
Kriegszahlmeister	NN	3	Kriegszahlmeister
Respekt	NN	2	Respekt
auk	NE	2	auk
Kleid	NN	2	Kleid, Kleide
draus	PAV	2	draus
Grenze	NN	2	Grenze, Grenzen
Unrecht	NN	2	Unrechtes, Unrechte
Gegenwart	NN	2	Gegenwart
ungefähr	ADJD	2	ungefähr
Stab	NN	2	Stab
Komödiantin	NN	2	Komödiantinnen, Komödiantin
gewaltig	ADJD	2	gewaltig
Platz	NN	2	Platz
Lebensart	NN	2	Lebensart
springen	VVFIN, VVINF	2	springt, springen
Gasthof	NN	2	Gasthof, Gasthöfe
Gegenstand	NN	2	Gegenstand
Neugierde	NN	2	Neugierde
kehren	VVFIN	2	Kehrt, kehrte
Stunde	NN	2	Stunde
amis	NE	2	amis
Verbindung	NN	2	Verbindung
Blut	NN	2	Blut
neunzig	CARD	2	neunzig
teilen	VVINF	2	teilen
Bande	NN	2	Bande
plötzlich	ADJD	2	plötzlich
klingen	VVFIN	2	klingt
Dero	NE, NN	2	Dero
bekennen	VVFIN, VVINF	2	bekenne, bekennen
verleiten	VVINF	2	verleiten
frei	ADJD	2	frei
begleiten	VVINF	2	begleiten
Parade	NN	2	Parade
Ernste	NE, NN	2	Ernste
Pistol	NN	2	Pistol
Lieutenant	NE	2	Lieutenant
Närrin	NN	2	Närrin
tod	ADJD	2	tod
verweigern	VVPP, VVINF	2	verweigert, verweigern
gesprenkt	VVFIN	2	gesprenkt
leihen	VVINF	2	leihen
Holla	NE	2	Holla
Equipage	NN	2	Equipage
Lazarett	NN	2	Lazarette, Lazarett
Grille|Grillen	NN	2	Grillen
<UNKNOWN>	NE, ADJD	2	Se, depend
speisen	VVINF	2	speisen
Stübchen	NN	2	Stübchen
Weile	NN	2	Weile
coeur	NN	2	coeur
Mache	NN	2	Mache
Beziehung	NN	2	Beziehung
fein	ADJA	2	feinste
Strenge	NN	2	Strenge
beschimpfen	VVPP, VVFIN	2	beschimpft, beschimpfen
Biß	NN	2	Bissen
Capitaine	NN	2	Capitaine
sais	ADJA, NE	2	sais
Bestie	NN	2	Bestie
Ringelchen	NN	2	Ringelchen
Brust	NN	2	Brust
Wendung	NN	2	Wendung
Unwille	NN	2	Unwillen, Unwille
Geschöpf	NN	2	Geschöpf
Hälfte	NN	2	Hälfte
Tür	NN	2	Türen
Genugtuung	NN	2	Genugtuung
Sieg	NN	2	Sieg
entbehrlich	ADJD	2	entbehrlich
Gesundheit	NN	2	Gesundheit
ereifern	VVFIN, VVINF	2	ereifert, ereifern
Beweis	NN	2	Beweis
Wink	NN	2	Wink
unten	ADV	2	unten
kosten	VVINF	2	kosten
Verschwender	NN	2	Verschwender
ums	APPRART	2	ums
He	NE	2	He
niederschlagen	VVPP	2	niedergeschlagen
plus	ADV	2	plus
anbieten	VVPP, VVFIN	2	angeboten, anböte
Beste	NN	2	Beste
Schwelle	NN	2	Schwelle
unterm	APPRART	2	unterm
Elend	NN	2	Elend
unentbehrlich	ADJD	2	unentbehrlich
ersticken	VVFIN	2	ersticke, ersticken
nunmehr	ADV	2	nunmehr
lösen	VVFIN, VVINF	2	löse, lösen
Feldzug	NN	2	Feldzüge, Feldzug
Bißchen	NN	2	Bißchen
Freundin	NN	2	Freundin
Hund	NN	2	Hunde, Hund
doute	NN	2	doute
ersetzen	VVINF	2	ersetzen
Schmerz	NN	2	Schmerz, Schmerze
trennen	VVFIN, VVINF	2	trennen
herzlich	ADJD	2	herzlich, Herzlich
Aussicht	NN	2	Aussicht
quälen	VVINF	2	quälen
Ungetreue	NN	2	Ungetreue
Bahn	NN	2	Bahn
Geschäft	NN	2	Geschäfte, Geschäften
lachend	ADJD, ADJA	2	lachend, lachende
wenns	VVFIN	2	wenns
dit	NN, NE	2	dit
Groll	NN	2	Groll
Vermögen	NN	2	Vermögen
schrecklich	ADJA	2	schreckliche, schreckliches
besetzen	VVPP	2	besetzt
Appetit	NN	2	Appetit
geteilet	VVPP	2	geteilet
Gütchen	NN	2	Gütchen
Absicht	NN	2	Absicht
Summa	NE	2	Summa
Verlangen	NN	2	Verlangen
unbescheiden	ADJD	2	unbescheiden, Unbescheiden
kanns	VVFIN, NN	2	kanns
Dach	NN	2	Dache, Dach
lieblich	ADJD, ADJA	2	lieblich, lieblichste
mitbringen	VVFIN, VVINF	2	mitbringt, mitbringen
Morgenland	NN	2	Morgenlande
Verdacht	NN	2	Verdacht
ärgern	VVFIN	2	ärgert
st	VVFIN	2	st
nous	NE	2	nous
trunken	ADJD	2	trunken
enden	VVINF	2	enden
verdrängen	VVPP	2	verdrängt
non	NE, FM	2	non
nok	NE	2	nok
Mittag	NN	2	Mittag
Rittmeisterin	NN	2	Rittmeisterin
Vorsatze	NN	2	Vorsatze
dachen	VVFIN	2	Dacht, dacht
schmecken	VVFIN, VVINF	2	schmeckt, schmecken
Tlr	NN	2	Tlr
Begriff	NN	2	Begriffe
Feuer	NN	2	Feuer
weisend	ADJD	2	weisend
packen	VVFIN	2	packe
vertrauen	VVIMP, VVINF	2	vertrau, vertrauen
Mais	NN	2	Mais
traurig	ADJA, ADJD	2	traurige, traurig
Hals	NN	2	Hals, Halse
Bein	NN	2	Beine
fertig	ADJD	2	fertig
zutrauen	VVINF	2	zutrauen
Dreiteil	NN	2	Dreiteil
Geduld	NN	2	Geduld
Könik	NN	2	Könik
garstig	ADJA	2	garstiger
betrachten	VVFIN, VVPP	2	betrachte, betrachtet
Fenster	NN	2	Fenster
Bewegung	NN	2	Bewegung
verlegen	VVPP, VVINF	2	verlegt, verlegen
seinige	PPOSAT	2	seinigen, seinige
ehemalig	ADJA	2	ehemaligen
Röllchen	NN	2	Röllchen
erkundigen	VVINF	2	erkundigen
schreien	VVFIN, VVINF	2	schrie, schreien
einräumen	VVINF, VVPP	2	einräumen, eingeräumt
vorgeben	VVFIN, VVINF	2	vorgab, vorgeben
Anspruch	NN	2	Ansprüche
Tapferkeit	NN	2	Tapferkeit
weggeritten	VVPP	2	weggeritten
Anblick	NN	2	Anblick, Anblicke
darin	PAV	2	darin
gehörig	ADJA	2	gehörige, gehörigen
Parbleu	NN	2	Parbleu
verdammt	ADJD, ADJA	2	verdammt, verdammte
Grobheit	NN	2	Grobheit
eitel	ADJD	2	eitel
Stich	NN	2	Stich, Stiche
dergleichen	PIS	2	dergleichen
hernach	ADV	2	Hernach, hernach
falsch	ADJA, ADJD	2	falschen, Falsch
Glücke	NN	2	Glücke
tout	NN	2	tout
Höflichkeit	NN	2	Höflichkeit
Befehl	NN	2	Befehle, Befehl
schießen	VVINF, VVFIN	2	schießen, schoß
entstehen	VVPP, VVINF	2	entstanden, entstehen
fortune	NE	2	fortune
Fremde	NN	2	Fremden
Engel	NN	2	Engel
Essen	NN	2	Essen
willig	ADJD	2	Willig, willig
ausreden	VVINF	2	ausreden
Nu	NN	2	Nu
dran	PAV	2	dran
heucheln	VVINF	2	heucheln
täglich	ADJD	2	täglich
Tropfen	NN	2	Tropfen
melancholisch	ADJA	2	melancholischer, melancholische
Überlegung	NN	2	Überlegung
zanken	VVINF	2	zanken
gleichwohl	ADV	2	Gleichwohl
Bekannte	NN	2	Bekannten, Bekannte
wackern	NN	2	wackern
Pfennig	NN	2	Pfennig
Warte	NN	2	Warte
einzigesmal	NN	2	einzigesmal
empfindlich	ADJD	2	empfindlicher, empfindlich
tilgen	VVINF, VVPP	2	tilgen, getilgt
hinein	PTKVZ	2	hinein
breit	ADJA	2	breite
elend	ADJA	2	Elenden, Elende
Reise	NN	2	Reise
Kleinigkeit	NN	2	Kleinigkeiten, Kleinigkeit
unterstehen	VVINF	2	unterstehen
hauen	VVFIN, VVPP	2	hieb, gehauen
heben	VVFIN	2	hebt, hebe
Barmherzigkeit	NN	2	Barmherzigkeit
schwarz	ADJD	2	schwarz
eilen	VVINF, VVFIN	2	eilen, Eilen
Bezahlung	NN	2	Bezahlung
nachkommen	VVPP, VVFIN	2	nachgekommen, nachkomme
aufs	APPRART	2	aufs
rächen	VVFIN, VVINF	2	rächten, rächen
Teufel	NN	2	Teufel
Sr	NE, NN	2	Sr
beifallen	VVPP, ADJD	2	beigefallen, beifallen
edel	ADJA	2	edlen
klagen	VVINF, VVPP	2	klagen, geklagt
verliebt	ADJD, ADJA	2	verliebt, verliebten
weißen	VVFIN	2	weißt
Schwemme	NN	2	Schwemme
prophezeien	VVFIN	2	prophezeie
Bst	NE	2	Bst
kaufen	VVFIN, VVPP	2	kaufe, gekauft
abdanken	VVPP	2	abgedankt
erdichten	VVPP	2	erdichtet, Erdichtet
Alter	NN	2	Alter
Vorschuss	NN	2	Vorschuß, Vorschüsse
22	CARD	2	22
behüten	VVFIN	2	Behüte, behüte
fünf	CARD	2	fünf
Missverständnis	NN	2	Mißverständnis
Reise|Reisen	NN	2	Reisen
spalten	VVINF	2	spalten
Witwe	NN	2	Witwe
Schritt	NN	2	Schritte
zufrieden	ADJD, ADJA	2	zufrieden, zufriedener
Henker	NN	2	Henker
fallen	VVINF	2	fallen
aufgehen	VVINF, VVPP	2	aufgehen, aufgegangen
dont	ADJA, VVFIN	2	dont
anwenden	VVPP	2	angewandt, angewendet
wofür	PWAV	2	Wofür, wofür
Dämmerung	NN	2	Dämmerung
tot	ADJD	2	tot
jeu	NN	2	jeu
Gefährlichkeit	NN	2	Gefährlichkeit
Verrichtung	NN	2	Verrichtungen
Tisch	NN	2	Tisch
stehn	VVFIN	2	stehn
Vergebung	NN	2	Vergebung
ungehalten	ADJD	2	ungehalten
Affaire	NN, ADJA	2	Affaire
schlafen	VVINF, VVFIN	2	schlafen
geruhen	VVFIN	2	geruht, geruhen
überlassen	VVINF, VVFIN	2	überlassen, überließe
herumlaufen	VVINF	2	herumlaufen
Dire	NE	2	dire
Großmut	NN	2	Großmut
leugnen	VVFIN, VVINF	2	leugnest, leugnen
mieux	NN	2	mieux
treiben	VVFIN, VVPP	2	treibt, getrieben
Sorge	NN	2	Sorge
Eigenliebe	NN	2	Eigenliebe
manchmal	ADV	2	manchmal
fähig	ADJD	2	fähig
Summarum	NN	2	Summarum
klug	ADJD	2	klug
très-	VVFIN, TRUNC	2	très-
unriktig	ADJD	2	unriktig
wiedersagen	VVFIN	2	wiedersagen
unschuldig	ADJA, ADJD	2	unschuldigen, unschuldig
Freundschaft	NN	2	Freundschaft
Schlimmste	NN	2	Schlimmste
Spieler	NN	2	Spieler
richten	VVFIN, VVPP	2	richte, gerichtet
Natur	NN	2	Natur
beleidigen	VVINF	2	beleidigen
verdrüßlich	ADJD	2	verdrüßlich
beleidiget	VVFIN	2	beleidiget
verstoßen	VVINF, VVPP	2	verstoßen
fortgehen	VVFIN	2	fortgehen
Bitterkeit	NN	2	Bitterkeit
fühlen	VVFIN	2	fühle
Kammerdiener	NN	2	Kammerdiener
unendlich	ADJD	2	unendlich
bemerken	VVFIN	2	bemerken, bemerkte
Eindruck	NN	2	Eindruck, Eindrücken
ertrotzen	VVINF	2	ertrotzen, Ertrotzen
Gebrauch	NN	2	Gebrauch
Provinz	NN	2	Provinz, Provinzen
verändern	VVPP	2	verändert
angelangen	VVFIN, VVPP	2	angelangt
Handschreiben	NN	2	Handschreiben
exakt	ADJD	2	exakt
allzu	PTKA	2	allzu
gehören|hören	VVPP	2	gehört
rien	VVFIN	2	rien
funfzig	NN, ADJA	2	funfzig
zugehend	ADJD	2	zugehend
verderben	VVFIN, VVPP	2	verdirbst, verdorben
meinetwegen	ADV	2	Meinetwegen, meinetwegen
fast	ADV	2	fast
vierzehn	CARD	2	vierzehn
Feind	NN	2	Feind
Frauenzimmer	NN	2	Frauenzimmer
Böse	NN	2	Böse, Böses
karren	VVFIN	2	karrt
Gemahl	NN	2	Gemahl
fallen|gefallen	VVPP	2	gefallen
Abwesenheit	NN	2	Abwesenheit
verwirren	VVFIN, VVPP	2	verwirre, verwirrt
Anmerkung	NN	2	Anmerkung
blöd	ADJA	2	blöde
Staaten-General	NN	2	Staaten-General
Familie	NN	2	Familie
Ruhe	NN	2	Ruhe
wetten	VVFIN	2	wette
verdanken	VVINF	2	verdanken
unterwegens	VVFIN, VVPP	2	unterwegens
übermorgen	ADV	2	übermorgen, Übermorgen
Jagd	NN	2	Jagd
Bedenken	NN	2	Bedenken
cela	ADJA, NE	2	cela
Übertreibung	NN	2	Übertreibung, Übertreibungen
bereuen	VVINF	2	bereuen
wenigste	PIS, PIAT	2	wenigsten
Szene	NN	2	Szene
unfehlbar	ADJD	2	unfehlbar
neigen	VVPP	2	geneigt
Angelegenheit	NN	2	Angelegenheiten
Wirtshaus	NN	2	Wirtshäuser
Sachse	NN	2	Sachsen
zwischen	APPR	2	zwischen
empfehlen	VVINF, VVFIN	2	empfehlen, empfiehlt
hindern	VVINF	2	hindern
Budeln	NN	2	Budeln
worin	PWAV	2	worin, Worin
Erfüllung	NN	2	Erfüllung
abbringen	VVINF	2	abbringen
Folge	NN	2	Folgen
Bruchsall	NN	2	Bruchsall
öffnen	VVFIN	2	öffnet
spöttisch	ADJA, ADJD	2	spöttischen, spöttisch
öfters	ADV	2	öfters
unbekannt	ADJD, ADJA	2	unbekannt, unbekannten
fröhlich	ADJD, ADJA	2	fröhlich, fröhliches
Nachbar	NN	2	Nachbars, Nachbar
aussetzen	VVIZU	2	auszusetzen
verabschiedet	ADJD	2	Verabschiedet, verabschiedet
huschen	VVIMP	2	Husch
Gefahr	NN	2	Gefahr
kommend	ADJD	2	Kommend, kommend
Viertelstündchen	NN	2	Viertelstündchen
zureichen	VVFIN, VVINF	2	zureicht, zureichen
kaum	ADV	2	kaum
schimpflich	ADJD, ADJA	2	schimpflich, schimpflichen
Point	NN, NE	2	point, Point
erwähnen	VVINF	2	erwähnen
einnehmen	VVINF, VVIZU	2	einnehmen, einzunehmen
ses	ADJA	2	ses
gedenken	VVINF, VVFIN	2	gedenken, Gedenke
gekränkt	ADJA	2	gekränkte, gekränkten
verbinden	VVPP, VVFIN	2	verbunden, verbinde
ertappen	VVPP, VVFIN	2	ertappt, ertappte
Irrtume	NN	2	Irrtume
Rede	NN	2	Rede
einbilden	VVFIN	2	einbildet, einbildete
verpflichten	VVPP	2	verpflichtet
faut	VVFIN	2	faut
dumm	ADJA	2	dumme
Zuflucht	NN	2	Zuflucht
Mode	NN	2	Mode
pochen	VVFIN	2	pocht
Schloss	NN	2	Schlosse
begehen	VVINF, VVFIN	2	begehen
behelfen	VVINF	2	behelfen
neben	APPR	2	neben
still	ADJD, ADJA	2	still, stillsten
unterkommen	VVINF, VVIZU	2	unterkommen, unterzukommen
mais	ADJA	2	mais
Galgen	NN	2	Galgen
Hofstaatskasse	NN	2	Hofstaatskasse
streitig	ADJD	2	streitig
wills	VVFIN	2	wills
scherzen	VVFIN, VVINF	2	scherzen
Geb	VVFIN	2	Geb
Verwirrung	NN	2	Verwirrung
hierauf	PAV	2	hierauf
entdecken	VVINF, VVPP	2	entdecken, entdeckt
Gespenst	NN	2	Gespenst, Gespenster
kränken	VVPP	2	gekränkt
Schuss	NN	2	Schuß
greifen	VVFIN	2	griff, greift
sprek	NE, VVFIN	2	sprek
Kaffeehause	NN	2	Kaffeehause
Wohltat	NN	2	Wohltaten
Tasche	NN	2	Tasche
schriftlich	ADJD	2	schriftlich
gutt	ADJD	2	gutt
nachts	ADV	2	Nachts
beschließen	VVPP	2	beschlossen
est	ADJA, ADJD	2	est
Monsieur	NN	2	Monsieur
aufopfern	VVPP	2	aufgeopfert
oben	ADV	2	oben
allhier	ADJA	2	allhier
ander	ADJA	2	ander
anschreiben	VVINF	2	anschreiben
Gläschen	NN	2	Gläschen
ehemals	ADV	2	ehemals
hängen	VVPP, VVFIN	2	gehangen, hing
Blick	NN	2	Blicke
Vertrauen	NN	2	Vertrauen
Tee	NN	2	Tee
unbescholten	ADJA	2	unbescholtenen, unbescholtene
beisammen	PTKVZ	2	beisammen
schämet	VVFIN	2	schämet
versagen	VVFIN, VVPP	2	versage, versagt
vertreiben	VVFIN, VVINF	2	vertrieben, vertreiben
Zurückkunft	NN	1	Zurückkunft
veut	ADJA	1	veut
verbissen	ADJA	1	verbissene
steigen	VVFIN	1	stieg
nieder	PTKVZ	1	nieder
parlieren	VVFIN	1	parlieren
surpasse	VVFIN	1	surpasse
wohlfeilste	ADJA	1	wohlfeilste
niedersetzen	VVFIN	1	niedersetzte
wahrlich	ADV	1	wahrlich
Blessur	NN	1	Blessuren
Sprache	NN	1	Sprache
lüderliche	ADJA	1	lüderliche
gedienet	ADJA	1	gedienet
Charakter	NN	1	Charakter
hats	NN	1	hats
Frauenszeug	NN	1	Frauenszeug
Licht	NN	1	Licht
Hieb	NN	1	Hieb
Farbe	NN	1	Farbe
Eselsgehirn	NN	1	Eselsgehirn
Denkungsart	NN	1	Denkungsart
fürchterlich	ADJD	1	fürchterlicher
sugesetzt	ADJD	1	sugesetzt
Traum	NN	1	Traume
Vorfall	NN	1	Vorfall
cher	ADJA	1	cher
politesses	NN	1	politesses
etoit	NN	1	etoit
winden	VVFIN	1	wand
geschicht	VVFIN	1	geschicht
empor	PTKVZ	1	empor
Barschaft	NN	1	Barschaft
fleißig	ADJD	1	fleißig
Flattergeist	NN	1	Flattergeist
malheur	NN	1	malheur
voyés	NN	1	voyés
hilfts	VVFIN	1	hilfts
Spötterei	NN	1	Spötterei
derjenige	PDS	1	denjenigen
reformé	ADJD	1	reformé
rouinir	ADJD	1	rouinir
Packknecht	ADJD	1	Packknecht
anführen	VVINF	1	anführen
Seigneur	NN	1	Seigneur
Vorteil	NN	1	Vorteil
Dames	NN	1	Dames
gottlos	ADJD	1	gottlos
Darnach	ADV	1	Darnach
Mangel	NN	1	Mangel
Recht|Rechte	NN	1	Rechten
vorspiegeln	VVIZU	1	vorzuspiegeln
schwärmen	VVINF	1	schwärmen
vertieft	ADJD	1	vertieft
unversehrt	ADJD	1	unversehrt
hartnäckig	ADJA	1	Hartnäckiger
wenigsten	ADV	1	wenigsten
Moment	NN	1	moment
Säbels	NN	1	Säbels
gelassener	ADJD	1	gelassener
Ärgernis	NN	1	Ärgernis
Uhr	NN	1	Uhr
Savés-	TRUNC	1	Savés-
gespeisen	VVFIN	1	gespeisen
bewusst	ADJA	1	bewußten
sicher	ADJD	1	sichrer
91	CARD	1	91
Ministre	NN	1	Ministre
Stube	NN	1	Stube
Nachweisungen	NN	1	Nachweisungen
Lügner	NN	1	Lügner
tändelnd	ADJA	1	tändelnden
lohnen	VVFIN	1	lohnen
Trommelschläger	NN	1	Trommelschläger
Rache	NN	1	Rache
Le	NE	1	Le
dexterité	NN	1	dexterité
Kammermädchens	NN	1	Kammermädchens
La	NE	1	La
Posse	NN	1	Possen
Vorbereitung	NN	1	Vorbereitung
Würde	NN	1	Würden
Pret-au-val	NN	1	Pret-au-val
unterhalten	VVINF	1	unterhalten
françois	VVFIN	1	françois
Junge	NN	1	Junge
untergesteckt	VVPP	1	untergesteckt
satt	ADJD	1	satt
Augenblickchen	NN	1	Augenblickchen
erstemal	ADV	1	erstemal
A	NN	1	A
unterstützet	VVFIN	1	unterstützet
Verzehren	NN	1	Verzehren
billig	ADJD	1	billig
wegkommen	VVPP	1	weggekommen
Schnelle	NN	1	Schneller
Lächerliche	NN	1	Lächerlichen
Winkel	NN	1	Winkel
Kapitale	NN	1	Kapitale
gelassen	ADJD	1	gelassen
befugen	VVPP	1	befugt
bewohnt	ADJA	1	bewohnten
vernarret	VVFIN	1	vernarret
hinderts	VVFIN	1	hinderts
moitié	NE	1	moitié
bangen	VVFIN	1	bange
Antwort	NN	1	Antwort
fix	ADJD	1	Fix
Peinigung	NN	1	Peinigung
Dorf	NN	1	Dorf
Freischulze	NE	1	Freischulze
dorthin	ADV	1	dorthin
Brillant	NN	1	Brillant
Brieftasche	NN	1	Brieftasche
Vorbewußt	NN	1	Vorbewußt
anblicken	VVFIN	1	anblickt
dasmal	ADV	1	dasmal
zucken	VVFIN	1	zuckt
sans	NN	1	sans
wollüstig	ADJD	1	wollüstig
beizutreiben	VVIZU	1	beizutreiben
Selbsterhaltung	NN	1	Selbsterhaltung
wahrscheinlich	ADJD	1	wahrscheinlich
uneingeladen	ADJD	1	uneingeladen
Rechtschaffenheit	NN	1	Rechtschaffenheit
abziehen	VVPP	1	abgezogen
paisla	NE	1	paisla
mentendés	NN	1	mentendés
unternehmen	VVINF	1	unternehmen
wahrhaft	ADJD	1	wahrhaft
Schulter|Schultern	NN	1	Schultern
ungeputzt	ADJD	1	ungeputzt
Wars	NN	1	Wars
toute	NN	1	toute
Mühle	NN	1	Mühle
überflüssig	ADJA	1	überflüssige
Prozentchen	NN	1	Prozentchen
erziehen	VVPP	1	erzogen
Hure	NN	1	Hure
Bemühung	NN	1	Bemühung
zudenken	VVPP	1	zugedacht
Windbeutelei	NN	1	Windbeutelei
vierfach	ADJA	1	vierfache
Bequemlichkeit	NN	1	Bequemlichkeit
Urteil	NN	1	Urteil
anzeigen	VVINF	1	anzeigen
vorbereiten	VVINF	1	vorbereiten
zubringen	VVPP	1	zugebracht
quun	NE	1	quun
Gratial	NN	1	Gratial
verwünscht	ADJA	1	verwünschte
nichtswürdiger	ADJA	1	nichtswürdiger
armselig	ADJD	1	armselig
Cela	NE	1	Cela
ausgebreitet	ADJA	1	ausgebreiteten
Eilends	NN	1	Eilends
Träumer	NN	1	Träumer
aufzählen	VVFIN	1	aufzähle
est-ce	ADJA	1	est-ce
Polen	NE	1	Polen
bitter	ADJA	1	bittersten
verbieten	VVPP	1	verboten
überreden	VVINF	1	überreden
albern	ADJA	1	albernes
nahe	PTKVZ	1	nahe
Rapport	NN	1	Rapport
Schein	NN	1	Schein
übermütig	ADJD	1	übermütig
Gleichgültigkeit	NN	1	Gleichgültigkeit
abgeschmackt	ADJD	1	abgeschmackt
humble	NN	1	humble
recommence	ADJA	1	recommence
Tranchons	NN	1	Tranchons
telle	NN	1	telle
Kammerjungfern	NN	1	Kammerjungfern
zaudern	VVFIN	1	zaudern
ehren	VVIMP	1	ehr
auftrüge	VVFIN	1	auftrüge
stellen	VVINF	1	stellen
hingehen	VVFIN	1	hingeht
Gegend	NN	1	Gegend
angenehm	ADJD	1	angenehm
brauk	NE	1	brauk
faveur	NN	1	faveur
Prensdor	NE	1	Prensdor
nachbringen	VVFIN	1	nachbringen
ansteckend	ADJA	1	ansteckender
Empfindung	NN	1	Empfindung
wegzukapern	VVIZU	1	wegzukapern
wiederkehrend	ADJA	1	wiederkehrendes
ansehnlich	ADJD	1	ansehnlich
appellés	NN	1	appellés
lächeln	VVFIN	1	lächelte
Sicherheit	NN	1	Sicherheit
Herzensmajor	NN	1	Herzensmajor
sperren	VVINF	1	sperren
zieren	VVFIN	1	zieren
Wand	NN	1	Wand
komplimentieren	VVINF	1	komplimentieren
Unbarmherzige	NN	1	Unbarmherzige
ausfragen	VVIZU	1	auszufragen
Verantwortung	NN	1	Verantwortung
singen	VVFIN	1	sang
verweilen	VVFIN	1	verweile
augurer	ADJA	1	augurer
Ihrentwegen	NN	1	Ihrentwegen
Markt	NN	1	Markt
impolie	NN	1	impolie
ausgeben	VVFIN	1	ausgibt
mengen	VVINF	1	mengen
coute	NN	1	coute
sies	ADJD	1	sies
Nürnberg	NE	1	Nürnberg
häßlich	ADJA	1	Häßlicher
zusammenbringen	VVFIN	1	zusammenbringen
gelaß	NN	1	gelaß
Säbel	NN	1	Säbel
widmen	VVPP	1	gewidmet
verwahren	VVFIN	1	verwahre
Wartung	NN	1	Wartung
verteidigen	VVFIN	1	Verteidigen
Betäubung	NN	1	Betäubung
hingesteckt	VVFIN	1	hingesteckt
abbrechen	VVINF	1	abbrechen
schwach	ADJA	1	schwächere
Führet	VVFIN	1	Führet
Wein|Weinen	NN	1	Weinen
erfinden	VVPP	1	erfunden
verschaffen	VVPP	1	verschafft
blicken	VVFIN	1	blickt
ledig	ADJD	1	ledig
fair	ADJA	1	faire
fais	ADJA	1	fais
hiesig	ADJA	1	hiesige
zurückbringen	VVPP	1	zurückgebracht
zuhalten	VVINF	1	zuhalten
fangen	VVFIN	1	fing
Ehrgeiz	NN	1	Ehrgeiz
bekannt	ADJD	1	bekannt
mancherlei	PIAT	1	mancherlei
schadlos	ADJD	1	schadlos
Sturm|Stürmen	NN	1	Stürmen
Pforte	NN	1	Pforte
hätt	VVFIN	1	hätt
funfsehn	ADJA	1	funfsehn
vermelden	VVINF	1	vermelden
geraten|raten	VVPP	1	geraten
Dritte	NN	1	Dritter
miens	NE	1	miens
comprenés	ADJD	1	comprenés
Gewesen	NN	1	Gewesen
Metier	NN	1	Metier
erfüllen	VVPP	1	erfüllt
ungemein	ADJD	1	ungemein
vorstehend	ADJA	1	vorstehende
Ehrerbietung	NN	1	Ehrerbietung
Majestät	NN	1	Majestät
behorcht	VVFIN	1	behorcht
Kasse	NN	1	Kasse
abgebrannt	ADJA	1	abgebrannten
Schweig	NE	1	Schweig
vernichten	VVINF	1	vernichten
gültig	ADJD	1	gültig
klingeln	VVFIN	1	klingelt
paradieren	VVINF	1	paradieren
belieben	VVPP	1	beliebt
Decke	NN	1	Decke
pardonnerés	NN	1	pardonnerés
drückend	ADJD	1	drückend
ängstigen	VVINF	1	ängstigen
weise	ADJA	1	weisen
Krankenbette	NN	1	Krankenbette
zänkisch	ADJA	1	zänkischen
entfliehen	VVPP	1	entflohen
Schutzengel	NN	1	Schutzengel
Schäfer	NN	1	Schäfer
tant	ADJA	1	tant
Rocken	NN	1	Rocken
Handlung	NN	1	Handlung
kurzsichtig	ADJD	1	kurzsichtig
wenig	ADV	1	wenig
entehret	VVFIN	1	entehret
entehren	VVFIN	1	entehrt
Tell	NE	1	Tell
permis	NE	1	permis
derweile	VVFIN	1	derweile
quand	NE	1	quand
ordentlich	ADJA	1	ordentlichen
zehnt	ADJA	1	zehnte
niks	ADJD	1	niks
behausen	VVINF	1	behausen
ankleiden	VVINF	1	ankleiden
unverzeihlich	ADJA	1	unverzeihlicher
mittelste	ADJA	1	mittelste
Schande	NN	1	Schanden
Reichtum	NN	1	Reichtümern
Größe	NN	1	Größe
Neider	NN	1	Neidern
Waise	NN	1	Waise
senden	VVFIN	1	sendet
gespielen	ADJD	1	gespielen
Pflege	NN	1	Pflege
beschweren	VVFIN	1	beschwere
weichen	VVFIN	1	weicht
Kantine	NN	1	Kantinen
geschmeidig	ADJD	1	geschmeidig
schließen	VVIMP	1	Schließ
reste	ADJA	1	reste
widern	VVIMP	1	wider
brennet	VVFIN	1	brennet
Verwunderung	NN	1	Verwunderung
Nimmermehr	NN	1	Nimmermehr
Bewunderer	NN	1	Bewunderern
herwendet	VVFIN	1	herwendet
Handwerk	NN	1	Handwerk
brennen	VVFIN	1	brennen
schreckhaft	ADJA	1	schreckhaften
falten	VVFIN	1	faltet
royal	ADJD	1	Royal
Aufschrift	NN	1	Aufschrift
entern	VVFIN	1	entre
einstecken	VVFIN	1	einsteckt
faul	ADJA	1	faules
vollesten	ADJA	1	vollesten
dankbar	ADJA	1	dankbarer
exactement	NN	1	exactement
wiedernehmen	VVFIN	1	wiedernehmen
Kohle	NN	1	Kohlen
Kamin	NN	1	Kamin
eingebildet	ADJA	1	eingebildetes
Sieh	NN	1	Sieh
50	CARD	1	50
Zusammenhang	NN	1	Zusammenhang
füllen	VVFIN	1	füllt
Extraction	NN	1	Extraction
widerfahren	VVFIN	1	widerfährt
niedrig	ADJA	1	niedrigste
beneiden	VVINF	1	beneiden
verdienet	VVFIN	1	verdienet
gezieret	VVFIN	1	gezieret
Quark	NN	1	Quark
Les	NE	1	Les
stiften	VVPP	1	gestiftet
gönnen	VVINF	1	gönnen
Mundierungsstücke	NN	1	Mundierungsstücke
Main	NE	1	main
weiblich	ADJA	1	weibliche
Ausgange	NN	1	Ausgange
bewohnen	VVPP	1	bewohnt
burr	ADJD	1	burr
Bräutigam	NN	1	Bräutigam
Zeitlang	NE	1	Zeitlang
ausgelernt	ADJA	1	ausgelernter
urgieren	VVINF	1	urgieren
rauchen	VVFIN	1	raucht
Schuh	NN	1	Schuhen
Still	NN	1	Still
entlegne	ADJA	1	entlegne
nachweisen	VVINF	1	nachweisen
günstig	ADJD	1	günstiger
Ruhmbegierde	NN	1	Ruhmbegierde
son	FM	1	son
sou	ADJD	1	sou
Unmensch	NN	1	Unmenschen
Ermüdung	NN	1	Ermüdung
Müller	NE	1	Müller
resolvier	ADJD	1	resolvier
einholen	VVINF	1	einholen
redlichern	ADJA	1	redlichern
erbetteln	VVFIN	1	erbettelt
22.	ADJA	1	22.
zugehören	VVINF	1	zugehören
Unschuld	NN	1	Unschuld
leiden	VVINF	1	leiden
tugendhaft	ADJD	1	tugendhaft
Banquier	NN	1	Banquier
navoir	NN	1	navoir
offen	ADJA	1	offenen
stürmisch	ADJA	1	stürmische
beschwerlich	ADJD	1	beschwerlich
liebest	VVFIN	1	liebest
vertrauter	ADJD	1	vertrauter
Hiernächst	ADV	1	Hiernächst
Liverei	NN	1	Liverei
reiten	VVFIN	1	ritt
insgeheim	ADV	1	insgeheim
dadurk	VVFIN	1	dadurk
erscheinen	VVFIN	1	erscheinen
Gewissen	NN	1	Gewissens
versparen	VVINF	1	versparen
Gleichfalls	NN	1	Gleichfalls
Gegenpart	NN	1	Gegenpart
erholen	VVINF	1	erholen
scharmieren	VVFIN	1	scharmieren
ny	NE	1	ny
angewiesen	ADJD	1	angewiesen
Falle	NN	1	Falle
Versuch	NN	1	Versuche
öfterer	ADV	1	öfterer
Schlafzimmer	NN	1	Schlafzimmer
gehöret	ADJD	1	gehöret
auftreiben	VVIZU	1	aufzutreiben
befremden	VVFIN	1	befremdet
beträchtlich	ADJD	1	beträchtlich
Italien	NE	1	Italien
Liaison	NN	1	liaison
Runde	NN	1	Runde
gegenwärtig	ADJD	1	gegenwärtig
fureur	NN	1	fureur
Rois	NE	1	Rois
wenikst	ADJA	1	wenikst
Valute	NN	1	Valute
vermaledeite	ADJA	1	vermaledeite
Pferd	NN	1	Pferde
Heimat	NN	1	Heimat
Donnés	NN	1	Donnés
gespreizt	ADJA	1	gespreizten
doits	NN	1	doits
endlik	NN	1	endlik
lächelnd	ADJD	1	lächelnd
Wohnung	NN	1	Wohnung
Adjeu	NN	1	Adjeu
dringender	ADJD	1	dringender
Hu	NE	1	Hu
Festung	NN	1	Festung
Abschlag	NN	1	Abschlag
ver	VVFIN	1	ver
gebrechen	VVPP	1	gebrechen
deswegen	PAV	1	deswegen
entwischen	VVINF	1	entwischen
reizender	ADJD	1	reizender
Bedenklichkeit	NN	1	Bedenklichkeit
Gastwirt	NN	1	Gastwirt
hurtig	ADJD	1	hurtig
Hang|Hängen	NN	1	Hängen
veranlasset	ADJD	1	veranlasset
enterben	VVPP	1	enterbt
wählen	VVPP	1	gewählt
schwerlich	ADJD	1	schwerlich
dommage	VVFIN	1	dommage
Ehrlichkeit	NN	1	Ehrlichkeit
Kron	NE	1	Kron
Stiefel	NN	1	Stiefeln
politisch	ADJA	1	politische
naget	VVFIN	1	naget
sais-je	NE	1	sais-je
betragen|betrügen	VVFIN	1	betrügen
beurlauben	VVFIN	1	beurlauben
desfalls	NN	1	desfalls
bestellen	VVINF	1	bestellen
Gutt	ADJD	1	Gutt
Monarch	NN	1	Monarch
rasieren	VVINF	1	rasieren
aufziehen	VVFIN	1	aufzieht
Bravour	NN	1	Bravour
zuzuschanzen	VVIZU	1	zuzuschanzen
Benennung	NN	1	Benennung
Berg	NN	1	Berge
Briefschreiben	NN	1	Briefschreiben
fliehen	VVINF	1	fliehen
Fleischerknecht	NN	1	Fleischerknecht
höhnisch	ADJD	1	höhnisch
nêt-homme	VVFIN	1	nêt-homme
losgehen	VVINF	1	losgehen
ausliefern	VVIZU	1	auszuliefern
militärisch	ADJD	1	militärisch
Eigentümer	NN	1	Eigentümer
bange	ADJD	1	bange
verwundern	VVPP	1	verwundert
blühende	ADJA	1	blühende
beurteilet	VVFIN	1	beurteilet
steckts	NN	1	steckts
mehrmal	ADJD	1	mehrmal
Où	NN	1	Où
parmi	NE	1	parmi
verlieben	VVPP	1	verliebt
honnêt-homme	NE	1	honnêt-homme
Perle|Perlen	NN	1	Perlen
abreisen	VVINF	1	abreisen
beßre	ADJA	1	beßre
August	NN	1	August
schleppen	VVIMP	1	schlepp
Zurückhaltung	NN	1	Zurückhaltung
Feuermauren	NN	1	Feuermauren
vous	NE	1	vous
drehend	ADJD	1	drehend
swanzik	NN	1	swanzik
Friedrichsdor	NN	1	Friedrichsdor
Trommel|Trommeln	NN	1	Trommeln
anstehen	VVFIN	1	ansteht
Hintertreppe	NN	1	Hintertreppe
abgeredet	VVPP	1	abgeredet
Schuldigkeit	NN	1	Schuldigkeit
Oui	NE	1	Oui
Schreiber	NN	1	Schreiber
küssend	ADJD	1	küssend
car	NE	1	car
hinwiederum	ADV	1	hinwiederum
elft	ADJA	1	elfte
Schreiben	NN	1	Schreiben
großmütig	ADJD	1	großmütig
beantworten	VVINF	1	beantworten
Geliebte	NN	1	Geliebten
stolz	ADJD	1	stolz
lähmen	VVPP	1	gelähmt
gewohnt	ADJD	1	gewohnt
laufend	ADJA	1	laufenden
Galgenstrick	NN	1	Galgenstrick
Swar	NE	1	Swar
ruhmvoll	ADJA	1	ruhmvolle
stumm	ADJD	1	stumm
Dinte	NN	1	Dinte
Liebenswürdigsten	NN	1	Liebenswürdigsten
Notfall	NN	1	Notfall
sous	NE	1	sous
laimés	NN	1	laimés
zuführend	VVFIN	1	zuführend
verdienstlicher	ADJD	1	verdienstlicher
verachten	VVFIN	1	verachtete
lässig	ADJD	1	lässig
grob	ADJA	1	groben
füttern	VVINF	1	füttern
töten	VVFIN	1	tötet
Tant	ADJA	1	Tant
vorenthalten	VVFIN	1	vorenthält
Verderben	NN	1	Verderben
Rechtschaffene	NN	1	Rechtschaffenen
Verkauft	NN	1	Verkauft
zugeben	VVINF	1	zugeben
Vormittag	NN	1	Vormittage
Probe	NN	1	Probe
su	NN	1	su
sa	VVFIN	1	sa
Empfang	NN	1	Empfang
se	NE	1	se
verdrösse	VVFIN	1	verdrösse
wirblicht	ADJD	1	wirblicht
Länge	NN	1	Länge
meiste	PIS	1	meisten
unterrichten	VVPP	1	unterrichtet
Lachs	NN	1	Lachs
Geck	NN	1	Geck
bunt	ADJD	1	bunt
Bereitschaft	NN	1	Bereitschaft
meistenteils	ADV	1	meistenteils
erweiset	VVFIN	1	erweiset
herkömmt	VVFIN	1	herkömmt
vorbei	PTKVZ	1	vorbei
irre	PTKVZ	1	irre
gequälet	VVPP	1	gequälet
erwerben	VVFIN	1	erwarb
Schulzengerichte	NN	1	Schulzengerichte
Feder	NN	1	Feder
lauern	VVPP	1	gelauert
dauren	VVFIN	1	dauren
placé	NN	1	placé
Zahlungstermin	NN	1	Zahlungstermin
kosen|kosten	VVFIN	1	koste
Dok	ADJD	1	Dok
eu	ADJA	1	eu
Lui	NE	1	lui
zuschreiben	VVINF	1	zuschreiben
Ordnung	NN	1	Ordnung
erdrosseln	VVINF	1	erdrosseln
verfahren	VVPP	1	verfahren
unanständig	ADJD	1	unanständig
Wesen	NN	1	Wesen
überzeugen	VVINF	1	überzeugen
reformir	NE	1	reformir
rein	ADJA	1	reinen
gilts	NN	1	gilts
pigeonneau	NN	1	pigeonneau
Justizkollegiis	NN	1	Justizkollegiis
principe	ADJD	1	principe
umsehen	VVFIN	1	umsieht
Gliedmaß	NN	1	Gliedmaßen
beiher	NN	1	beiher
wirds	VVFIN	1	wirds
Quälgeist	NN	1	Quälgeist
murren	VVINF	1	murren
Stellung	NN	1	Stellung
gratulieren	VVFIN	1	gratuliere
doppelt	ADJA	1	doppelter
Lohn	NN	1	Lohn
Dato	NE	1	Dato
par-là	NN	1	par-là
nutzen	VVINF	1	nutzen
Verbindlichkeit	NN	1	Verbindlichkeit
beben	VVPP	1	gebebt
ewik	NN	1	ewik
aufwärts	PTKVZ	1	aufwärts
16	CARD	1	16
gewarnet	NE	1	gewarnet
dasu	NE	1	dasu
vertrauet	ADJD	1	vertrauet
De	NE	1	De
vertrinken	VVINF	1	vertrinken
Teuff	NN	1	Teuff
Bett|Betten	NN	1	Betten
sonderbar	ADJA	1	sonderbare
Höhe	NN	1	Höhe
Französisch	NN	1	Französisch
parle	NE	1	parle
preußisch	ADJD	1	preußisch
jedermann	PIS	1	jedermann
voudrois	NE	1	voudrois
Bitte	NN	1	Bitte
wunderbar	ADJD	1	Wunderbar
führen	VVFIN	1	führte
Kurland	NN	1	Kurland
Bube	NN	1	Bube
Schwert	NN	1	Schwert
perfekt	ADJA	1	perfekter
losdrücken	VVINF	1	losdrücken
Päbstliken	NN	1	Päbstliken
Lektion	NN	1	Lektion
nüchtern	VVINF	1	nüchtern
Rauch	NE	1	Rauch
hinterlassen	VVINF	1	hinterlassen
plump	ADJD	1	plump
hörts	VVFIN	1	hörts
Niederträchtigkeit	NN	1	Niederträchtigkeit
Trunk	NN	1	Trunk
Sophistin	NN	1	Sophistin
Handel	NN	1	Handel
erzürnen	VVPP	1	erzürnt
gen	APPR	1	gen
Näher	NN	1	Nähern
gewilliget	VVFIN	1	gewilliget
schwer	ADJD	1	schwer
mon	ADJA	1	mon
leichtgläubig	ADJA	1	Leichtgläubiger
schätzen	VVFIN	1	schätze
anrühren	VVINF	1	anrühren
carte	NE	1	carte
vermocht	ADJA	1	vermochte
geputzter	ADJD	1	geputzter
erstrecken	VVINF	1	erstrecken
Schwanz	NN	1	Schwanze
Prahlen	NN	1	Prahlen
Donnés-	TRUNC	1	Donnés-
stärkern	NN	1	stärkern
3	CARD	1	3
lässest	VVFIN	1	lässest
ungehangen	ADJD	1	ungehangen
dachts	VVFIN	1	dachts
Kontribution	NN	1	Kontribution
Wert	NN	1	Wert
Hitze	NN	1	Hitze
Senge|Sengen	NN	1	Sengen
brauchen|gebrauchen	VVPP	1	gebraucht
mans	ADJD	1	mans
Beutepferde	NN	1	Beutepferde
eröffnen	VVPP	1	eröffnet
vois	NN	1	vois
besorgt	ADJD	1	besorgt
Mahlzeit	NN	1	Mahlzeit
veritabel	ADJA	1	veritabler
wandern	VVFIN	1	wandere
damals	ADV	1	damals
einfallen	VVFIN	1	einfällt
tückisch	ADJA	1	tückische
beiderseits	APPR	1	beiderseits
Armut	NN	1	Armut
abhangen	VVFIN	1	abhangen
ausziehen	VVINF	1	ausziehen
Bett	NN	1	Bette
gleichviel	ADV	1	gleichviel
befriedigen	VVINF	1	befriedigen
coupe	NE	1	coupe
Eigensinn	NN	1	Eigensinn
hernehmen	VVINF	1	hernehmen
Nasenweise	NN	1	Nasenweise
verleugnen	VVPP	1	verleugnet
Erste	NN	1	Ersten
ungeschliffen	ADJA	1	ungeschliffene
Karosse	NN	1	Karossen
Klage|Klagen	NN	1	Klagen
bereiten	VVFIN	1	bereite
zustoßen	VVPP	1	zugestoßen
Verweis	NN	1	Verweise
krank	ADJD	1	krank
Vollmacht	NN	1	Vollmacht
soit	NN	1	soit
sauer	ADJD	1	sauer
eigennützig	ADJA	1	eigennützige
Uniform	NN	1	Uniform
aiment	NN	1	aiment
verunglücken	VVFIN	1	verunglückte
dhonneur	NN	1	dhonneur
hundsföttsche	ADJA	1	hundsföttsche
toûjours	NN	1	toûjours
Karat	NN	1	Karat
zittern	VVPP	1	gezittert
Edelmut	NN	1	Edelmut
Scherz	NN	1	Scherz
Empfehl	NN	1	Empfehl
Parteilichkeit	NN	1	Parteilichkeit
Unbekannte	NN	1	Unbekannte
Lichtmess	NN	1	Lichtmeß
Beständigkeit	NN	1	Beständigkeit
Ankunft	NN	1	Ankunft
nai	NE	1	nai
aufwiegen	VVFIN	1	aufwiegt
Wallung	NN	1	Wallung
Rummel	NN	1	Rummel
Zeile	NN	1	Zeile
cherche	NN	1	cherche
Kommendanten	NN	1	Kommendanten
herabreißen	ADJD	1	herabreißen
Wirtstafel	NN	1	Wirtstafel
hungern	VVFIN	1	hungerte
offenherziger	ADJD	1	offenherziger
Komplott	NN	1	Komplott
Ort|Orten	NN	1	Orten
parat	ADJD	1	parat
plumer	VVINF	1	plumer
erbiete	VVFIN	1	erbiete
Alsdann	NE	1	Alsdann
lachendsten	ADJA	1	lachendsten
Verstellung	NN	1	Verstellung
Vorwand	NN	1	Vorwand
begegnen	VVPP	1	begegnet
geschickt	ADJD	1	geschickt
verstehn	VVFIN	1	verstehn
versiker	NN	1	versiker
Bravo	NN	1	Bravo
holländisch	ADJA	1	holländischen
verschloßnen	ADJA	1	verschloßnen
Hon	NE	1	Hon
Geschwindigkeit	NN	1	Geschwindigkeit
Vorbitterin	NN	1	Vorbitterin
Kur	NN	1	Kur
Gebieterin	NN	1	Gebieterin
wozu	PWAV	1	Wozu
auslegen	VVPP	1	ausgelegt
Schutz	NN	1	Schutz
wägen	VVINF	1	wägen
vû	ADJA	1	vû
unverloren	ADJD	1	unverloren
hieher	NN	1	hieher
unfreundlich	ADJD	1	unfreundlich
Partie	NN	1	Partie
vis-à-vis	NE	1	vis-à-vis
bemühet	VVFIN	1	bemühet
meinet	VVFIN	1	meinet
très-joli	NE	1	très-joli
einhändigen	VVIZU	1	einzuhändigen
raus	ADV	1	raus
fechten	VVPP	1	gefochten
nebst	APPR	1	nebst
artig	ADJD	1	artig
Redensart	NN	1	Redensart
on	NE	1	on
ach	ITJ	1	Ach
verfließen	VVFIN	1	verfließt
Neigung	NN	1	Neigung
Kreatur	NN	1	Kreatur
étre	VVFIN	1	étre
unvermutet	ADJA	1	unvermutete
prügeln	VVFIN	1	prügelte
rühmen	VVINF	1	rühmen
sterbend	ADJA	1	sterbenden
Beruhigung	NN	1	Beruhigung
Tabagie	NN	1	Tabagie
abfinden	VVIZU	1	abzufinden
entspringen	VVFIN	1	entsprang
zürnen	VVFIN	1	Zürnen
vergangen	ADJD	1	vergangen
lon	ADJA	1	lon
Aufgebot	NN	1	Aufgebote
bestrebe	VVFIN	1	bestrebe
fodern	VVINF	1	fodern
überzeugt	ADJD	1	überzeugt
Wurf	NN	1	Wurf
hochöchst	ADJD	1	höchst
Gedränge	NN	1	Gedränge
foltern	VVFIN	1	foltert
verscheuchen	VVFIN	1	verscheuchten
vielmal	ADV	1	vielmal
rechnen	VVINF	1	rechnen
Garnisonregimente	NN	1	Garnisonregimente
interessir	NN	1	interessir
a.c.	ADJA	1	a.c.
mahnen	VVINF	1	mahnen
Nouvelle	NN	1	Nouvelle
verschämt	ADJD	1	verschämt
beibehalten	VVPP	1	beibehalten
Aufwartung	NN	1	Aufwartung
Hof	NN	1	Hof
unveränderlich	ADJD	1	unveränderlich
gratulier	NN	1	gratulier
umnebeln	VVPP	1	umnebelt
gäb	VVFIN	1	gäb
allervollständigste	ADJA	1	allervollständigste
erlaubet	VVFIN	1	erlaubet
Verbeugung	NN	1	Verbeugung
donnés	NN	1	donnés
Gespielin	NN	1	Gespielin
Futteral	NN	1	Futteral
hölzern	ADJD	1	hölzern
grundfalsch	ADJD	1	grundfalsch
überwacht	ADJA	1	überwachten
Verdruss	NN	1	Verdruß
notwendik	ADJD	1	notwendik
Zurücknehmung	NN	1	Zurücknehmung
Zeitung	NN	1	Zeitungen
herschreibt	VVFIN	1	herschreibt
Mauer	NN	1	Mauern
Bestechung	NN	1	Bestechung
gestehen|stehen	VVPP	1	gestanden
Mond	NN	1	monde
traktiere	VVFIN	1	traktiere
Schlimme	NN	1	Schlimmen
abnehmen	VVINF	1	abnehmen
Flitterseite	NN	1	Flitterseite
Nachdenken	NN	1	Nachdenken
schade	ADJD	1	Schade
Kanale	NN	1	Kanale
geziemet	VVFIN	1	geziemet
währender	ADJA	1	währender
Rest	NN	1	Reste
hoffentlich	ADV	1	Hoffentlich
desprit	ADJA	1	desprit
zurückhaltend	ADJD	1	zurückhaltend
Beschäftigung	NN	1	Beschäftigung
Rücken	NN	1	Rücken
laut	ADJD	1	laut
Hoheit	NN	1	Hoheit
Kammerkätzchen	NN	1	Kammerkätzchen
Falsch	NN	1	Falsch
verkehren	VVPP	1	verkehrt
Trieb	NN	1	Trieb
Haltung	NN	1	Haltung
Republik	NN	1	Republik
hinaus	ADV	1	hinaus
sur	NN	1	sur
Lehre	NN	1	Lehre
Körper	NN	1	Körpers
leid	ADJD	1	leid
Gift	NN	1	Gift
kützeln	VVFIN	1	kützeln
Vollblütigkeit	NN	1	Vollblütigkeit
sert	NN	1	sert
erhitzet	VVFIN	1	erhitzet
ausmachen	VVPP	1	ausgemacht
Rachen	NN	1	Rachen
betragen	VVPP	1	betragen
Neujahr	NN	1	Neujahr
depars	NN	1	depars
Hoffnung	NN	1	Hoffnung
Tafel	NN	1	Tafel
avancieren	VVPP	1	avanciert
kapern	VVINF	1	kapern
heilen	VVFIN	1	heilen
Gefalle	NN	1	Gefalle
trocken	ADJA	1	trockenen
Spanien	NE	1	Spanien
6	CARD	1	6
Eigentum	NN	1	Eigentum
Sachés	NN	1	Sachés
Richtigkeit	NN	1	Richtigkeit
redlich	ADJA	1	redlichen
reizen	VVPP	1	gereizt
Rittmeister	NN	1	Rittmeister
enfant	NN	1	enfant
prompt	ADJD	1	prompt
Wien	NE	1	Wien
Garderobe	NN	1	Garderobe
bedeutend	ADJA	1	bedeutenden
vermieten	VVFIN	1	vermietete
Dresden	NE	1	Dresden
Knoten	NN	1	Knoten
Grille	NN	1	Grille
rasend	ADJD	1	rasend
pertes	ADJA	1	pertes
Rennen	NN	1	Rennen
mitleidig	ADJD	1	mitleidig
Kälte	NN	1	Kälte
Schlingel	NN	1	Schlingel
Schokolate	NN	1	Schokolate
Gasthofe	NN	1	Gasthofe
vient	ADJA	1	vient
Renner	NN	1	Renner
mystères	NE	1	mystères
scheinet	ADJA	1	scheinet
File	NN	1	file
gleichsam	ADJD	1	gleichsam
unbeweglich	ADJD	1	unbeweglich
abhalten	VVPP	1	abgehalten
Rechtfertigung	NN	1	Rechtfertigung
unbefohlen	ADJD	1	unbefohlen
25	CARD	1	25
21	CARD	1	21
voran	PTKVZ	1	voran
ansprechen	VVFIN	1	anspricht
Chevaliers	NN	1	Chevaliers
Edelmütiger	NN	1	Edelmütiger
avantureux	ADJA	1	avantureux
Schreiberei	NN	1	Schreiberei
verehren	VVINF	1	verehren
Statten	NN	1	Statten
nachlässig	ADJA	1	nachlässige
entfernt	ADJA	1	entferntesten
Rad	NN	1	Rad
unerwartet	ADJD	1	unerwartet
Nachfrage	NN	1	Nachfrage
Rat	NN	1	Rat
Bessers	NN	1	Bessers
Schadenfreude	NN	1	Schadenfreude
Lippe	NN	1	Lippen
herholen	VVINF	1	herholen
très-humble	NN	1	très-humble
stillen	VVFIN	1	stille
heiter	ADJA	1	heitersten
allzunachteiligen	ADJA	1	allzunachteiligen
hart	ADJD	1	hart
Distrikt	NN	1	Distrikte
quelque	ADJA	1	quelque
ansehnlik	NN	1	ansehnlik
missen	VVINF	1	missen
Drechslerpuppen	NN	1	Drechslerpuppen
vorgehen	VVFIN	1	vorgeht
winseln	VVINF	1	winseln
Flucht	NN	1	Flucht
stieres	ADJA	1	stieres
Reden	NN	1	Redens
Paradies	NN	1	Paradiese
Irrung	NN	1	Irrung
Juchhe	NE	1	Juchhe
Kammer	NN	1	Kammer
ertragen	VVINF	1	ertragen
hassen	VVINF	1	hassen
schmeichelnd	ADJA	1	schmeichelnde
Brod	NE	1	Brod
fromm	ADJD	1	fromm
boshaft	ADJA	1	boshafter
donc	NE	1	donc
Familienname	NN	1	Familienname
kampieren	VVPP	1	kampiert
Dienerin	NN	1	Dienerin
schelten	VVINF	1	schelten
aufbringen	VVIZU	1	aufzubringen
Aufführung	NN	1	Aufführung
ruhik	VVINF	1	ruhik
trouvoient	NN	1	trouvoient
eigensinnig	ADJD	1	eigensinnig
Falsche	NN	1	Falsche
Notwendiges	NN	1	Notwendiges
Schranke	NN	1	Schranken
aussi	NN	1	aussi
karg	ADJD	1	karg
Abzug	NN	1	Abzug
Katzenhäusern	NN	1	Katzenhäusern
Groschen	NN	1	Groschen
Diamant	NN	1	Diamanten
Vollkommenheiten	NN	1	Vollkommenheiten
Mutter	NN	1	Mutter
begierig	ADJD	1	begierig
tragisch	ADJD	1	tragisch
hungrig	ADJD	1	hungrig
maison	NN	1	maison
Erfahrung	NN	1	Erfahrung
Stabsrittmeisters	NN	1	Stabsrittmeisters
unrecht	ADJA	1	unrechten
praktizieren	VVPP	1	praktiziert
Neuigkeit	NN	1	Neuigkeiten
hitzig	ADJD	1	hitzig
geruhet	VVFIN	1	geruhet
Achtung	NN	1	Achtung
Laissés-moi	NE	1	Laissés-moi
explizier	NN	1	explizier
Verfahren	NN	1	Verfahren
Verbrechen	NN	1	Verbrechen
funfzehnhundert	ADJA	1	funfzehnhundert
Juwel	NN	1	Juwelen
Ort	NN	1	Orts
Schöpfer	NN	1	Schöpfer
lüderliches	ADJA	1	lüderliches
infailliblement	NN	1	infailliblement
Hören	NN	1	Hören
getrost	ADV	1	getrost
heften	VVINF	1	heften
Oberste	NN	1	Oberster
küssen	VVINF	1	küssen
hinwerfen	VVINF	1	hinwerfen
unbarmherzig	ADJA	1	unbarmherzigen
verschweigen	VVINF	1	verschweigen
mauen	VVINF	1	mauen
finster	ADJA	1	finstern
Grundsatz	NN	1	Grundsätze
Reich	NE	1	Reich
furchtsam	ADJD	1	furchtsam
bedient	ADJA	1	Bedienten
haften	VVFIN	1	hafte
Taschenbuch	NN	1	Taschenbuch
Schauder|Schaudern	NN	1	Schaudern
wischen	VVFIN	1	wischte
beruhiget	VVFIN	1	beruhiget
bellen	VVFIN	1	belle
maniere	ADJA	1	maniere
beruhigen	VVFIN	1	Beruhigen
Held	NN	1	Helden
necken	VVINF	1	necken
Arglist	NN	1	Arglist
Zukunft	NN	1	Zukunft
rasseln	VVINF	1	rasseln
Nahrung	NN	1	Nahrung
Geschriebene	NN	1	Geschriebenes
schurkisch	ADJA	1	schurkischen
arg	ADJD	1	arg
hervorziehen	VVFIN	1	hervorzieht
Stütze	NN	1	Stütze
muten	VVFIN	1	muten
Auftrag	NN	1	Auftrag
Restchen	NN	1	Restchen
Feldkriegskassen	NN	1	Feldkriegskassen
lenchainer	NE	1	lenchainer
hierdurch	PAV	1	Hierdurch
vexiert	VVFIN	1	vexiert
Katze	NN	1	Katzen
infam	ADJA	1	infame
Rechthaber	NN	1	Rechthaber
tauert	VVFIN	1	tauert
Bestehlen	NN	1	Bestehlen
Rachsucht	NN	1	Rachsucht
garçon	NE	1	garçon
Rentmeister	NN	1	Rentmeister
Könikliken	NN	1	Könikliken
Fehler	NN	1	Fehlers
dadurch	PAV	1	dadurch
Unruhe	NN	1	Unruhen
Schaden	NN	1	Schaden
Suche|Suchen	NN	1	Suchen
weh	ADJD	1	weh
etre	VVFIN	1	etre
getan	ADJA	1	getanen
Wenigkeit	NN	1	Wenigkeit
zusammen	PTKVZ	1	zusammen
stürzen	VVFIN	1	stürzte
Willig	NE	1	Willig
frölik	NN	1	frölik
versiegelt	ADJA	1	versiegelte
austreten	VVINF	1	austreten
Irrtum	NN	1	Irrtum
nehm	VVFIN	1	nehm
Blinde	NN	1	Blinden
schwinden	VVINF	1	schwinden
nähern	VVFIN	1	nähere
Eilikheit	NE	1	Eilikheit
Rücksicht	NN	1	Rücksicht
irgendwo	ADV	1	irgendwo
Unterredung	NN	1	Unterredung
Kostbarkeit	NN	1	Kostbarkeit
hinziehen	VVPP	1	hingezogen
sagit	NE	1	sagit
Treulose	NN	1	Treulosen
hingeritten	ADJD	1	hingeritten
Winspel	NN	1	Winspel
Reitpferd	NN	1	Reitpferde
nützen	VVINF	1	nützen
Gehülfen	NN	1	Gehülfen
reuen	VVINF	1	reuen
gehend	ADJD	1	gehend
bekomms	NN	1	bekomms
widrig	ADJA	1	widriger
urteilen	VVINF	1	urteilen
eingelöset	VVPP	1	eingelöset
bedachen|bedenken	VVPP	1	bedacht
Handbrief	NN	1	Handbrief
Einrichtung	NN	1	Einrichtung
verhärten	VVINF	1	verhärten
herausziehend	ADJD	1	herausziehend
nähernd	ADJD	1	nähernd
fliegend	ADJA	1	fliegenden
vernehmen	VVPP	1	vernommen
Schleifwege	NN	1	Schleifwege
auszahlen	VVPP	1	ausgezahlt
mot	NN	1	mot
allenfalls	ADV	1	allenfalls
Liebhaberin	NN	1	Liebhaberin
Tous	NE	1	Tous
y	ADJA	1	y
veritablement	ADJD	1	veritablement
einsprengen	VVINF	1	einsprengen
propos	ADJA	1	propos
coup	NE	1	coup
beteuern	VVFIN	1	beteuerte
Hindernis	NN	1	Hindernis
reizend	ADJD	1	reizend
Staat	NN	1	Staate
Sittenrichterin	NN	1	Sittenrichterin
danke	PTKANT	1	danke
joue	NE	1	joue
Marino	NE	1	Marino
vermutet	ADJD	1	vermutet
Besitz	NN	1	Besitze
wohlaffektionierter	ADJA	1	wohlaffektionierter
soviele	PIS	1	soviel
uneigennützig	ADJD	1	uneigennützig
Geldeswert	NN	1	Geldeswert
demande	NN	1	demande
Branche	NN	1	Branche
Regimente	NN	1	Regimente
blutjung	ADJD	1	blutjung
weiß	ADJD	1	weiß
weinen	VVPP	1	geweint
Ökonomie	NN	1	Ökonomie
Linke	NN	1	Linken
Geschlechtsnamen	NN	1	Geschlechtsnamen
Adresse	NN	1	adresse
Wunder	NN	1	Wunder
autres	ADJD	1	autres
hinten	ADV	1	Hinten
Bosheit	NN	1	Bosheit
Fußsteige	NN	1	Fußsteige
holdseligste	ADJA	1	holdseligste
anspinnt	VVFIN	1	anspinnt
Allerliebstes	NN	1	Allerliebstes
peu	ADJD	1	peu
Nachtwächter	NN	1	Nachtwächter
Disposition	NN	1	Disposition
ungestüm	ADJA	1	ungestümes
Antlitz	NN	1	Antlitz
Bild	NN	1	bild
verabschiedeter	ADJA	1	verabschiedeter
acht	ADJA	1	Acht
wiederverlange	VVPP	1	wiederverlange
Kaste|Kasten	NN	1	Kasten
entbehren	VVINF	1	entbehren
weis	PTKVZ	1	weis
schwatze	VVFIN	1	schwatze
Entschlossenheit	NN	1	Entschlossenheit
bewerben	VVFIN	1	bewirbt
Gefallen	NN	1	Gefallen
juste	ADJD	1	juste
ausdrücklich	ADJD	1	ausdrücklich
zerstreuet	VVFIN	1	zerstreuet
dulden	VVINF	1	dulden
Beflissenheit	NN	1	Beflissenheit
hergeben	VVPP	1	hergegeben
tout-à-fait	NN	1	tout-à-fait
Menge	NN	1	Menge
Korporals	NN	1	Korporals
Fach|Fächer	NN	1	Fächer
gewesen	ADJA	1	gewesenen
Euern	NN	1	Euern
Hartnäckigkeit	NN	1	Hartnäckigkeit
ratihabierende	ADJA	1	ratihabierende
verschwemmt	VVPP	1	verschwemmt
Wachtmeisterin	NN	1	Wachtmeisterin
weggehen	VVFIN	1	weggingen
Einfalspinse	NN	1	Einfalspinse
spaßen	VVINF	1	spaßen
Anverwandte	NN	1	Anverwandte
gewähret	NE	1	gewähret
Schäkerin	NN	1	Schäkerin
Ehrenwort	NN	1	Ehrenwort
unbiegsamen	ADJA	1	unbiegsamen
glücklichern	NN	1	glücklichern
Betragen	NN	1	Betragen
gesehn	ADJD	1	gesehn
Verlegenheit	NN	1	Verlegenheit
Frauenzimmers	NN	1	Frauenzimmers
unebenes	ADJA	1	unebenes
Tl	NE	1	Tl
nak	ADJA	1	nak
Moräste	NN	1	Moräste
Kapitulation	NN	1	Kapitulation
pour	NN	1	pour
rechtschaffenste	ADJA	1	rechtschaffenste
Versicherung	NN	1	Versicherung
dringen	VVFIN	1	drang
Bursche	NN	1	Bursche
ohnlängst	ADJD	1	ohnlängst
invitir	NE	1	invitir
tapezieren	VVFIN	1	tapeziert
langsam	ADJD	1	langsam
ausschlagen	VVINF	1	ausschlagen
Verweilen	NN	1	Verweilen
Leipzig	NE	1	Leipzig
Ritter	NN	1	Ritter
erfordern	VVPP	1	erfordert
Corriger	NN	1	Corriger
hinreichen	VVFIN	1	hinreicht
Träumerei	NN	1	Träumereien
zankst	VVFIN	1	zankst
ge	ADJD	1	ge
verleihen	VVINF	1	verleihen
wiederkommen	VVFIN	1	wiederkomme
Ehrenstelle	NN	1	Ehrenstelle
Nok	NE	1	Nok
sieben	VVFIN	1	sieben
sparsam	ADJD	1	sparsam
Menschenhasses	NN	1	Menschenhasses
Blendwerk	NN	1	Blendwerk
anhören	VVINF	1	anhören
schlechtrer	ADJA	1	schlechtrer
gemein	ADJA	1	gemeinsten
tuts	NN	1	tuts
abgehen	VVPP	1	abgegangen
Streiches	NN	1	Streiches
Blitz	NN	1	Blitz
verlaufen	VVFIN	1	verlaufen
unruhig	ADJD	1	unruhig
Kunst	NN	1	Künste
nachbrauche	VVFIN	1	nachbrauche
begnügen	VVINF	1	begnügen
Indes	NN	1	Indes
Pflicht	NN	1	Pflicht
Oberst	NN	1	Oberst
gestehen	VVINF	1	gestehen
Zeichnung	NN	1	Zeichnung
Verwahrung	NN	1	Verwahrung
Dienstfertigkeit	NN	1	Dienstfertigkeit
prahlen	VVPP	1	geprahlt
krepieren	VVINF	1	krepieren
chose	NN	1	chose
Stolze	NN	1	Stolze
marterst	VVFIN	1	marterst
ober	ADJA	1	obersten
wiederherstellen	VVPP	1	wiederhergestellt
sûr	NE	1	sûr
Seufzer	NN	1	Seufzer
39	CARD	1	39
darneben	VVFIN	1	darneben
gens	ADJA	1	gens
hereinziehen	VVPP	1	hereingezogen
angehören	VVIZU	1	anzugehören
bestehlen	VVINF	1	bestehlen
wegbleiben	VVINF	1	wegbleiben
dreißig	CARD	1	dreißig
confidence	NE	1	confidence
Inwärts	ADV	1	Inwärts
Frankreich	NE	1	Frankreich
erkläret	VVFIN	1	erkläret
Negligee	NN	1	Negligee
Schnurre	NN	1	Schnurre
Hut	NN	1	Hut
Oberstlieutenant	NE	1	Oberstlieutenant
Narrn	NN	1	Narrn
croyance	ADJD	1	croyance
verschonen	VVFIN	1	Verschonen
heim	PTKVZ	1	heim
sont	ADJA	1	sont
Jammer	NN	1	Jammer
Händel	NE	1	Händel
gemakt	NN	1	gemakt
spaßhafte	ADJA	1	spaßhafte
Nebel	NN	1	Nebel
pontes	ADJA	1	pontes
pantomimisch	ADJD	1	pantomimisch
est-il	ADJD	1	est-il
votre	ADJA	1	votre
Louisdoren	NN	1	Louisdoren
Avancement	NN	1	Avancement
geschieden	ADJA	1	geschiedene
entladen	VVPP	1	entladen
liebenswürdig	ADJA	1	liebenswürdige
Rackers	NN	1	Rackers
Veränderung	NN	1	Veränderung
plauderst	VVFIN	1	plauderst
herauswirft	VVFIN	1	herauswirft
stemmen	VVFIN	1	stemme
waret	ADJD	1	waret
langen	VVFIN	1	langt
öftrer	ADV	1	öftrer
Aufenthalt	NN	1	Aufenthalts
einig	ADJD	1	einig
wirbeln	VVINF	1	wirbeln
ausgenommen	ADV	1	ausgenommen
klar	ADJD	1	klar
tief	ADJD	1	tief
Rammsdorf	NN	1	Rammsdorf
swansik	NN	1	swansik
Stachel	NN	1	Stachel
rechtschaffner	NN	1	rechtschaffner
erstaunen	VVFIN	1	erstaune
faché	ADJD	1	faché
Cadet	NN	1	Cadet
betauere	VVFIN	1	betauere
angeredt	ADJD	1	angeredt
@card@	CARD	1	114
häufen	VVINF	1	häufen
umgehen	VVPP	1	umgegangen
1	CARD	1	1
wundern	VVINF	1	wundern
mündlich	ADJD	1	mündlich
zweitenmale	ADJA	1	zweitenmale
geschlagner	VVFIN	1	geschlagner
Belohnung	NN	1	Belohnung
choses	ADJA	1	choses
festeste	ADJA	1	festeste
Beute	NN	1	Beute
Ausgelernt	NN	1	Ausgelernt
Forderung	NN	1	Forderungen
Pour	NE	1	pour
Car	NE	1	Car
Weigerung	NN	1	Weigerung
Zunge	NN	1	Zunge
Tölpel	NN	1	Tölpel
Kriegsdepartement	NN	1	Kriegsdepartement
hämisch	ADJA	1	hämischen
gutwillig	ADJD	1	gutwillig
Sak	NE	1	Sak
Katz	NN	1	Katz
durchprügelten	VVFIN	1	durchprügelten
einwenden	VVIZU	1	einzuwenden
verknüpfen	VVINF	1	verknüpfen
guignon	NE	1	guignon
Generalkriegskasse	NN	1	Generalkriegskasse
aufkommen	VVPP	1	aufgekommen
voulés	NN	1	voulés
Vieh	NN	1	Vieh
aufzumutzen	VVIZU	1	aufzumutzen
Fröhlichkeit	NN	1	Fröhlichkeit
studiert	ADJA	1	studierte
Katzenbuckel	NN	1	Katzenbuckel
eifersüchtig	ADJD	1	eifersüchtig
Ähnliche	NN	1	Ähnliches
cest	ADJA	1	cest
eigentlichsten	ADJA	1	eigentlichsten
Rumpf	NN	1	Rumpfe
Blick|Blicken	NN	1	Blicken
vorwerfen	VVIZU	1	vorzuwerfen
vorschossen	VVFIN	1	vorschossen
Spandau	NE	1	Spandau
Anfang	NN	1	Anfang
auffangen	VVFIN	1	auffing
sentraider	NE	1	sentraider
heilig	ADJA	1	heiligste
arrivir	NE	1	arrivir
ansehend	ADJD	1	ansehend
umständlich	ADJD	1	umständlich
herauf	PTKVZ	1	herauf
Brieftragens	NN	1	Brieftragens
Vorrecht	NN	1	Vorrecht
Roßarzt	NN	1	Roßarzt
wedeln	VVFIN	1	wedelte
echt	ADJA	1	echter
wunderlich	ADJD	1	wunderlich
Auslegung	NN	1	Auslegung
anzeigend	ADJD	1	anzeigend
sonderlich	ADJD	1	sonderlich
Tier	NN	1	tiers
Zugang	NN	1	Zugänge
Paar	NN	1	Paar
eilends	ADV	1	Eilends
Mutwille	NN	1	Mutwille
Verordnung	NN	1	Verordnungen
überreichen	VVFIN	1	Überreicht
Est-il	NE	1	Est-il
connoissés	NN	1	connoissés
Betrug	NN	1	Betrug
Blatt	NN	1	Blatt
Vorfahr|Vorfahren	NN	1	Vorfahren
verspielen	VVINF	1	verspielen
ringen	VVFIN	1	rang
Zorn	NN	1	Zorn
Subordination	NN	1	Subordination
Kammerjungfer	NN	1	Kammerjungfer
mis	ADJA	1	mis
verschieben	VVINF	1	verschieben
zärtlich	ADJD	1	Zärtlich
Unterpfand	NN	1	Unterpfand
Ungnade	NN	1	Ungnade
wegnehmen	VVPP	1	weggenommen
gelegensten	ADJA	1	gelegensten
urgieret	ADJD	1	urgieret
einreichen	VVIZU	1	einzureichen
lordinaire	NE	1	lordinaire
beziehen	VVFIN	1	bezieht
aushalten	VVINF	1	aushalten
gelegentlich	ADJA	1	gelegentlichen
Kostbarers	NN	1	Kostbarers
ankleideten	VVFIN	1	ankleideten
verbauen	VVFIN	1	verbaute
Bibel	NN	1	Bibel
wos	NE	1	wos
Fuchtel	NN	1	Fuchtel
versetzt	ADJD	1	versetzt
vorstellen	VVFIN	1	vorstelle
Livres	NN	1	Livres
horchen	VVINF	1	horchen
edeln	ADJA	1	edeln
wiegen	VVFIN	1	wiegt
neugierig	ADJD	1	neugierig
Unverschämter	NN	1	Unverschämter
Kauf	NN	1	Kauf
davor	PAV	1	davor
Unbesonnenheit	NN	1	Unbesonnenheit
gebunden	ADJA	1	gebundener
Gebet	NN	1	Gebet
verlorne	ADJA	1	verlorne
gram	ADJD	1	gram
trauen	VVFIN	1	traue
wohlhabend	ADJA	1	wohlhabender
bessern	VVFIN	1	bessern
rechen	VVFIN	1	recht
Feldscher	NN	1	Feldscher
Ottomannische	ADJA	1	Ottomannische
hiermit	PAV	1	hiermit
schleichen	VVPP	1	geschlichen
Schatten	NN	1	Schatten
zerrütten	VVFIN	1	zerrüttet
Marloffin	NE	1	Marloffin
eintreffen	VVFIN	1	eintrifft
verhindern	VVINF	1	verhindern
Gefühl	NN	1	Gefühl
Ausflucht	NN	1	Ausflüchte
tapfer	ADJA	1	tapferste
pavé	NN	1	pavé
blessiert	ADJA	1	blessierten
certaines	ADJA	1	certaines
Venedig	NE	1	Venedig
wärs	NN	1	wärs
zumuten	VVINF	1	zumuten
vergebens	ADV	1	vergebens
hinkommen	VVINF	1	hinkommen
Eigensinne	NN	1	Eigensinne
Stund	NN	1	Stund
Knecht	NN	1	Knecht
Heu	NN	1	Heu
liesest	VVFIN	1	liesest
Christ	NN	1	Christen
umarmend	ADJD	1	umarmend
Winkelzug	NN	1	Winkelzug
Schnur	NN	1	Schnur
verschlagen	VVFIN	1	verschlägt
wegfahren	VVINF	1	wegfahren
heimlich	ADJD	1	heimlich
Nichte	NN	1	Nichte
widerwärtig	ADJA	1	widerwärtige
prellen	VVFIN	1	prellte
kahl	ADJD	1	kahl
ängstlich	ADJD	1	ängstlich
quil	ADJA	1	quil
Straß	NN	1	Straß
Magen	NN	1	Magen
Gespräch	NN	1	Gespräch
geplündert	ADJA	1	geplünderten
allerschlecht	ADJA	1	allerschlechtesten
Generalin	NN	1	Generalin
innerhalb	ADJD	1	innerhalb
Flasche	NN	1	Flasche
Votre	NN	1	Votre
Gesandten	NN	1	Gesandten
Sturm	NN	1	Sturm
entschuldiget	VVFIN	1	entschuldiget
Mores	NN	1	Mores
General	NN	1	General
chambre	ADJD	1	chambre
Erbin	NN	1	Erbin
Kompagnie	NN	1	Kompagnie
Küchenzettel	NN	1	Küchenzettel
wegwenden	VVFIN	1	wegwendet
längst	ADV	1	längst
galant-homme	ADJA	1	galant-homme
durchgehen	VVPP	1	durchgegangen
Posten	NN	1	Posten
Hochachtung	NN	1	Hochachtung
sächsisch	ADJA	1	sächsisches
Eiteln	NN	1	Eiteln
Topp	NN	1	Topp
Resource	NN	1	Resource
Verzweiflung	NN	1	Verzweiflung
unerzogen	ADJA	1	unerzogene
Reiz	NN	1	Reize
sauter	ADJA	1	sauter
retten	VVINF	1	retten
beschenken	VVINF	1	beschenken
Angenehme	NN	1	Angenehmes
Würdigste	NN	1	Würdigste
untersuchen	VVPP	1	untersucht
vermehren	VVINF	1	vermehren
Stern	NN	1	Sterne
mildtätig	ADJA	1	Mildtätigen
zulangen	VVFIN	1	zulangt
Taubenschlage	NN	1	Taubenschlage
Bösewicht	NN	1	Bösewicht
kramen	VVFIN	1	kramen
Lieset	NN	1	Lieset
Freischulzengerichte	NN	1	Freischulzengerichte
martern	VVINF	1	martern
Vorposten	NN	1	Vorposten
wes	ADJA	1	wes
umkehren	VVFIN	1	umkehrt
süß	ADJA	1	süßeste
verzogen	ADJA	1	verzogener
Glückes	NN	1	Glückes
Kugel	NN	1	Kugel
Karte	NN	1	Karte
Krieger	NN	1	Krieger
schwören	VVINF	1	schwören
Gabe	NN	1	Gabe
San	NE	1	sans
fehlend	ADJA	1	fehlende
dennoch	ADV	1	dennoch
ehrlike	ADJA	1	ehrlike
vermutlich	ADJA	1	vermutliche
treffen|triefen	VVPP	1	getroffen
venetianische	ADJA	1	venetianische
abzählen	VVINF	1	abzählen
eintragen	VVINF	1	eintragen
Voilà	ADJD	1	Voilà
makte	ADJA	1	makte
Lüge|Lügen	NN	1	Lügen
Geschick	NN	1	Geschicke
charmant	ADJA	1	charmante
herausgeben	VVINF	1	herausgeben
vorfahren	VVINF	1	vorfahren
avoit	NN	1	avoit
nachgeben	VVFIN	1	nachgibt
Rätsel	NN	1	Rätsel
Zwang	NN	1	Zwanges
aufgekläret	VVPP	1	aufgekläret
Biss	NN	1	Biß
Foderungen	NN	1	Foderungen
hinzusetzen	VVPP	1	hinzugesetzt
lindern	VVFIN	1	lindern
neidisch	ADJD	1	neidisch
Taschenbuche	NN	1	Taschenbuche
vorschießen	VVPP	1	vorgeschossen
Sau	NN	1	Säue
Sommer	NN	1	Sommer
aufstehen	VVPP	1	aufgestanden
Triebfeder	NN	1	Triebfedern
gegeben	ADJA	1	gegebenes
drein	PTKVZ	1	drein
Ami	NN	1	amis
Rausch	NE	1	Rausch
derselb	PDAT	1	desselben
Amt	NN	1	Ämtern
Feldflasche	NN	1	Feldflasche
bedankest	VVFIN	1	bedankest
Kömmst	VVFIN	1	Kömmst
hm	NE	1	Hm
he	ITJ	1	He
Wald	NN	1	Wälder
ausarten	VVFIN	1	ausarte
Wall	NN	1	Wällen
Dauer	NN	1	Dauer
Glanz	NN	1	Glanze
zufolge	APPR	1	Zufolge
Enterbung	NN	1	Enterbung
zweifeln	VVPP	1	gezweifelt
Rührung	NN	1	Rührung
Potz	NN	1	Potz
revanche	VVFIN	1	revanche
überallhin	ADV	1	überallhin
beleuchten	VVINF	1	beleuchten
Lettre	ADJA	1	Lettre
monter	VVFIN	1	monter
Haut	NN	1	Haut
seul	NN	1	seul
Briefschaften	NN	1	Briefschaften
Vortreffliches	NN	1	Vortreffliches
envisager	NN	1	envisager
hierüber	PAV	1	hierüber
erlassen	VVPP	1	erlassen
verirren	VVINF	1	verirren
wendend	ADJD	1	wendend
rapportieren	VVINF	1	rapportieren
Bon	NN	1	Bons
Bestimmung	NN	1	Bestimmung
Lust	NN	1	Lust
