Title: Nathan der Weise
Number of all lemmas: 10391
Nummber of different lemmas: 3174

Lemma	POS	Frequency	Tokens
wohl	ADV, ADJD, PTKVZ	164	wohl, Wohl
gut	ADJD, ADJA	122	gut, besser, guter, gute, guten, Guter, besten, beste, Gut, Gutes, best
wissen	VVFIN, VVINF	117	wißt, Weiß, weiß, wisse, wissen, wüßte, Wißt, wußte
Gott	NN	99	Gott, Gottes
Vater	NN	98	Vaters, Vater, Vätern, Väter
sagen	VVIMP, VVINF, VVFIN, VVPP	97	Sag, sag, sagen, sagt, sagst, Sagt, sage, gesagt, Gesagt, sagte, sagest, sagtet, Sagtest
Nathan	NE	92	Nathan
Bruder	NN	76	Brüder, Bruder, Bruders
euer	PPOSAT	66	Euer, Eure, euer, eure, Eurem, Eures, Eurer
sehen	VVIMP, VVFIN, VVINF, VVPP	60	sieh, sahen, sehen, seht, Sieh, sehe, Seht, sieht, sah, siehst, gesehen
Jude	NN	60	Jude, Juden
gar	ADV	59	gar, Gar
Patriarch	NN	58	Patriarchen, Patriarch
hören	VVINF, VVFIN, VVIMP	58	hören, hört, hör, Hört, hörte, hörst, höre, Hör
Saladin	NE	58	Saladin
Mann	NN, NE	57	Mann, Manne, Mannes, Männer, Männern, Manns
allein	ADV, PTKVZ	56	allein, Allein
erst	ADJA, ADV	55	erste, ersten, Erst, erst, erster
gern	ADV	54	gern, Gern
lieb	ADJD, ADJA	53	lieber, liebes, lieb, liebe, liebsten, liebste, lieben, Lieber
Herr	NN	48	Herrn, Herr, Herren
wär	ADJD, VVFIN	47	wär
Mensch	NN	47	Menschen, Mensch
Sultan	NN	46	Sultan, Sultans
denken	VVINF, VVFIN, VVIMP	46	denken, dachte, Denkt, denkt, denke, dächte, denk, Denk, denkst, dachtet, dächten
nehmen	VVINF, VVIMP, VVFIN, VVPP	46	nehmen, Nimm, nimm, nehmt, Nehmt, genommen, nehme, nahm, Nimmt
kennen	VVINF, VVFIN, VVIMP, VVPP	46	kennen, Kennt, kennt, kenne, Kenn, kennst, gekannt, Kennst, kenn
Tempelherr	NN	44	Tempelherr, Tempelherrn, Tempelherren
Daja	NE	44	Daja
sonst	ADV	44	sonst, Sonst
Christ	NE, NN	44	Christ, Christen
sehnen	VVIMP	42	sehn
Recha	NE, NN	40	Recha
recht	ADJD, PTKVZ	40	rechter, recht, Recht
bald	ADV	40	bald, Bald
wahr	ADJD, ADJA	39	wahr, wahren, wahre, wahrer
ah	ITJ	37	Ah, ah
nie	ADV	36	nie, Nie
freilich	ADV	36	freilich, Freilich
Geld	NN	35	Geld, Gelder, Gelds, Geldes
glauben	VVFIN, VVINF, VVPP	34	glaubte, glaube, glaubt, glauben, Glaubt, glaubst, geglaubt
stehen	VVFIN, VVINF, VVIMP	33	stand, steht, stünde, stehe, stehen, Steht, steh, Steh
gewiss	ADJD, ADJA	32	gewiß, Gewissen, gewissen, Gewiß, Gewisse, gewisser
Kind	NN	31	Kind, Kindern, Kinder, Kinde
Mädchen	NN	30	Mädchens, Mädchen
eben	ADV	30	eben, Eben
Al-Hafi	NE	30	Al-Hafi
Sittah	NE, ADJD	30	Sittah
lieben	VVINF, VVFIN, VVPP, VVIMP	29	lieben, liebt, liebe, geliebt, Lieb
kömmt	ADJD, VVFIN	29	kömmt
Zeit	NN	27	Zeit, Zeiten
heißen	VVINF, VVFIN, VVPP	27	heißen, hieß, heißt, heißet, Heißt, geheißen, heiße, Hieß
wenige	PIAT, PIS	27	wenig, weniger, wenigem
Ring	NN	27	Ring, Rings, Ringes, Ringe
nennen	VVINF, VVFIN, VVIMP, VVPP	27	nennen, Nennt, nennt, nannte, nenn, nennst, nennte, Genannt, Nenn, Nannte
Freund	NE, NN	27	Freund, Freunde, Freunds
Herz	NN	26	Herz, Herzen, Herze, Herzens
Hand	NN	26	Hand, Händen, Hände
bloß	ADJD, ADJA	26	bloß, Bloß, bloßen, bloße
Ritter	NN, NE	26	Ritter, Ritters
weiter	ADV, PTKVZ	26	weiter, Weiter
brauchen	VVFIN, VVIMP, VVINF	25	braucht, brauch, brauche, brauchen, Brauch, brauchst
selber	ADV	25	selber
unser	PPOSAT	25	unsers, unsrer, unserm, unser, Unsrer, Unsers
Haus	NN	25	Haus, Hauses, Hause, Häuser
fragen	VVIMP, VVFIN, VVINF, VVPP	24	frag, fragst, fragen, fragt, gefragt, Frag, Fragst, frage
ichs	ADJD, ADJA	24	ichs
Liebe	NN	24	Liebe
Schwester	NN	23	Schwester
Engel	NN, NE	23	Engel
leben	VVFIN, VVINF, VVIMP	23	lebt, Lebt, leben, leb, lebte, lebet, lebe
retten	VVFIN, VVINF, VVPP	23	rettete, retten, Gerettet, gerettet
itzt	VVFIN, VVIMP, ADJD, NN	22	itzt
Leben	NN	22	Leben, Lebens
er|es	PPER	21	Ihm
Volk	NN	21	Volk, Volkes, Volke
Derwisch	NN	21	Derwisch
ists	VVFIN, ADJD	21	ists
wahrlich	ADV	20	wahrlich, Wahrlich
Tochter	NN	20	Tochter
hätt	VVFIN, VVINF, NN	20	hätt
Weg	NN	20	Weg, Wegen, Wegs, Wege, Weges
finden	VVINF, VVFIN, VVPP	20	finden, fand, gefunden, finde
klein	ADJA, ADJD	19	kleines, kleinste, klein, kleinen, kleiner, Kleine
groß	ADJA, ADJD	19	große, groß, größer, großen, größte, Groß, größten
Dank	NN	19	Dank, Danks, Dankes
Wunder	NN	19	Wunder, Wunders
werd	NE, VVFIN	19	werd, ward
lange	ADV	18	lange
Sache	NN	18	Sache, Sachen
Spiel	NN	18	Spiel, Spieles, Spiele, Spiels
Welt	NN	18	Welt
jung	ADJA, ADJD	18	junger, jung, junge, Junger, jungen
Augenblick	NN	17	Augenblicke, Augenblick, Augenblicken
genug	ADV	17	genug, Genug
Ha	NE	17	Ha
Tag	NN	17	Tage, Tag, Tags
oft	ADV	17	Oft, oft
kaum	ADV	17	kaum, Kaum
Sohn	NN	16	Söhnen, Sohn, Söhne
Wort	NN	16	Wort, Worte, Worts, Worten
verstehen	VVFIN, VVIMP	16	Versteht, Versteh, versteht, versteh, verstehen
kurz	ADJD, ADJA	16	kurz, Kurz, kurzen, kurzem, kurze
spielen	VVINF, VVFIN, VVPP	16	spielen, spiele, spielst, spielt, spielte, gespielt
<UNKNOWN>	NE, NN, VVINF, VVFIN, ADJA, VVPP	16	Vertraun, Stirne, größern, konnt, Ansehn, ansehn, ältern, graden, Konnt, geängstet, Mißtraun
endlich	ADV	16	endlich, Endlich
fühlen	VVFIN, VVINF, VVIMP	16	fühlt, Fühlt, fühlen, fühl, fühlte, fühle
lang	ADJD, ADJA	16	länger, langer, lange, lang
setzen	VVFIN, VVIMP, VVINF, VVPP	16	setzt, Setz, setz, setze, setzen, setzte, Gesetzt, gesetzt
Auge	NN	16	Auge, Augen
vielleicht	ADV	15	Vielleicht, vielleicht
Tat	NN	15	Tat, Taten
Feuer	NN	15	Feuer
Name	NN	15	Name, Namen, Namens
Schach	NN	15	Schach
darum	PAV	15	darum, Darum
verlieren	VVINF, VVFIN, VVPP	15	verlieren, verlor, verloren
arm	ADJA, ADJD	15	Armes, arme, armen, arm, armer, armes
reich	ADJD, ADJA	15	reich, reichen, reichsten, reicher
eins	CARD	15	eins, Eins, einen
fort	PTKVZ, ADV	14	fort, Fort
schwerlich	ADJD	14	schwerlich, Schwerlich
Recht	NN	14	Recht, Rechts
fromm	ADJA, ADJD	14	fromme, fromm, frommer, frömmsten, frommen
Ding	NN	14	Dingen, Ding, Dings, Dinge
holen	VVINF, VVFIN, VVPP, VVIMP	14	holen, holte, geholt, hol, holt
wenigstens	ADV	14	wenigstens, Wenigstens
verlangen	VVFIN, VVPP, VVINF	14	Verlangt, verlangt, verlangen, verlange
kalt	ADJD, ADJA	13	Kalt, kalter, kalt, kalte, Kalte
weise	ADJD, ADJA	13	weise, weisen, weisere, weises
borgen	VVINF, VVFIN	13	borgen, borge, borgt
fehlen	VVFIN, VVINF, VVIMP, VVPP	13	fehlt, fehlen, Fehlt, fehlte, fehl, gefehlt
Gute	NN	13	Gutes, Gute, Guten
Stauffen	NN	13	Stauffen
heuen	VVFIN	13	heut
ruhig	ADJA, ADJD	13	ruhiger, ruhig, Ruhig, ruhige
Euern	NN	13	Euern
Seele	NN	13	Seele
Hafi	NE	13	Hafi
schön	ADJA, ADJD	13	schönen, schön, schöner, schöne
danken	VVFIN, VVINF, VVIMP	13	dankte, danken, danket, dankt, Dank
weisen	VVFIN, VVINF	13	wies, weise, weisen, wiest, Wies
drum	PAV	13	drum, Drum
Christin	NE	12	Christin
bitten	VVFIN, VVINF	12	bittet, bitten, bitte
Grund	NN	12	Grund, Gründen, Gründe, Grunde
ewig	ADJD, ADJA	12	ewig, ewige, ewigen, ewiger
verzeihen	VVFIN, VVIMP	12	Verzeihe, Verzeihet, verzeiht, Verzeih, Verzeiht, verzeih
fallen	VVFIN, VVINF, VVIMP	12	Fiel, fiel, fallen, fall
verbrennen	VVPP, VVFIN, VVINF	12	Verbrannt, verbrannt, verbrannte, verbrennen
Wunsch	NN	12	Wunsch, Wünsche, Wunsches
eh	ADV	12	eh, Eh
bezahlen	VVFIN, VVIMP, VVPP, VVINF	11	bezahlen, Bezahl, bezahl, bezahlt
niemand	PIS	11	niemand
drei	CARD	11	drei
Palme	NN	11	Palmen
einzig	ADJA, ADJD	11	einziger, einzige, einzig, einzigen
suchen	VVIMP, VVFIN, VVPP, VVINF	11	such, sucht, gesucht, suchen, suche, Such, Sucht
Assad	NE	11	Assad
Rat	NN	11	Rat
Ei	NN	11	Ei
leicht	ADJD	11	leicht, leichter, Leicht
Himmel	NN	11	Himmel, Himmels
Rechas	NN, NE	11	Rechas
Wahrheit	NN	11	Wahrheit
vergessen	VVFIN, VVPP, VVINF	10	Vergeßt, Vergißt, vergessen, vergißt
Blut	NN	10	Blut, Bluts
tragen	VVFIN, VVINF, VVIMP	10	trug, tragen, trägt, tragt, Trag, trage
schenken	VVINF, VVFIN, VVPP	10	schenken, schenkst, geschenkt, schenkte, schenke
schämen	VVINF, VVFIN, VVIMP	10	schämen, schäme, schäm, schämt
Muselmann	NN	10	Muselmann
führen	VVINF, VVFIN	10	führen, führt
Glaube	NN	10	Glauben, Glaube, Glaubens
Bettler	NN	10	Bettler, Bettlern
schlagen	VVINF, VVFIN	10	schlagen, schlägt, schlägst, schlagt, Schlug
geschwind	ADJD	10	geschwind, geschwinder, Geschwind
Dienst	NN	10	Dienst, Dienste, Diensten
fast	ADV	10	Fast, fast
voll	ADJA, ADJD	10	volle, vollem, Voll, voll, voller, vollen
warten	VVFIN, VVPP, VVINF	10	Warte, Wartet, gewartet, warten, warteten, wartet
Gefahr	NN	10	Gefahr
zurück	PTKVZ, ADV	10	zurück, Zurück
Glück	NN	10	Glück, Glücks
sicher	ADJD	9	sicher, Sicher
übel	ADJD	9	übel
weniger	ADV	9	weniger
Mantel	NN	9	Mantel, Mantels
Gang	NN	9	Ganges, Gang
Vernunft	NN	9	Vernunft
rufen	VVFIN, VVINF, VVIMP	9	rief, rufen, ruf, ruft
erzählen	VVFIN, VVINF, VVIMP	9	erzählen, erzählt, erzähl, erzähle
gehören	VVFIN	9	gehört, Gehört
stolz	ADJD, ADJA	9	Stolz, stolz, stolzen, stolze
hoffen	VVINF, VVPP, VVFIN, VVIMP	9	hoffen, gehofft, hoffte, hoff, hofft
Fall	NN	9	Fall
wert	ADJD	9	wert
Geduld	NN	9	Geduld
lehren	VVPP, VVFIN, VVINF	9	gelehrt, lehrt, Lehrt, Gelehrt, lehren
erfahren	VVFIN, VVPP, VVIMP, VVINF	9	erfuhr, erfahren, erfahr, erfährt
eilen	VVFIN, VVINF	9	eilt, eile, Eilt, eilen
edel	ADJA, ADJD	9	edle, Edler, edler, edel
seh	FM, NE	9	seh
weiß	ADJA, ADJD	9	weißen, Weißem, weiße, Weiß, weißem, weiß
Bild	NN	9	Bild, Bilder, Bilde
Euerm	NE, NN	9	Euerm
indes	ADV	9	indes, Indes
dünken	VVFIN, VVINF, VVPP	9	dünkt, dünken, Deucht
Jud	NE, NN	9	Jud
Kopf	NN	9	Kopf
wünschen	VVFIN, VVPP, VVIMP	9	Wünscht, wünschte, gewünscht, Wünsch, wünsche, wünscht
zwei	CARD	9	zwei
seit	KOUS, APPR	9	Seit, seit
treten	VVFIN, VVPP	9	trat, trete, treten, Tretet, getreten, Tritt, tritt
sterben	VVFIN, VVPP, VVINF	8	sterben, stirbt, starb, gestorben
Weise	NN	8	Weise, Weisen
frei	ADJD, ADJA, PTKVZ	8	frei, freien, freier, freiem
Curd	NE	8	Curd
tot	ADJD, ADJA	8	tot, toten
Gewalt	NN	8	Gewalt
Königin	NN	8	Königin, Königinnen
vielmehr	ADV	8	Vielmehr, vielmehr
brav	ADJD, ADJA	8	Brav, brav, braven, braver
Schuld	NN	8	Schulden, Schuld
Grab	NN	8	Grab, Gräber, Gräbern, Grabe
stecken	VVFIN, VVINF, VVPP	8	steckt, stecken, gesteckt, Gesteckt
Beste	NN	8	Besten, Beste, Bestes
schweigen	VVIMP, VVFIN	8	schweig, schweige, schweigt
schlimm	ADJA, ADJD	8	Schlimmer, schlimm, schlimmes, schlimmsten, schlimmster, schlimmer, Schlimm
ei	NE, FM	8	Ei
bitt	VVFIN	8	bitt
freuen	VVINF, VVFIN, VVPP, VVIMP	8	freuen, freut, freue, freuet, gefreut, freu
fallen|fällen	VVFIN	8	fällt, Fällt
Jahr	NN	8	Jahre, Jahren
Wolf	NE, NN	8	Wolfs, Wolf
Tod	NN	8	Tod, Tode, Todes
weißen	VVFIN	8	weißt
werfen	VVFIN, VVPP, VVINF	8	wirft, warf, geworfen, werfen
Stein	NN	8	Steinen, Steine, Stein, Steins
tausend	CARD	8	tausend
jen	PDAT, PDS	8	jene, jenem, jenen, jener
dank	APPR	8	Dank, dank
stehn	ADJD, VVFIN	8	stehn
reden	VVINF, VVFIN	8	reden, redet, rede
klug	ADJD	8	klug, klüger
Natur	NN	8	Natur
Feind	NN	8	Feind, Feinde
Stelle	NN	8	Stelle
Christenkind	NN	8	Christenkind, Christenkinder
Weib	NN	8	Weib, Weiber, Weibern
handeln	VVINF, VVFIN	8	handeln, handle, handelt
erkennen	VVFIN, VVINF, VVIMP	8	erkennt, erkennen, erkenn
Richter	NN	7	Richter, Richters
Seite	NN	7	Seite, Seiten
Jüdin	NN	7	Jüdin
Tugend	NN	7	Tugend
Ende	NN	7	Ende
lesen	VVFIN, VVINF, VVPP	7	lese, lesen, gelesen
halt	ADV	7	halt, Halt
vertrauen	VVINF, VVFIN, VVIMP	7	vertrauen, vertraue, Vertraut, vertrau
schnell	ADJD, ADJA	7	Schnell, schnell, schneller
Mund	NN	7	Mund, Munde
zugleich	ADV	7	zugleich, Zugleich
wozu	PWAV	7	Wozu, wozu
schicken	VVFIN, VVINF	7	Schickt, schicken, schicke, schickt
richtig	ADJD	7	richtig, Richtig
Wär	ADJD, NN, VVFIN	7	Wär
treffen	VVINF, VVFIN	7	treffen, traf, trefft, trifft
wagen	VVFIN, VVIMP, VVINF	7	wagte, wag, wagen, wage
Mutter	NN	7	Mutter
treiben	VVINF, VVFIN	7	treiben, treibt, Treibt
stürzen	VVFIN	7	stürzte, stürzt
gehören|hören	VVPP	7	gehört, Gehört
stellen	VVINF, VVFIN	7	stellen, stellt, Stellt
schaffen	VVIMP, VVINF, VVFIN	7	schaff, schaffen, schafft
Geheimnis	NN	7	Geheimnis
Stimme	NN	7	Stimme
Land	NN	7	Länder, Land, Landes, Lande
Feur	NN	7	Feur
umsonst	ADV	7	Umsonst, umsonst
entdecken	VVPP, VVFIN, VVINF	7	entdeckt, entdecke, Entdeckt, entdecken
Gelegenheit	NN	7	Gelegenheit
Blick	NN	7	Blick, Blicks
recht|rechts	ADJA	6	rechte
warm	ADJD, ADJA	6	warm, warmen, wärmster
laß	ADJD	6	laß
Nathans	NE, ADJA, NN	6	Nathans
plötzlich	ADJD	6	plötzlich, Plötzlich
unterscheiden	VVINF, VVFIN	6	unterscheiden, unterscheidet
Gedanke	NN	6	Gedanken, Gedanke
laufen	VVFIN, VVIMP	6	laufe, lauft, lauf
Fuß	NN	6	Füßen, Fuß
Kloster	NN	6	Kloster
wenig	ADV	6	wenig
Reichtum	NN	6	Reichtum, Reichtümer, Reichtums
Ists	NN, NE	6	Ists
gewinnen	VVFIN, VVINF, VVPP	6	gewinnt, gewinnen, gewann, gewonnen
gönnen	VVFIN, VVINF	6	gönnst, gönnen, gönnt
leer	ADJD, ADJA	6	leerer, leer, leeren
zeihen|ziehen	VVFIN	6	zieht, ziehst, Zieht
Wahn	NN	6	Wahn, Wahne
verschmähen	VVFIN, VVPP	6	verschmäht, Verschmäht
bestellen	VVPP, VVINF	6	bestellt, bestellen
Berg	NN	6	Berge, Berg
schaden	VVFIN, VVINF	6	schadet, schaden
Filneck	NN	6	Filneck
würdig	ADJD, ADJA	6	würdig, würdiger
drücken	VVINF, VVFIN, VVPP	6	drücken, drückte, gedrückt, drückt
schuldig	ADJD	6	schuldig
untern	APPRART	6	untern
schlecht	ADJD	6	schlecht, schlechter
gehn	VVINF, VVFIN, ADJD	6	gehn
helfen	VVFIN, VVINF, VVPP	6	hilft, helfen, geholfen
Schwert	NN	6	Schwerte, Schwert
König	NN, NE	6	Könige, König
unsre	PPOSAT	6	unsern, unsre
krank	ADJD	6	krank
sogleich	ADV	6	sogleich, Sogleich
erinnern	VVPP, VVINF, VVFIN	6	erinnert, erinnern, erinnerst, Erinnert
gibts	NN	6	gibts
minder	ADJD	6	minder
wohin	PWAV	6	wohin, Wohin
Kleinigkeit	NN	6	Kleinigkeit, Kleinigkeiten
aufs	APPRART	6	aufs
Geckerei	NN	6	Geckerei
gnug	ADJD, NN	6	gnug
mirs	ADJD	6	mirs
irren	VVIMP, VVFIN, VVINF	6	irr, irre, irrst, irrte, irren
vorbei	ADV, PTKVZ	6	vorbei, Vorbei
erlauben	VVPP, VVFIN, VVINF	6	Erlaubt, Erlaubst, erlauben, erlaubt
bekommen	VVINF, VVFIN	6	bekommen, bekam
weder	KON	6	weder
verlassen	VVIMP, VVPP, VVFIN	6	verlaß, verlassen, Verlassen, verläßt, verließ
Jerusalem	NE	6	Jerusalem
erwarten	VVINF, VVPP	6	erwarten, erwartet
Not	NN	6	Not
gestehen	VVFIN, VVINF	6	Gesteht, gestehen, gesteht, gestand
Gut	NN	6	Gut, Gütern
ach	ITJ	6	Ach
heiß	ADJA, ADJD	6	heißen, heiße, heiß
wandeln	VVINF, VVFIN	6	wandeln, wandelt, wandle
Rede	NN	6	Rede
Judenmädchen	NN	6	Judenmädchen
etwa	ADV	6	etwa
stets	ADV	6	stets
Träne|Tränen	NN	6	Tränen
selten	ADV, ADJD	6	selten
Brautkleid	NN	6	Brautkleid
schwärmen	VVFIN, VVPP	5	schwärmt, geschwärmt, schwärmen
drauf	PAV	5	drauf
dienen	VVINF, VVPP	5	dienen, gedient
Kindheit	NN	5	Kindheit
Wasser	NN	5	Wasser
Recht|Rechte	NN	5	Rechte, Rechten
Posse	NN	5	Possen, Posse
versprechen	VVIMP, VVINF, VVFIN	5	versprich, versprechen, Versprach, verspricht, verspreche
Wille	NN	5	Wille, Willen
klingen	VVFIN	5	klänge, klingt, klang
Arm|Arme	NN	5	Armen, Arme
legen	VVINF, VVIMP, VVPP	5	legen, leg, gelegt
Eindruck	NN	5	Eindruck
Conrad	NE	5	Conrad
Spott	NN	5	Spott
Gewesen	NN	5	Gewesen
Kasse	NN	5	Kasse
Zweifel	NN	5	Zweifel
manche	PIAT	5	manche, manchem, manches, manch
bereit	ADJD	5	bereit, Bereit
Argwohn	NN	5	Argwohn
verdienen	VVINF, VVIMP, VVFIN	5	verdienen, verdien, verdiente
nu	ITJ	5	nu, Nu
gehorchen	VVINF, VVFIN	5	gehorchen, Gehorcht, gehorche
fassen	VVFIN, VVPP, VVINF	5	faßt, gefaßt, fassen
töten	VVFIN, VVPP, VVINF	5	Töte, tötet, getötet, töten
böse	ADJA	5	böser, böse, bösen
Buch	NN	5	Buch, Büchern, Bücher
erweisen	VVPP, VVINF, VVFIN	5	erwiesen, erweisen, Erwiesen
Euers	NN	5	Euers
Beutel	NN	5	Beutel
zweit	ADJA	5	zweiten, zweiter, zweite
doppelt	ADJD, ADJA	5	doppelt, doppeltes
merken	VVINF, VVFIN	5	merken, merkt, merke
Ägypten	NE	5	Ägypten
dergleichen	PIS	5	dergleichen
Christenheit	NN	5	Christenheit
rechnen	VVPP, VVFIN, VVINF	5	gerechnet, rechnet, rechnen
Briefchen	NN	5	Briefchen, Briefchens
alt	ADJA, ADJD	5	alter, alt, alte
besitzen	VVFIN	5	besitzt, besitze, besaß, Besitzt, besitzen
Aug	NE	5	Aug
Schatz	NN	5	Schatzes, Schatz, Schätze
nämliche	ADJD	5	nämliche
überall	ADV	5	überall
zusammen	PTKVZ, ADV	5	zusammen, Zusammen
vernehmen	VVPP, VVINF	5	vernommen, vernehmen
brechen	VVFIN, VVPP	5	Brach, bricht, gebrochen, brach
Bote	NN	5	Bote, Boten
beschwören	VVFIN, VVINF	5	beschwor, beschwören, beschworen
weinen	VVINF, VVPP, VVFIN	5	weinen, geweint, Geweint, weinst
besondern	VVFIN	5	besondern, besondre
Zug	NN	5	Zug
wiederkommen	VVFIN, VVINF	5	wiederkommt, wiederkommen, wiederkomme
möcht	VVFIN	5	möcht
horchen	VVIMP, VVINF, VVFIN	5	horch, horchen, horcht
bilden	VVPP, VVFIN, VVINF	5	gebildet, Bildet, bilden, bildete
Zins	NN	5	Zinsen, Zins
Richard	NE	5	Richards, Richard
Ernst	NN, NE	5	Ernst
ziemen	VVFIN	5	Ziemte, ziemt
Entschluss	NN	5	Entschlüsse, Entschluß
Geist	NN	5	Geist
längst	ADV	5	längst
weg	ADV, PTKVZ	5	Weg, weg
süß	ADJA, ADJD	5	süßen, süß, süße, süßes
Kraft	NN	5	Kraft, Kräfte
womit	PWAV	5	womit, Womit
vermutlich	ADV	5	Vermutlich, vermutlich
Ohr	NN	5	Ohr
fahren	VVFIN, VVINF, VVIMP	5	fuhr, fahren, Fahret, fahr
Sünde	NN	5	Sünde, Sünden
würd	VVFIN, ADJD	5	würd
nieder	PTKVZ, ADJD	4	nieder
vertraut	ADJD, ADJA	4	vertraut, vertrautes, vertraute
ungefähr	ADJD	4	ungefähr
Vorteil	NN	4	Vorteil, Vorteile
Blume	NN	4	Blumen, Blume
wovon	PWAV	4	wovon, Wovon
hierher	PAV, ADV	4	hierher, Hierher
erziehen	VVPP	4	erzogen
Fürst	NN	4	Fürsten, Fürst
vorgehen	VVFIN	4	vorgeht
leihen	VVINF, VVFIN	4	leihen, leiht
Gern	NE	4	Gern
Einfalt	NN	4	Einfalt
lächeln	VVFIN, VVINF	4	Lächelt, lächelt, lächeln
gefangen	PTKVZ	4	gefangen
Prinzessin	NN	4	Prinzessin
stehlen	VVFIN, VVINF, VVPP	4	stiehlt, stehlen, gestohlen
Geschlecht	NN	4	Geschlechts, Geschlechte
Springer	NN	4	Springer
brennen	VVFIN, VVINF	4	brannte, brennen, brennt, brenne
Stolz	NN	4	Stolz, Stolzes
Beifall	NN	4	Beifall
Versprechen	NN	4	Versprechen
He	NE	4	He
fern	ADJD	4	ferner, fern
leiden	VVFIN	4	litt, leidet, litte
Fenster	NN	4	Fenster
ergründen	VVINF, VVFIN, VVPP	4	ergründen, ergründet
Gekommen	NN	4	Gekommen
Pferd	NN	4	Pferd, Pferde
Absicht	NN	4	Absicht
schleppen	VVFIN, VVINF	4	schleppt, schleppen, schleppte
annehmen	VVPP, VVIZU	4	angenommen, anzunehmen
Unruh	NN	4	Unruh
meiste	PIS	4	meisten
Geck	NN	4	Geck, Gecken
Kamel	NN	4	Kamele, Kamelen
dachen	VVFIN	4	Dacht, dacht
Stand	NN	4	Standes, Stande, Stand
gilts	NN	4	gilts
wirken	VVFIN, VVPP	4	Wirkt, wirken, wirkt, gewirkt
ähnlich	ADJD	4	ähnlich
sonderbar	ADJD, ADJA	4	sonderbar, sonderbaren
ohnedem	VVFIN, ADJD	4	ohnedem
lernen	VVINF, VVPP, VVFIN	4	lernen, gelernt, lernte, lernt
schwer	ADJD, PTKVZ	4	schwer, schwerer
Wert	NN	4	Wert
Pfand	NN	4	Pfand
kämpfen	VVFIN, VVINF	4	kämpft, kämpfen
wärs	NN, ADJD, VVFIN	4	wärs
siegen	VVINF, VVFIN	4	siegen, siegt
begegnen	VVFIN, VVINF, VVPP	4	begegnet, begegnen
Hats	NN	4	Hats
entgegen	PTKVZ, APPO	4	entgegen
nötig	ADJD	4	nötig
fein	ADJD, ADJA	4	fein, feine
Meinung	NN	4	Meinung
ohn	VVFIN	4	ohn
gleichwohl	ADV	4	gleichwohl, Gleichwohl
Traum	NN	4	Traums, Traume, Träume
Hirn	NN	4	Hirn, Hirns
Reich|Reiche|Reichen	NN	4	Reichen
rächen	VVINF, VVFIN	4	rächen, rächt
Gewissen	NN	4	Gewissen
Libanon	NE	4	Libanon
heiter	ADJA, ADJD	4	heitre, heitern, heiter
nimmermehr	ADV	4	Nimmermehr, nimmermehr
Mönch	NN	4	Mönch
wofür	PWAV	4	wofür, Wofür
Märchen	NN	4	Märchen
Mansor	NN	4	Mansor
find	VVFIN	4	find
Sorge	NN	4	Sorge
Betrieger	NN	4	Betrieger
sitzen	VVFIN, VVINF, VVPP	4	sitzen, gesessen, saß
hinter	APPR	4	hinter
allgemein	ADJA, ADJD	4	allgemeine, allgemein, allgemeinen
fürcht	VVFIN	4	fürcht
Gesicht	NN	4	Gesichter, Gesicht
Verlust	NN	4	Verlust, Verlusts
gesehn	VVFIN, ADJD	4	gesehn
fallen|gefallen	VVPP	4	gefallen
taugen	VVFIN	4	taugt, Taugt
geschehen	VVFIN, VVINF	4	geschieht, geschehen, Geschieht
Saladins	NN	4	Saladins
irgend	ADV	4	irgend
begreifen	VVFIN, VVPP, VVINF	4	Begreifst, begreife, begriffen, begreifen
heraus	ADV	4	heraus, Heraus
echt	ADJA, ADJD	4	echten, echt, echte
Tier	NN	4	Tier, Tieres
Religion	NN	4	Religionen, Religion
zeigen	VVINF, VVFIN	4	zeigen, zeigt
gefallen	VVINF, VVFIN	4	gefallen, Gefiel, Gefällt, gefiel
mags	NN	4	mags
Gesetz	NN	4	Gesetz, Gesetzes
sparen	VVINF, VVFIN	4	sparen, Spart
überlegen	VVINF, VVFIN, VVPP	4	überlegen, überlegt
Rechnung	NN	4	Rechnung
Stadt	NN	4	Stadt
wild	ADJA	4	wilden, Wilder
Orden	NN	4	Orden, Ordens
verlernen	VVINF, VVFIN, VVPP	4	verlernen, verlernt
Unsinn	NN	4	Unsinn
Ohn	VVFIN, ADJA	4	Ohn
verkennen	VVPP, VVFIN	4	verkannt, Verkennt, verkennt
herrlich	ADJD	4	herrlicher, Herrlich, herrlich
Wüste	NN	4	Wüsten, Wüste
übrig	ADJD, ADJA	4	übrig, übrige
hm	NE	4	Hm, hm
Vorsicht	NN	4	Vorsicht
loben	VVINF	4	loben
genau	ADJD	4	genau, genauer
Klosterbruder	NN	4	Klosterbruder
Ehr	TRUNC	3	Ehr
hats	NN, VVFIN	3	hats
betteln	VVINF, VVPP	3	betteln, gebettelt
pflegen	VVFIN, VVIMP, VVPP	3	Pflegen, Pfleg, gepflegt
verfolgen	VVINF	3	verfolgen
fleißig	ADJD	3	fleißig
Kleid	NN	3	Kleid
Geschäft	NN	3	Geschäft, Geschäfte
Hülfe	NN	3	Hülfe
trefflich	ADJD, ADJA	3	trefflich, trefflichen
Gestalt	NN	3	Gestalt
falsch	ADJD, ADJA	3	falsch, falschen
entreißen	VVINF, VVFIN, VVPP	3	entreißen, entreißt, entrissen
unendlich	ADJD	3	unendlich, Unendlich
kömmst	VVFIN	3	kömmst
bitter	ADJA, ADJD	3	bittern, bitter
nahe	PTKVZ	3	nahe
Vergnügen	NN	3	Vergnügen
treu	ADJD	3	Treu
geizig	ADJD, ADJA	3	geizig, geiziger, geizigen
Lächeln	NN	3	Lächeln
Geburt	NN	3	Geburt
bar	ADJD, ADJA	3	bar, baren
schreiben	VVFIN, VVPP	3	schreibet, Geschrieben, geschrieben
fangen	VVPP, VVFIN	3	gefangen, fängt, Fangt
erhalten	VVFIN, VVINF	3	erhielt, erhält, erhalten
fürchten	VVFIN	3	fürchte, fürchtet
zuverlässig	ADJD	3	zuverlässig
wider	APPR	3	wider
fest	ADJD, PTKVZ, ADJA	3	fester, fest, festen
Deutsche	NN	3	Deutscher, Deutschen
Vorurteil	NN	3	Vorurteilen, Vorurteile
Wink	NN	3	Wink
schließen	VVFIN	3	schließt
beßrer	NN, ADJA	3	beßrer
Leidenschaft	NN	3	Leidenschaft
Brüderchen	NN	3	Brüderchen
Arm	NN	3	Arm
Stell	NN	3	Stell
verschwinden	VVFIN, VVPP	3	verschwand, verschwunden
verschweigen	VVFIN, VVINF	3	verschweigt, verschweigen
Bubenstück	NN	3	Bubenstück
kosten	VVINF, VVFIN, VVPP	3	kosten, kostet, gekostet
woran	PWAV	3	Woran, woran
drüber	PAV	3	drüber
mitbringen	VVPP	3	mitgebracht
dritt	ADJA	3	dritte, dritter, dritten
Freundin	NN	3	Freundin
stutzen	VVINF, VVFIN	3	stutzen, stutzt
entlassen	VVFIN, VVPP	3	Entlaßt, entlassen, entließ
Deutschland	NE	3	Deutschland
Phantasie	NN	3	Phantasie
taufen	VVPP	3	getauft, Getauft
quälen	VVFIN, VVPP, VVINF	3	quält, gequält, quälen
deswegen	PAV	3	Deswegen, deswegen
erbieten	VVPP, VVFIN	3	erboten, erbot
wohlan	ADV	3	Wohlan
sogar	ADV	3	sogar, Sogar
Seel	ADJA, TRUNC, VVFIN	3	Seel
Entzücken	NN	3	Entzücken
Glut	NN	3	Glut
Neugier	NN	3	Neugier
verachten	VVINF, VVFIN	3	verachten, Verachtet
Verdacht	NN	3	Verdacht
Verderben	NN	3	Verderben
still	ADJD, PTKVZ	3	still
stimmen	VVFIN, VVINF	3	stimmt, stimmen
reif	ADJD, ADJA	3	reif, reifen
erkunden	VVINF, VVFIN	3	erkunden, Erkundete
Münze	NN	3	Münze
Überschuss	NN	3	Überschuß
Kurz	NE	3	Kurz
vollends	ADV	3	Vollends, vollends
Hals	NN	3	Hals, Halse
Bescheidenheit	NN	3	Bescheidenheit
Kerl	NN	3	Kerl
Bitte	NN	3	Bitte
Kömmt	NN	3	Kömmt
Erhalten	NN	3	Erhalten
Krone	NN	3	Krone
verlegen	VVINF	3	verlegen
geb	NE, VVFIN	3	geb
Krank	NE	3	Krank
Babylon	NE	3	Babylon
einst	ADV	3	einst
Boden	NN	3	Boden
Ort|Orten	NN	3	Orten
Güte	NN	3	Güte
bedienen	VVINF, VVPP	3	bedienen, Bedienen, Bedient
teilen	VVPP, VVFIN	3	geteilt, teile, teilten
sauer	ADJD	3	sauer, saurer
zittern	VVFIN, VVPP, VVINF	3	zittert, gezittert, zittern
schonen	VVFIN	3	schonet, Schonet, schone
vergeben	VVFIN, VVINF, VVIMP	3	vergebt, vergeben, vergib
rauh	ADJD, ADJA	3	rauh, rauhe, rauhen
oh	ITJ	3	oh, Oh
Büchelchen	NN	3	Büchelchen
Itzt	NN	3	Itzt
sterbend	ADJD	3	sterbend
bergen	VVINF	3	bergen
stark	ADJA, ADJD	3	starken, stark, stärker
los	ADJD	3	los
Zeichen	NN	3	Zeichen
Töchterchen	NN	3	Töchterchen, Töchterchens
Künstler	NN	3	Künstler, Künstlers
Hof	NN	3	Hofe, Hof
zanken	VVINF, VVFIN	3	zanken, zankt
sodann	ADV	3	Sodann, sodann
Traun	NN, NE	3	Traun
begleiten	VVPP, VVFIN	3	begleitet, Begleitet, begleite
laut	APPR, ADJD, ADJA	3	Laut, lauter, laute
Gnade	NN	3	Gnade
Europa	NE	3	Europa
Ins	NE	3	Ins
widersprechen	VVFIN, VVINF	3	widerspricht, widersprechen
deutlich	ADJD, ADJA	3	deutlich, deutlichsten
kaufen	VVPP, VVFIN	3	gekauft, Kaufe
Schwesterchen	NN	3	Schwesterchen
Leib	NN	3	Leib
Blanda	NE	3	Blanda
gebären	VVPP	3	geboren
Schritt	NN	3	Schritte, Schritt
zufrieden	ADJD	3	zufrieden
schaudern	VVFIN	3	Schaudert, schaudert
Sinai	NE	3	Sinai
Raub	NN	3	Raub
bedenken	VVINF, VVFIN	3	bedenken, bedenkt
untersuchen	VVFIN, VVINF	3	untersucht, untersuchen
schlafen	VVFIN, VVINF, VVPP	3	schläft, schlafen, geschlafen
erlügen	VVPP	3	Erlogen, erlogen
Freude	NN	3	Freude, Freuden
versuchen	VVPP, VVINF	3	versucht, versuchen
hübsch	ADJD, ADJA	3	hübsch, hübschen, hübsche
Ursach	NE, NN	3	Ursach
Assads	NE, NN	3	Assads
drängen	VVFIN, VVINF	3	drängt, drängen, Drängt
Fehler	NN	3	Fehler, Fehlern
schwören	VVINF, VVFIN	3	schwören, schwur
zwingen	VVPP, VVINF, VVFIN	3	gezwungen, zwingen, zwingt
Ibrahim	NE	3	Ibrahim
Freundschaft	NN	3	Freundschaft
erraten	VVFIN, VVPP	3	erriet, Erraten, Errätst
sichtbar	ADJD	3	sichtbar
bemerken	VVINF, VVPP, VVFIN	3	bemerken, bemerkt, Bemerkte
gelingen	VVFIN, VVINF	3	gelänge, gelingt, gelingen
Kummer	NE	3	Kummers, Kummer
Streich	NN	3	Streich
Staat	NN	3	Staat
sanft	ADJA	3	sanfte, sanfter
Horch	NE	3	Horch
Rettung	NN	3	Rettung
Gefallen	NN	3	Gefallen
auferzogen	VVFIN	3	auferzogen
Luft	NN	3	Luft
Böse	NN	3	Bösen, Böses
Stuhl	NN	3	Stuhle, Stuhl
Schurke	NN	3	Schurken
Fittiche	NN	3	Fittiche
lenken	VVFIN, VVIMP, VVINF	3	lenkt, Lenk, lenken
sieben	CARD	3	sieben, Sieben
Ruhm	NN	3	Ruhm
gemein	ADJA	3	Gemeinen, gemeinen, gemeiner
tuts	NN	3	tuts
frisch	ADJD	3	frisch
jagen	VVFIN	3	jagt
Geboren	NN	3	Geboren
Fleck	NN	3	Fleck
Hut	NN	3	Hut
erklären	VVPP, VVFIN, VVIMP	3	erklärt, Erklärt, Erklär
schmeicheln	VVFIN, VVPP	3	schmeichelt, geschmeichelt
zwischen	APPR	3	zwischen
Philipp	NE	3	Philipp
bins	VVFIN, NE	3	bins
Ehgemahl	NN	3	Ehgemahl
winken	VVFIN, VVINF	3	winkte, winken, winkt
überrasch	VVFIN, NN	3	überrasch
Beispiel	NN	3	Beispiel
bieten|gebieten	VVPP	3	geboten
matt	ADJD	3	matt
Teil	NN	3	Teil, Teile
verächtlich	ADJD	3	verächtlich, Verächtlich
Vorrecht	NN	3	Vorrecht
Frau	NN	3	Frau
Staub	NN	3	Staub, Staube
Kleidung	NN	3	Kleidung
Melek	NE	3	Melek
Geschwister	NN	3	Geschwister
jemand	PIS	3	jemand
einander	PRF	3	einander
nachschicken	VVPP	3	nachgeschickt
Könnt	NN, VVFIN	3	Könnt
Kundschaft	NN	3	Kundschaft
Gebet	NN	3	Gebete, Gebet
trauen	VVFIN, VVIMP	3	traue, Trau, Traut
bessern	VVFIN, VVINF	3	bessern
fremd	ADJD, ADJA	3	fremd, fremde
Stoff	NN	3	Stoff, Stoffen
Verloren	NN	3	Verloren
besinnen	VVIMP, VVFIN	3	Besinn, besann
Haupt	NN, NE	3	Haupt
betreten	VVINF, VVPP	3	betreten
Gespräch	NN	3	Gespräch
kleiden	VVINF, VVFIN	3	kleiden, kleidet
ändern	VVINF, VVFIN	3	ändern, ändert
nahen	VVFIN	3	nahte, naht, nahten
Mags	NN	3	Mags
sinds	NN, ADJD	3	sinds
dreist	ADJD, ADJA	3	dreist, dreisten
neidisch	ADJD	3	neidisch, Neidisch
geheim	ADJA, ADJD	3	geheimes, geheime, geheim
Frevel	NN	3	Frevel, Frevels
Laienbruder	NN	3	Laienbruder
Nachricht	NN	3	Nachricht
Jüngling	NN	3	Jüngling
ungeachtet	APPR, APPO	3	ungeachtet
wüßt	VVFIN	2	wüßt
Dattel	NN	2	Datteln
hatt	VVFIN	2	hatt
steigen	VVINF, VVFIN	2	steigen, steigt
euerm	ADJA, NE	2	euerm
Platz	NN	2	Platz, Platze
Unrecht	NN	2	Unrecht
Irdische	NN	2	Irdischer, Irdischen
Christus	NN	2	Christus
träumen	VVFIN, VVPP	2	Träumst, Geträumt
Sach	NE	2	Sach
wahrhaftig	ADJD	2	wahrhaftig, Wahrhaftig
Forscher	NN	2	Forschers, Forscher
Miene	NN	2	Mienen
üben	VVFIN	2	übe, üben
hilfts	NN, VVFIN	2	hilfts
Spur	NN	2	Spur
Mohr	NN	2	Mohren
wars	NN	2	wars
Acht	NN	2	Acht
hinweg	ADV	2	Hinweg, hinweg
vermögen	VVINF	2	vermögen
Person	NN	2	Person
erwünscht	ADJD, ADJA	2	erwünscht, Erwünschte
Gewinst	NN	2	Gewinst
lohnen	VVFIN, VVINF	2	lohnt, lohnen
ers	VVFIN	2	ers
springen	VVFIN	2	springt, sprang
hundert	CARD	2	hundert
gebieten	VVFIN, VVINF	2	Gebieten, gebieten
Unkraut	NN	2	Unkraut
ergreifen	VVPP, VVFIN	2	ergriffen, ergriff
lau	ADJD	2	lau
anklagen	VVPP	2	angeklagt
Christentum	NN	2	Christentum
ehrwürdger	ADJA	2	ehrwürdger
Frage	NN	2	Frage, Fragen
Ausdruck	NN	2	Ausdrucks, Ausdruck
Bande	NN	2	Banden, Bande
Ziel	NN	2	Ziel, Ziele
Gehabt	VVPP	2	Gehabt
umschatten	VVFIN	2	umschatten
Narr	NN	2	Narren, Narr
Botschaft	NN	2	Botschaft
Räuber	NN	2	Räuber
Transport	NN	2	Transport, Transports
unternehmen	VVPP, VVINF	2	unternommen, unternehmen
Erzogen	NN	2	Erzogen
Ward	NE	2	Ward
Ware	NN	2	Waren
Gedacht	NN	2	Gedacht
Durchs	NN	2	Durchs
darnach	ADV	2	darnach
gefährlich	ADJD	2	gefährlich, Gefährlich
raten	VVFIN, VVINF	2	Rate, raten
Närrin	NN	2	Närrin
wähnen	VVFIN, VVINF	2	wähnt, wähnen
flüchten	VVFIN, VVPP	2	flüchtet, geflüchtet
albern	ADJD	2	albern
verraten	VVFIN, VVPP	2	verrieten, verraten
Große	NN	2	Großen, Großes
vorüber	ADV, PTKVZ	2	vorüber
laden	VVINF, VVFIN	2	laden, ladet
angenehm	ADJD	2	angenehm
Persisch	NN	2	Persisch
Vollkommen	NN	2	Vollkommen
inzwischen	ADV	2	inzwischen
bst	VVFIN	2	bst
abwenden	VVIZU	2	abzuwenden
menschlich	ADJD, ADJA	2	menschlich, menschliche
hinauf	ADV	2	hinauf
Wand	NN	2	Wand
schleunig	ADJD	2	schleunig
Verschmäht	NN, ADJA	2	Verschmäht
höchstens	ADV	2	höchstens
spitz	ADJD, ADJA	2	spitz, spitze
Wenns	ADJD, VVFIN	2	Wenns
erröten	VVINF	2	erröten
Gönnts	NN	2	Gönnts
Bekommen	NN	2	Bekommen
verbinden	VVPP	2	verbunden
schwach	ADJA, ADJD	2	schwächsten, schwach
Netz	NN	2	Netze
verschaffen	VVPP	2	verschafft
blicken	VVINF, VVFIN	2	blicken, blickte
ausführen	VVPP	2	ausgeführt
Heiland	NN	2	Heiland, Heilands
entkommen	VVFIN	2	entkäme, entkam
bekannt	ADJD	2	bekannt
Auferstandnen	ADJA	2	Auferstandnen
ungesäumt	ADJD	2	ungesäumt
Laune	NN	2	Laune, Launen
selig	ADJD	2	selig
Pfaffe	NN	2	Pfaffen, Pfaffe
Gestiegen	NN	2	Gestiegen
Antwort	NN	2	Antwort
Salomons	NE, NN	2	Salomons
Hälfte	NN	2	Hälfte
Fall|Fällen	NN	2	Fällen
gewöhnen	VVFIN, VVINF	2	gewöhne, gewöhnen
ähneln	VVINF, VVFIN	2	ähneln, ähnelt
drin	PAV, PTKVZ	2	drin
Mangel	NN	2	Mangel, Mangels
gierig	ADJD	2	gierig, gieriger
Bewunderung	NN	2	Bewunderung
Geier	NE, NN	2	Geier, Geiern
Art	NN	2	Art
füllen	VVINF	2	füllen
Ton	NN	2	Ton
Spende|Spenden	NN	2	Spenden
feierlich	ADJD	2	feierlich
Punkt	NN	2	Punkt
Fest	NN	2	Feste
weiblich	ADJA, ADJD	2	weibliche, weiblich
binden	VVFIN	2	band
Ichs	NN	2	Ichs
besolden	VVINF, VVPP	2	besolden, besoldet
Geschichte	NN	2	Geschichte
schützen	VVINF	2	schützen
Topf	NN	2	Topf
verbitten	VVINF, VVFIN	2	verbitten, verbittet
Elend	NN	2	Elend
Wärs	NN	2	Wärs
Unschuld	NN	2	Unschuld
woher	PWAV	2	woher, Woher
Franke	NE	2	Franke
Erinnern	NN	2	Erinnern
reiten	VVINF	2	reiten
Schwärmerinnen	NN	2	Schwärmerinnen
Schwachheit	NN	2	Schwachheit
zudem	ADV	2	Zudem
Falle	NN	2	Fallen, Falle
Hund	NN	2	Hunde
scharf	ADJA, ADJD	2	scharfen, schärfer
entbrechen	VVINF	2	entbrechen
geschehn	VVFIN, VVINF	2	geschehn
Schmerz	NN	2	Schmerzen, Schmerz
Baum	NN	2	Baum, Bäumen
herzlich	ADJD, ADJA	2	herzlich, herzlicher
rot	ADJA	2	rote, roter
Fund	NN	2	Fund, funden
innig	ADJA	2	innigster
Geistliche	NN	2	Geistlichen, Geistlicher
Wahl	NN	2	Wahl
gefangner	ADJA, NN	2	gefangner
Morgen	NN	2	Morgen, Morgens
Fleiß	NN	2	Fleiß
michs	NE, ADJD	2	michs
Kniee	NN	2	Kniee
verbergen	VVINF	2	verbergen
Preis	NN	2	Preis
lieblich	ADJD, ADJA	2	lieblich, liebliche
Retter	NN	2	Retter
glücklich	ADJD	2	glücklich
Feld	NN	2	Feld
Lieb	NN	2	Lieb
Angesicht	NN	2	Angesicht
gestern	ADV	2	Gestern, gestern
Unterschied	NN	2	Unterschied
Tabor	NN	2	Tabor
ungern	ADV	2	ungern
Probe	NN	2	Proben, Probe
Menge	NN	2	Menge
Stauffin	NN	2	Stauffin
Schlecht	NN	2	Schlecht
anraten	VVIZU, VVPP	2	anzuraten, angeraten
bescheiden	ADJD, VVINF	2	bescheiden
Stärk	NN, TRUNC	2	Stärk
Schwärmer	NN	2	Schwärmer, Schwärmern
Gestürzte	NN	2	Gestürzte
erwerben	VVINF	2	erwerben
Gerechtigkeit	NN	2	Gerechtigkeit
Mild	VVFIN, ADJA	2	Mild
Kette	NN	2	Kette, Ketten
ungewohnt	ADJD	2	ungewohnt
wackrer	ADJA	2	wackrer
Wesen	NN	2	Wesen
tadeln	VVINF, VVFIN	2	tadeln, tadle
Schicksal	NN	2	Schicksal
quitt	ADJD	2	quitt
Begriff	NN	2	Begriffe
verhüllen	VVPP, VVINF	2	verhüllt, verhüllen
behalten	VVFIN, VVINF	2	behält, behalten
nutzen	VVFIN, VVINF	2	nutzt, nutzen
Problema	NN	2	Problema
Möglichkeit	NN	2	Möglichkeit
bauen	VVPP	2	Gebaut, gebaut
gelassen	ADJD	2	gelassen
glaublich	ADJA	2	glaubliche, glaublicher
Betrogen	NN	2	Betrogen
Schlinge	NN	2	Schlinge
Furcht	NN	2	Furcht
Schwerd	NE	2	Schwerd
aufzudringen	VVIZU	2	aufzudringen
siebenfach	ADJD, ADJA	2	siebenfach, siebenfache
betrachten	VVFIN, VVINF	2	betrachten
schmerzen	VVFIN	2	schmerzt
abjagen	VVIZU, VVPP	2	abzujagen, abgejagt
Rauch	NN	2	Rauch
bekümmern	VVPP	2	Bekümmert, bekümmert
plump	ADJA	2	plumper, plumpen
Ohm	NN	2	Ohm
Christendamen	NN	2	Christendamen
väterlich	ADJA	2	väterlichen, väterliches
schreien	VVFIN	2	schreit, schrie
lösen	VVINF	2	lösen
tus	VVPP, NN	2	tus
Askalon	NN	2	Askalon
Dinar	NN	2	Dinar, Dinare
derselb	PDAT	2	desselben, denselben
teuer	ADJD	2	teuer
andächtig	ADJD	2	andächtig, Andächtig
Stich	NN	2	Stich, Stiche
Ferne	NN	2	Ferne, Fernen
herum	ADV, APZR	2	Herum, herum
Hass	NN	2	Haß
zwanzig	CARD	2	zwanzig
Eisen	NN	2	Eisen
Kirch	NE, NN	2	Kirch
erschaffen	VVPP, VVFIN	2	erschaffen
Versichert	NN	2	Versichert
erstenmal	NN	2	erstenmal
gnügt	ADJD	2	gnügt
geschickt	ADJD	2	geschickt
unglaublich	ADJD	2	unglaublich, Unglaublich
bange	ADJD	2	bange
Sorge|Sorgen	NN	2	Sorgen
Darun	NE	2	Darun
bereuen	VVINF	2	bereuen
woll	VVFIN	2	woll
öfters	ADV	2	öfters
rühmen	VVINF	2	rühmen
empfinden	VVFIN, VVINF	2	empfinde, empfinden
zürnen	VVINF, VVIMP	2	zürnen, zürn
Stirn	NN	2	Stirn
achten	VVFIN	2	achte, achtet
Aberglaube	NN	2	Aberglauben
Schurkerei	NN	2	Schurkerei
Schöne	NN	2	Schönes, Schöne
melancholisch	ADJA, ADJD	2	melancholisches, melancholisch
vorn	ADV	2	vorn, Vorn
Mühe	NN	2	Mühe
trennen	VVFIN, VVINF	2	trennen
Eltern	NN	2	Eltern
Mauer	NN	2	Mauer
Habt	NN	2	Habt
auszubeugen	VVFIN, NN	2	auszubeugen
Schlimme	NN, NE	2	Schlimmes, Schlimme
hinein	ADV	2	Hinein
elend	ADJD	2	elend
begnadigen	VVPP	2	begnadigt
Gefangner	NN	2	Gefangner
Schreck	NN	2	Schreck
Eräugnet	VVIMP, VVPP	2	Eräugnet
Bedeckung	NN	2	Bedeckung
passen	VVINF, VVFIN	2	passen, paßt
Türe	NN	2	Türe
grausam	ADJA, ADJD	2	Grausame, grausam
heben	VVPP, VVFIN	2	gehoben, hebt
Gespielt	VVFIN	2	Gespielt
Wirds	NN	2	Wirds
senden	VVFIN	2	sandte, sendet
wohnen	VVPP	2	gewohnt
Schlechte	NN	2	Schlechten, Schlechte
alsdann	VVPP	2	alsdann
lautern	ADJD, ADJA	2	lautern
verfügen	VVFIN, VVINF	2	verfügt, verfügen
erheben	VVFIN, VVINF	2	Erhob, erheben
taub	ADJD, ADJA	2	taub, taube
ertragen	VVINF	2	ertragen
allemal	ADV	2	allemal
Fleisch	NN	2	Fleisch
Grille	NN	2	Grille
Erde	NN	2	Erde
Emir	NN	2	Emir
Hecke	NN	2	Hecke
Getäuscht	NN	2	Getäuscht
entsprechen	VVFIN	2	entspräche
Hast	NN	2	Hast
hinzufügen	VVPP	2	Hinzugefügt
Verschlingen	NN	2	Verschlingen
Bessers	NN	2	Bessers
stillen	VVPP	2	gestillt
hart	ADJA, ADJD	2	harten, hart
dirs	NN	2	dirs
unterschlagen	VVINF	2	unterschlagen
Haar	NN	2	Haare
Milde	NN	2	Milde
vernehmlich	ADJD	2	vernehmlicher, vernehmlich
Geschichtchen	NN	2	Geschichtchen
Leier	NN	2	Leier
Pflicht	NN	2	Pflicht
Neubegier	NN	2	Neubegier
Galle	NN	2	Galle
verreisen	VVFIN, VVPP	2	verreist
mangeln	VVINF	2	mangeln
behutsam	ADJD	2	Behutsam, behutsam
Freiheit	NN	2	Freiheit
genießen	VVPP, VVFIN	2	genossen, genießt
ermüden	VVINF, VVFIN	2	ermüden, ermüdet
küssen	VVFIN	2	küssen, küßt
Schwäche	NN	2	Schwäche
Großmut	NN	2	Großmut
leugnen	VVPP, VVFIN	2	geleugnet, leugnet
Titel	NN	2	Titel
Stimm	NN	2	Stimm
Knall	NN	2	Knall
schüchtern	VVFIN, ADJD	2	schüchtern
Vermuten	NN	2	Vermuten
eignen	VVFIN	2	eignet
immerdar	NE	2	immerdar
verloren	ADJD, PTKVZ	2	verloren
zusammenpassen	VVINF	2	zusammenpassen
empfangen	VVIMP, VVFIN	2	empfang, empfange
strafen	VVFIN, VVIMP	2	strafst, straf
Obs	NN	2	Obs
wuchern	VVINF, VVFIN	2	wuchern, wuchert
kamt	NN, ADJD	2	kamt
dus	VVFIN, ADJD	2	dus
Ehrwürdger	NE	2	Ehrwürdger
aufgedrungen	VVPP	2	aufgedrungen
Kostbarkeit	NN	2	Kostbarkeiten
werben	VVFIN, VVINF	2	warb, werben
fließen	VVPP, VVINF	2	geflossen, fließen
nützen	VVINF	2	nützen
verführen	VVFIN, VVPP	2	verführte, verführt
Hunger	NN	2	Hunger
Wette	NN	2	Wette
ansehn	ADJD	2	ansehn
Anschlag	NN	2	Anschlag
fällen	VVPP	2	gefällt
Rate	FM, NN	2	Rate
ungewiss	ADJD	2	ungewiß
aufwachsen	VVPP	2	aufgewachsen
rechts	ADV	2	rechts
Gebrauch	NN	2	Gebrauch
erschrecken	VVFIN	2	erschrecke, erschrak
vermeiden	VVPP, VVFIN	2	vermieden, vermeiden
Buße	NN	2	Buße
Gelernt	NN	2	Gelernt
David	NE	2	Davids
einleuchten	VVPP	2	eingeleuchtet
Siegel	NN	2	Siegel
Koch	NE	2	Koch
besorgen	VVINF, VVIMP	2	besorgen, besorg
Faktum	NN	2	Faktum
schwört	VVFIN	2	schwört
Verlegenheit	NN	2	Verlegenheit
beschönen	ADJD, VVINF	2	beschönen
Einsicht	NN	2	Einsicht
mächtig	ADJD, ADJA	2	mächtiger, mächtiges
klemmen	VVFIN	2	klemmt
Erwarten	NN	2	Erwarten
goldnen	ADJA	2	goldnen
Gegenteil	NN	2	Gegenteil
ausschlagen	VVFIN, VVIZU	2	ausschlug, auszuschlagen
wiedersehn	VVFIN	2	wiedersehn
verwirren	VVINF, VVPP	2	verwirren, verwirrt
ehedem	ADV	2	ehedem
Lilla	NE	2	Lilla
lügen	VVFIN, VVPP	2	Lügt, gelogen
früh	ADJD, ADJA	2	früh, frühere
Kunst	NN	2	Kunst, Künste
Gelt	ADJD, NE	2	Gelt
Vorsatz	NN	2	Vorsatz
wachen	VVFIN	2	wacht
vertragen	VVPP, VVINF	2	vertragen
willkommen	ADJD	2	willkommen
wenigste	PIS, PIAT	2	wenigsten, wenigste
Finger	NN	2	Finger
verwickeln	VVINF	2	verwickeln
Hui	NE	2	Hui
befehlen	VVFIN, VVINF	2	befehlt, befehlen
Reitknecht	NN	2	Reitknecht
verschonen	VVPP	2	verschont
links	ADV	2	links
Zahl	NN	2	Zahl
Gebracht	NN	2	Gebracht
Hochehrwürden	NN	2	Hochehrwürden
alltäglich	ADJD	2	alltäglich, Alltäglich
Verstand	NN	2	Verstand
spottest	NN, VVFIN	2	spottest
vorsetzen	VVPP	2	vorgesetzt
Opfer	NN	2	Opfer
Stachel	NN	2	Stachel, Stacheln
paar	PIAT	2	Paar
Euertwegen	NE, NN	2	Euertwegen
wundern	VVPP, VVFIN	2	gewundert, wundert
gesund	ADJD	2	Gesund, gesund
Sinn	NN	2	Sinn, Sinns
eur	NN	2	eur
müß	VVFIN	2	müß
Gehirn	NN	2	Gehirn
beginnen	VVFIN, VVIMP	2	beginnt, beginn
Held	NN	2	Held
umgekehrt	ADJD	2	umgekehrt
Blick|Blicken	NN	2	Blicken
Vergessen	NN	2	Vergessen
tief	ADJD	2	tiefer
unbegreiflich	ADJA, ADJD	2	unbegreiflichen, unbegreiflich
Defterdar	NE, NN	2	Defterdar
erwägen	VVPP, VVINF	2	erwogen, erwägen
Genießen	NN	2	Genießen
verwünscht	ADJA	2	verwünschte, verwünschten
Geheiß	NN	2	Geheiß
Ewigkeit	NN	2	Ewigkeit
Fassung	NN	2	Fassung
kaiserlich	ADJA	2	Kaiserlichen, kaiserliches
aufrichtig	ADJD	2	Aufrichtig, aufrichtig
Blatt	NN	2	Blatt
betreffen	VVFIN	2	betrifft
vorhin	ADV	2	vorhin
Gekannt	ADJD	2	Gekannt
melden	VVINF, VVFIN	2	melden, melde
könn	NE	2	könn
Genug	NN	2	Genug
rege	ADJD	2	rege
Karawane	NN	2	Karawane
Werkzeug	NN	2	Werkzeug
Buche	NN	2	Buche
Augenbraunen	NN	2	Augenbraunen
rein	ADV, PTKVZ	2	rein
Aufs	NN	2	Aufs
spotten	VVFIN, VVINF	2	spottet, spotten
verweilen	VVPP	2	verweilt
schleichen	VVPP, VVFIN	2	geschlichen, schlich
Schatten	NN	2	Schatten
Gefühl	NN	2	Gefühl
umkommen	VVPP	2	umgekommen
vergebens	ADV	2	vergebens
Weisheit	NN	2	Weisheit
Krieg	NN	2	Kriegs, Krieg
Hätt	NE, VVIMP	2	Hätt
Wichtigkeit	NN	2	Wichtigkeit
Überlegung	NN	2	Überlegung
Funken	NN	2	Funken
allmählig	ADJD	2	allmählig
Sturm	NN	2	Sturm
verbreiten	VVPP	2	verbreitet
Möcht	VVFIN, NN	2	Möcht
ziehen	VVPP, VVFIN	2	gezogen, zöge
Strom	NN	2	Ströme
verstellen	VVFIN	2	verstellt
schelten	VVINF, VVFIN	2	schelten, Schilt
Wohltat	NN	2	Wohltat
Bösewicht	NN	2	Bösewicht
Osten	NN	2	Osten
Eigentum	NN	2	Eigentum
Schatzmeister	NN	2	Schatzmeister
Gabe	NN	2	Gabe
dennoch	ADV	2	dennoch
treffen|triefen	VVPP	2	Getroffen, getroffen
höflich	ADJD	2	höflich, höflicher
streichen	VVFIN	2	strich, striche
betäuben	VVINF, VVPP	2	betäuben, betäubt
Rätsel	NN	2	Rätsel
sichs	NN	2	sichs
rasch	ADJD, ADJA	2	rasch, rasches
vorschießen	VVPP, VVINF	2	vorgeschossen, vorschießen
ander	ADJA	2	ander
hiervon	PAV	2	hiervon
Ergebenheit	NN	2	Ergebenheit
hassen	VVFIN, VVINF	2	haßte, hassen
drohen	VVFIN	2	droht
Eifer	NN	2	Eifer
auftragen	VVPP, VVFIN	2	aufgetragen, aufträgt
voraus	ADV, PTKVZ	2	voraus
Erzählt	NN	2	Erzählt
auserlesen	VVPP, VVFIN	2	auserlesen
Geschöpf	NN	2	Geschöpf
Heer	NN	2	Heer, Heere
Almosen	NN	2	Almosen, Almosens
erblicken	VVPP, VVINF	2	erblickt, erblicken
scheiden	VVPP	1	geschieden
öfter	ADV	1	öfter
Spange	NN	1	Spangen
Abschach	NN	1	Abschach
gehaben	VVFIN	1	gehabt
Brandmal	NN	1	Brandmal
Aberglaub	NN	1	Aberglaub
Beinah	NE	1	Beinah
euern	ADJA	1	euern
Charakter	NN	1	Charakter
abgelegnen	ADJA	1	abgelegnen
Hunderttausend	NN	1	Hunderttausenden
Zurückgezogen	VVINF	1	Zurückgezogen
Licht	NN	1	Licht
Erfüllet	NN	1	Erfüllet
Farbe	NN	1	Farben
Ruine	NN	1	Ruinen
jemals	ADV	1	jemals
Pflegevater	NN	1	Pflegevater
Zusprach	NN	1	Zusprach
sieden	VVINF	1	sieden
Gasse	NN	1	Gassen
Roche	NN	1	Roche
Wuchs	NN	1	Wuchs
garstgen	ADJA	1	garstgen
Sack	NN	1	Sack
offne	ADJA	1	offne
gebühren	VVPP	1	gebührt
Gerührt	NN	1	Gerührt
launig	ADJA	1	launigen
garstger	ADJA	1	garstger
reichlich	PIAT	1	reichlich
Sermon	NN	1	Sermon
Frisch	NE	1	Frisch
Ende|Enden	NN	1	Enden
straucheln	VVINF	1	straucheln
deutsch	ADJA	1	deutscher
winden	VVFIN	1	windet
Stifter	NN	1	Stifter
vorgeplaudert	VVPP	1	vorgeplaudert
Verlängert	NN	1	Verlängert
bürg	VVFIN	1	bürg
Hängts	NN	1	Hängts
Willkommen	NN	1	Willkommen
Moses	NE	1	Moses
entgegensetzen	VVINF	1	entgegensetzen
Barschaft	NN	1	Barschaft
unterlassen	VVINF	1	unterlassen
theatralschen	ADJA	1	theatralschen
Stärkste	NN	1	Stärkste
nachdenken	VVPP	1	nachgedacht
Heldenmäßigste	NN	1	Heldenmäßigste
Dankbarkeit	NN	1	Dankbarkeit
toll	ADJD	1	toll
brauchts	NN	1	brauchts
Erkenntlichkeit	NN	1	Erkenntlichkeit
Pflegetochter	NN	1	Pflegetochter
Asien	NE	1	Asien
fördern	VVINF	1	fördern
schänden	VVINF	1	schänden
erschreckest	VVFIN	1	erschreckest
bedünkt	VVFIN	1	bedünkt
unbesorgt	ADJD	1	unbesorgt
Mittelgut	NN	1	Mittelgut
nannt	VVFIN	1	nannt
ungesittet	ADJA	1	ungesittet
willkommner	ADJA	1	willkommner
nochmals	ADV	1	nochmals
worauf	PWAV	1	worauf
Allgerechter	NN	1	Allgerechter
wundersüchtges	ADJA	1	wundersüchtges
Spruch	NN	1	Spruches
hadern	VVINF	1	hadern
trugs	VVFIN	1	trugs
Hieß	ADJA	1	Hieß
allzeit	ADV	1	allzeit
solcherlei	PIAT	1	solcherlei
Hättst	VVFIN	1	Hättst
Verachten	NN	1	Verachten
erfreuen	VVFIN	1	erfreut
vorspiegeln	VVIZU	1	vorzuspiegeln
reichen	VVFIN	1	reiche
vergleichen	VVINF	1	vergleichen
Gefälligkeit	NN	1	Gefälligkeit
Wirt	NN	1	Wirt
Erziehen	NN	1	Erziehen
Kaß	NN	1	Kaß
Unterschleif	NN	1	Unterschleif
grenzen	VVFIN	1	grenzt
Schatz|Schätzen	NN	1	Schätzen
Oheim	NN	1	Oheim
wenigsten	ADV	1	wenigsten
bevölkern	VVINF	1	bevölkern
allzustreng	ADJD	1	allzustreng
verflossen	ADJA	1	verflossenen
bewusst	ADJD	1	bewußt
Braut	NN	1	Braut
Sogleich	NN	1	Sogleich
abhängen	VVFIN	1	abhängt
verkenn	VVIMP	1	verkenn
hold	ADJA	1	holdes
Willkür	NN	1	Willkür
Sklave	NN	1	Sklaven
locken	VVFIN	1	lockt
versorgen	VVINF	1	versorgen
Ginnistan	NE	1	Ginnistan
stehts	NN	1	stehts
unterhalten	VVINF	1	unterhalten
Gepflegt	NN	1	Gepflegt
befehl	VVFIN	1	befehl
hochgepriesner	ADJA	1	hochgepriesner
Engelschwärmerin	NN	1	Engelschwärmerin
Delk	NN	1	Delk
aufzuziehn	VVIZU	1	aufzuziehn
Jordan	NE	1	Jordan
Buhler	NN	1	Buhler
vermögend	ADJD	1	Vermögend
zerschmelzen	VVINF	1	zerschmelzen
lad	ADJD	1	lad
Fieber	NN	1	Fieber
billig	ADJA	1	billigsten
dringlich	ADJA	1	dringlichste
unterstützen	VVINF	1	unterstützen
Vergeßliche	NN	1	Vergeßlichen
Stillstand	NN	1	Stillstands
Winkel	NN	1	Winkel
Kralle|Krallen	NN	1	Krallen
Stunde	NN	1	Stunde
Verschwunden	NN	1	Verschwunden
bedurft	VVPP	1	bedurft
frostig	ADJD	1	frostig
blind	ADJD	1	blind
verzeihen|verziehen	VVFIN	1	Verzieht
Wohltun	NN	1	Wohltun
knieen	VVFIN	1	kniet
Hiernieden	VVFIN	1	Hiernieden
schütteln	VVFIN	1	schüttelt
Ahnenprobe	NN	1	Ahnenprobe
Woll	VVFIN	1	Woll
Wolke	NN	1	Wolke
Behandeln	NN	1	Behandeln
Gefangnen	NN	1	Gefangnen
Äsern	NN	1	Äsern
filzig	ADJD	1	filzig
Ruf	NN	1	Ruf
Verhungern	NN	1	Verhungern
vermuten	VVINF	1	vermuten
unstreitig	ADJD	1	Unstreitig
unverzeihlich	ADJD	1	unverzeihlich
Sklav	NN	1	Sklav
Christlichste	NN	1	Christlichste
Bewusstsein	NN	1	Bewußtsein
säete	ADJA	1	säete
wahrscheinlich	ADJD	1	wahrscheinlich
Amme	NN	1	Amme
Tauf	NN	1	Tauf
gekonnt	ADJD	1	gekonnt
Vermählt	NN	1	Vermählt
werdt	VVFIN	1	werdt
Geschwind	NN	1	Geschwind
Wart	NN	1	Wart
Einander	NN	1	Einander
Wars	NN	1	Wars
verleiten	VVPP	1	Verleitet
überflüssig	ADJD	1	überflüssig
Vogler	NE	1	Voglers
Schien	NN	1	Schien
Zeh|Zehe	NN	1	Zehen
Beschwören	NN	1	Beschwören
beschleuniget	VVFIN	1	beschleuniget
Versteh	NN	1	Versteh
ungleich	ADJD	1	ungleich
geraum	ADJA	1	Geraumer
unversöhnlich	ADJA	1	unversöhnlichsten
Gezürnt	NN	1	Gezürnt
Farb	NN	1	Farb
vorbereiten	VVFIN	1	vorbereiten
lüstern	ADJD	1	lüstern
tolerant	ADJA	1	tolerante
richten	VVINF	1	richten
Kälte	NN	1	Kälte
grade	PTKVZ	1	grade
rank	ADJA	1	Ranken
lauter	PIAT	1	lauter
preis	VVFIN	1	preise
ungeheuer	ADJA	1	ungeheuern
Aushöhlen	NN	1	Aushöhlen
Gesandte	NN	1	Gesandte
vorgehn	VVPP	1	vorgehn
bürget	VVFIN	1	bürget
mindsten	ADJA	1	mindsten
ratet	VVFIN	1	ratet
sprengen	VVFIN	1	sprengte
pflanzen	VVPP	1	gepflanzt
Abbrechen	NN	1	Abbrechen
bescheidne	ADJA	1	bescheidne
gestrenger	ADJA	1	gestrenger
Post	NN	1	Post
Verlangen	NN	1	Verlangen
vertiefen	VVPP	1	vertieft
Geschützt	NN	1	Geschützt
reifen	VVFIN	1	reift
sprächst	VVFIN	1	sprächst
Feier	NN	1	Feier
durchaus	ADV	1	durchaus
Strafe	NN	1	Strafe
Abraham	NE	1	Abraham
Geflattre	VVFIN	1	Geflattre
Mitleid	NN	1	Mitleids
ehren	VVPP	1	geehrt
schlaffste	ADJA	1	schlaffste
entschuldigen	VVINF	1	entschuldigen
auspacken	VVPP	1	ausgepackt
gestehn	ADJD	1	gestehn
verscharren	VVFIN	1	verscharrten
besuchen	VVINF	1	besuchen
Beßres	NN	1	Beßres
erblasse	VVFIN	1	erblasse
einzge	ADJA	1	einzge
Beichte	NN	1	Beichte
gegriffnen	ADJA	1	gegriffnen
Gemach	NN	1	Gemach
gewaltig	ADJD	1	Gewaltig
sperren	VVFIN	1	Sperre
eingeplaudert	ADJD	1	eingeplaudert
Verstärkung	NN	1	Verstärkung
Wehe|Wehen	NN	1	Wehen
speisen	VVFIN	1	speist
sauersüßem	ADJA	1	sauersüßem
Menschlichkeit	NN	1	Menschlichkeit
singen	VVPP	1	gesungen
verstricken	VVPP	1	verstrickt
verstopft	ADJA	1	verstopften
Weile	NN	1	Weile
Gurt	NN	1	Gurt
Mache	NN	1	Mache
Weils	NN	1	Weils
tiefgeprägte	ADJA	1	tiefgeprägte
Gimpel	NN	1	Gimpel
einhüllen	VVPP	1	eingehüllt
födert	ADJD	1	födert
mengen	VVFIN	1	mengt
verstoßt	VVFIN	1	verstoßt
Asch	NN	1	Asch
verweben	VVPP	1	verwebt
Ohrgehenke	NN	1	Ohrgehenke
Knie	NE	1	Knie
Subtilität	NN	1	Subtilitäten
vollziehen	VVINF	1	vollziehen
Schlag	NN	1	Schlag
Sanftmut	NN	1	Sanftmut
Fuchse	NN	1	Fuchse
hinab	ADV	1	hinab
christlich	ADJA	1	christlichem
Knochen	NN	1	Knochen
ermessen	VVINF	1	ermessen
Wartung	NN	1	Wartung
Zuversicht	NN	1	Zuversicht
klügeln	ADJD	1	klügeln
eingebornen	ADJA	1	eingebornen
sinken	VVINF	1	sinken
Christentume	NN	1	Christentume
Beleidigte	NN	1	Beleidigte
Gewandtheit	NN	1	Gewandtheit
wachsen	VVFIN	1	wachse
kochen	VVFIN	1	kocht
erfinden	VVPP	1	erfunden
zahlen	VVFIN	1	zahlt
untersteh	NE	1	untersteh
sättigen	VVPP	1	Gesättigt
Zuweilen	NN	1	Zuweilen
schick	ADJD	1	schick
Christentöchterchen	NN	1	Christentöchterchen
Ruh	NE	1	Ruh
jüngern	ADJA	1	jüngern
verlauten	VVINF	1	verlauten
Maroniten	NN	1	Maroniten
körnt	ADJD	1	körnt
Bund	NN	1	Bunde
beikommen	VVIZU	1	beizukommen
empfangnen	ADJA	1	empfangnen
bestechen	VVINF	1	bestechen
brausend	ADJD	1	brausend
drosseln	VVINF	1	drosseln
Geschenk	NN	1	Geschenk
Bemerkt	NN	1	Bemerkt
ließet	VVFIN	1	ließet
geraten|raten	VVPP	1	geraten
Schale	NN	1	Schale
Kirche	NN	1	Kirche
Brust	NN	1	Brust
zweitenmal	NN	1	zweitenmal
Bring	NE	1	Bring
begreiflich	ADJD	1	begreiflich
Garaus	NN	1	Garaus
Wendung	NN	1	Wendung
Nackte	NN	1	Nackter
geloben	VVFIN	1	gelobt
Majestät	NN	1	Majestät
Beräuchern	NN	1	Beräuchern
Müß	NN	1	Müß
Lump|Lumpen	NN	1	Lumpen
befragen	VVINF	1	befragen
Regel	NN	1	Regeln
Regen	NN	1	Regen
schicktet	ADJA	1	schicktet
Aberwitz	NN	1	Aberwitz
aufbinden	VVPP	1	aufgebunden
Erlassen|Erlaß	NN	1	Erlassen
Blocke	NN	1	Blocke
Puls	NN	1	Puls
belieben	VVPP	1	beliebt
Gefunden	NN	1	Gefunden
Fetze	NN	1	Fetze
Versucher	NN	1	Versucher
sparts	NN	1	sparts
vornehmlich	ADJD	1	Vornehmlich
Trank	NN	1	Trank
Armseligkeiten	NN	1	Armseligkeiten
freundlich	ADJA	1	freundlicher
nennens	VVFIN	1	nennens
aussuchen	VVPP	1	ausgesucht
Versichrung	NN	1	Versichrung
Kindchen	NN	1	Kindchen
neubegieriger	ADJD	1	neubegieriger
Argwohnen	VVFIN	1	Argwohnen
entfliehen	VVINF	1	entfliehen
Fromme	NN	1	Frommen
Erzürnt	NN	1	Erzürnt
Nebenzimmer	NN	1	Nebenzimmer
Schutzengel	NN	1	Schutzengel
Tür	NN	1	Türen
Sterben	NN	1	Sterben
rühren	VVPP	1	gerührt
geschweige	ADV	1	Geschweige
erzählet	VVFIN	1	erzählet
ausbitten	VVIZU	1	auszubitten
Begraben	NN	1	Begraben
verharren	VVINF	1	verharren
Nam	NE	1	Nam
pfäffisch	ADJD	1	pfäffisch
unbedeckt	ADJD	1	unbedeckt
vergeb	VVFIN	1	vergeb
einverstehen	VVPP	1	einverstanden
augenblicks	ADV	1	Augenblicks
Lüge|Lügen	NN	1	Lügen
Dolch	NN	1	Dolch
Verschwand	NN	1	Verschwand
untergräbst	VVFIN	1	untergräbst
erfüllt	ADJA	1	erfüllten
Querkopf	NN	1	Querkopf
Alte	NN	1	Alten
Geselle	NN	1	Gesellen
umwerfen	VVPP	1	umgeworfen
verlornen	ADJA	1	verlornen
Größe	NN	1	Größe
verlorner	NN	1	verlorner
Schlaf	NN	1	Schlafe
Waise	NN	1	Waisen
scheu	ADJD	1	scheu
schluchzen	VVFIN	1	schluchzte
Strumpf	NN	1	Strumpf
ankommen	VVPP	1	angekommen
weichen	VVFIN	1	wich
Ungewissheit	NN	1	Ungewißheit
verhunzen	VVINF	1	verhunzen
Verklagte	NN	1	Verklagten
trugt	VVFIN	1	trugt
Lehre|Lehren	NN	1	Lehren
ohnehin	ADV	1	ohnehin
just	ADV	1	just
Streit	NN	1	Streit
Satz	NN	1	Satz
umgesehn	ADJA	1	umgesehn
annoch	VVFIN	1	annoch
Handwerk	NN	1	Handwerk
Gärtner	NN	1	Gärtner
aufspringen	VVPP	1	aufgesprungen
verschießen	VVPP	1	verschossen
wankend	ADJA	1	wankenden
Flamme	NN	1	Flamme
Schachgesell	NN	1	Schachgesell
besehn	ADJD	1	besehn
Altar	NN	1	Altars
auszehren	VVPP	1	ausgezehrt
Verträglichkeit	NN	1	Verträglichkeit
spannen	VVPP	1	gespannt
schalten	VVINF	1	schalten
hochbeladenen	ADJA	1	hochbeladenen
Sidon	NE	1	Sidon
stoßen	VVFIN	1	Stoßt
Blutbegier	NN	1	Blutbegier
Versprochne	NN	1	Versprochne
unten	ADV	1	unten
Kohle	NN	1	Kohlen
Vernünftge	ADJA	1	Vernünftge
erstenmale	NN	1	erstenmale
Gärung	NN	1	Gärung
Vogel	NN	1	Vogels
Sieh	NN	1	Sieh
zerbrechen	VVFIN	1	zerbricht
herbringen	VVPP	1	hergebracht
Geschmeide	NN	1	Geschmeide
allerheilig	ADJA	1	allerheiligsten
borg	VVFIN	1	borg
niedrig	ADJA	1	niedriger
beneiden	VVPP	1	beneidet
Geführt	NN	1	Geführt
Kahira	NE	1	Kahira
ums	APPRART	1	ums
dehnen	VVINF	1	dehnen
sinnreich	ADJD	1	sinnreich
wachend	ADJD	1	wachend
Pfeife	NN	1	Pfeife
stiften	VVPP	1	gestiftet
zeihen	VVFIN	1	zieh
Verschwenden	NN	1	Verschwenden
hundertmal	ADV	1	hundertmal
aufbehalten	VVPP	1	aufbehalten
Jericho	NE	1	Jericho
zogs	VVFIN	1	zogs
Grau	NN	1	Graus
vertraulich	ADJD	1	vertraulicher
entwöhnen	VVINF	1	entwöhnen
Euphrat	NE	1	Euphrat
Gram	NN	1	Gram
ausgegattert	VVPP	1	ausgegattert
darunter	PAV	1	Darunter
auszuspüren	VVIZU	1	auszuspüren
schirmen	VVINF	1	schirmen
Eigennützigste	NN	1	Eigennützigste
siebenjährig	ADJA	1	siebenjährigem
Erborgen	NN	1	Erborgen
gründen	VVFIN	1	gründen
Essen	NN	1	Essen
obs	VVIMP	1	obs
Erteilet	NN	1	Erteilet
mocht	VVFIN	1	mocht
tragend	ADJD	1	tragend
Geschadet	NN	1	Geschadet
trocken	ADJA	1	trockene
glorreich	ADJD	1	glorreicher
Entgegen	NN	1	Entgegen
Pfort	NN	1	Pfort
unters	APPRART	1	unters
unterliegen	VVFIN	1	unterliegt
Verbindlichkeit	NN	1	Verbindlichkeit
verzetteln	VVFIN	1	verzettelt
Kosten	NN	1	Kosten
Wärt	VVIMP	1	Wärt
zählen	VVINF	1	zählen
unentbehrlich	ADJD	1	unentbehrlich
Nagel	NN	1	Nagel
Besitzer	NN	1	Besitzer
Freudigkeit	NN	1	Freudigkeit
Gesucht	NN	1	Gesucht
Bauer	NE	1	Bauer
offen	ADJD	1	offen
gemach	ADV	1	Gemach
löset	VVINF	1	löset
Hiernächst	VVFIN	1	Hiernächst
Verdirb	VVFIN	1	Verdirb
übereilen	VVINF	1	übereilen
Stück	NN	1	Stück
prüfen	VVINF	1	prüfen
Feldzug	NN	1	Feldzug
Verspracht	VVFIN	1	Verspracht
erscheinen	VVINF	1	erscheinen
unwert	ADJD	1	unwert
Zelle	NN	1	Zelle
selgen	ADJA	1	selgen
Abtritt	NN	1	Abtritt
Ader	NN	1	Adern
rätselhaft	ADJA	1	rätselhaften
Neuste	NN	1	Neuste
Betaur	VVFIN	1	Betaur
morgens	ADV	1	morgens
Geärgert	ADJD	1	Geärgert
befremden	VVPP	1	befremdet
Weiberkopf	NN	1	Weiberkopf
gutherzgen	NE	1	gutherzgen
bestehn	ADJD	1	bestehn
überkochen	VVINF	1	überkochen
Geschwätz	NN	1	Geschwätz
ekeln	VVFIN	1	ekelt
dicht	ADJD	1	dicht
fasten	VVINF	1	fasten
seitwärts	ADV	1	seitwärts
Schleuse|Schleusen	NN	1	Schleusen
Verlieren	NN	1	Verlieren
Christeneltern	NN	1	Christeneltern
sollts	NN	1	sollts
Betret	VVFIN	1	Betret
hierzu	PAV	1	hierzu
lächelnd	ADJD	1	lächelnd
mild	ADJD	1	mild
Bär	NN	1	Bär
Hinauf	NN	1	Hinauf
Burg	NN	1	Burg
Stange	NN	1	Stange
gebrechen	ADJD	1	gebrechen
unsichtbar	ADJA	1	unsichtbaren
grauen	VVFIN	1	graute
Gepriesner	ADJA	1	Gepriesner
weils	NN	1	weils
Erwerb	NN	1	Erwerben
Leu	NN	1	Leu
Erkläre	NN	1	Erkläre
unrechtmäßig	ADJA	1	unrechtmäßigen
belohn	NN	1	belohn
wenns	VVFIN	1	wenns
faulen	VVFIN	1	faulen
streng	ADJA	1	strengsten
Ehrlichkeit	NN	1	Ehrlichkeit
Wunderbare	NN	1	Wunderbaren
auswerfen	VVPP	1	ausgeworfen
fasset	VVFIN	1	fasset
Antlitz	NN	1	Antlitz
behaupten	VVINF	1	behaupten
Buchgelehrsamkeit	NN	1	Buchgelehrsamkeit
tröstender	ADJD	1	tröstender
anziehen	VVPP	1	angezogen
Kindes-Kindeskindern	NN	1	Kindes-Kindeskindern
Bonafides	NN	1	Bonafides
Vermögen	NN	1	Vermögen
geloben|loben	VVPP	1	gelobt
Pfiffigkeit	NN	1	Pfiffigkeit
schrecklich	ADJD	1	schrecklich
Rache	NN	1	Rache
besetzen	VVPP	1	besetzt
Lage	NN	1	Lage
verhalten	VVFIN	1	verhält
fehlet	VVFIN	1	fehlet
wiederholen	VVINF	1	wiederholen
Tempelritter	NN	1	Tempelritter
Form	NN	1	Form
platterdings	ADJD	1	platterdings
Sittahs	NN	1	Sittahs
erdulden	VVINF	1	erdulden
zurückkommen	VVPP	1	zurückgekommen
Stempel	NN	1	Stempel
gesucht	ADJD	1	gesucht
fliehen	VVFIN	1	floh
unbekümmert	ADJD	1	unbekümmert
besorglichen	ADJA	1	besorglichen
meld	VVFIN	1	meld
geheimnisvoll	ADJD	1	geheimnisvoll
weis	PTKVZ	1	weis
losgehen	VVFIN	1	losgeht
ausliefern	VVPP	1	ausgeliefert
Mißlaut	NN	1	Mißlaut
begnaden	VVPP	1	begnadet
Klemme	NN	1	Klemme
Schwächste	NN	1	Schwächsten
Wüstenei	NN	1	Wüstenei
kanns	NE	1	kanns
Gazza	VVFIN	1	Gazza
Verlanget	VVFIN	1	Verlanget
unverkünstelt	ADJD	1	unverkünstelt
Wirst	NN	1	Wirst
hellern	ADJA	1	hellern
verändern	VVPP	1	verändert
weigern	VVFIN	1	weigerte
hinüber	PTKVZ	1	hinüber
Sait	NE	1	Sait
aufhör	NN	1	aufhör
unparteiisch	ADJD	1	unparteiisch
scheuchen	VVFIN	1	scheuchte
Grad	NN	1	Grad
zusammenhängen	VVFIN	1	zusammenhängt
reget	ADJD	1	reget
Ratschluss	NN	1	Ratschluß
neubegierig	ADJD	1	neubegierig
gedrungen	ADJD	1	gedrungen
worüber	PWAV	1	worüber
Pöbel	NN	1	Pöbels
rachbegierig	ADJD	1	rachbegierig
nachäffen	VVIZU	1	nachzuäffen
würdiget	VVFIN	1	würdiget
jüdschen	ADJA	1	jüdschen
Vorfahr	NN	1	Vorfahr
Begleiten	NN	1	Begleiten
Gewährt	NN	1	Gewährt
Tropf	NN	1	Tropf
Hülf	NN	1	Hülf
Bösewichter	NN	1	Bösewichter
wallen	VVINF	1	wallen
Wüßt	VVFIN	1	Wüßt
unmöglich	ADJD	1	unmöglich
Vetter	NE	1	Vetter
Sagt	ADJD	1	Sagt
Abulkassem	NN	1	Abulkassem
Schafpelz	NN	1	Schafpelz
erbittern	VVFIN	1	Erbittert
Wassereimer	NN	1	Wassereimer
Mißdeut	NN	1	Mißdeut
schrecken	VVINF	1	schrecken
abzulohnen	VVIZU	1	abzulohnen
Einsamkeit	NN	1	Einsamkeit
machtet	ADJD	1	machtet
dünk	VVFIN	1	dünk
wund	ADJA	1	Wunder
atmen	VVFIN	1	atmet
eintreiben	VVPP	1	eingetrieben
umarmen	VVINF	1	umarmen
namentlich	ADJD	1	namentlich
Geblüt	NN	1	Geblüt
säume	VVFIN	1	säume
fortgehn	VVPP	1	fortgehn
Hab	NN	1	Hab
verborgen	VVINF	1	verborgen
vorenthalten	VVPP	1	vorenthalten
Ließ	NN	1	Ließ
offner	ADJA	1	offner
hoffnungsvoll	ADJA	1	hoffnungsvollen
verderben	VVPP	1	Verdorben
innern	ADJA	1	innern
Empfang	NN	1	Empfang
Thebais	NN	1	Thebais
Druck	NN	1	Druck
offnes	ADJA	1	offnes
Sängerin	NN	1	Sängerin
Erzähl	NN	1	Erzähl
Tribut	NN	1	Tribut
ersaufen	VVINF	1	ersaufen
Larve	NN	1	Larve
entbehren	VVINF	1	entbehren
Bestand	NN	1	Bestand
unterrichten	VVFIN	1	unterrichtet
tauschen	VVFIN	1	tauschten
vorgreifen	VVIZU	1	vorzugreifen
itzo	VVINF	1	itzo
bunt	ADJA	1	bunten
versunknen	ADJA	1	versunknen
durchschlängeln	VVINF	1	durchschlängeln
Torheit	NN	1	Torheit
gewürdiget	VVPP	1	gewürdiget
einstimmen	VVPP	1	eingestimmt
Innere	NN	1	Innern
Scheiterhaufen	NN	1	Scheiterhaufen
Unglück	NN	1	Unglück
ruhen	VVINF	1	ruhen
irre	ADJA	1	irren
vorgespreiztem	ADJA	1	vorgespreiztem
Mittag	NN	1	Mittags
Milz	NN	1	Milz
Nuss	NN	1	Nuß
Lecker	NN	1	Lecker
drob	VVFIN	1	drob
kosen|kosten	VVFIN	1	koste
Parsi	NN	1	Parsi
entschossen	ADJD	1	entschossen
Verbrannt	NN	1	Verbrannt
Vorhang	NN	1	Vorhang
Zuckung	NN	1	Zuckung
aufhalten	VVPP	1	aufgehalten
Denkende	NN	1	Denkender
geziemen|ziemen	VVPP	1	geziemt
Wucher	NN	1	Wucher
verbunden	ADJD	1	verbunden
Berichtet	NN	1	Berichtet
Ordnung	NN	1	Ordnung
außer	KOUS	1	außer
Verlorst	NN	1	Verlorst
Verräter	NN	1	Verräter
außen	ADV	1	außen
Theater	NN	1	Theater
Stürzt	NN	1	Stürzt
Schmeichler	NN	1	Schmeichler
Rinde	NN	1	Rinde
Höchste	NN	1	Höchsten
Gebiet	NN	1	Gebiete
dürf	VVFIN	1	dürf
weich	ADJA	1	weichen
Abenteuer	NN	1	Abenteuer
anzugehn	VVIZU	1	anzugehn
Würd	VVFIN	1	Würd
Wen	NE	1	Wen
eifre	ADJD	1	eifre
Getriebe	NN	1	Getrieben
öde	ADJA	1	öden
unternehmet	VVFIN	1	unternehmet
beiher	NN	1	beiher
wirds	VVFIN	1	wirds
Eurigen	NN	1	Eurigen
Anstalt	NN	1	Anstalt
Trocknen	NN	1	Trocknen
Erzögt	NN	1	Erzögt
Sünd	NE	1	Sünd
Kält	NN	1	Kält
Gesättigt	NN	1	Gesättigt
Erzöge	NN	1	Erzöge
Glaubenshelden	NN	1	Glaubenshelden
verflattern	VVINF	1	verflattern
verschleißen	VVPP	1	verschlissen
Hingehn	NN	1	Hingehn
verstopfen	VVFIN	1	verstopft
Lohn	NN	1	Lohn
anlassen	VVFIN	1	anließ
entschließ	VVFIN	1	entschließ
Stammbaum	NE	1	Stammbaum
Meile	NN	1	Meilen
ungetreu	ADJA	1	ungetreuen
Sparung	NN	1	Sparung
List|Liste	NN	1	Listen
erweislich	ADJD	1	Erweislich
schlängeln	VVINF	1	schlängeln
unrein	ADJD	1	unrein
wers	NN	1	wers
schärfen	VVFIN	1	schärft
abbrennen	VVPP	1	abgebrannt
erkundigen	VVINF	1	erkundigen
drückts	VVFIN	1	drückts
pro	APPR	1	pro
Diener	NN	1	Diener
spenden	VVINF	1	spenden
ausgeweinet	VVPP	1	ausgeweinet
ausreiten	VVFIN	1	ausritt
vertrauet	VVFIN	1	vertrauet
Ermuntrung	NN	1	Ermuntrung
beßres	ADJA	1	beßres
fertig	ADJD	1	fertig
Gelesen	NN	1	Gelesen
betrög	ADJD	1	betrög
errötest	VVFIN	1	errötest
Kern	NE	1	Kern
stracks	ADV	1	stracks
Allwo	ADV	1	Allwo
entkömmst	VVFIN	1	entkömmst
Naschwerk	NN	1	Naschwerk
angst	ADJD	1	angst
Gipfelchen	NN	1	Gipfelchen
wacker	ADJA	1	wackre
Tulban	NE	1	Tulban
Unglaubliche	NN	1	Unglaubliche
vollziehn	VVINF	1	vollziehn
höhern	ADJA	1	höhern
Setzt	NN	1	Setzt
erregen	VVFIN	1	Erregt
vermache	ADJA	1	vermache
laben	VVINF	1	laben
Wes	NE	1	Wes
ausüben	VVPP	1	ausgeübt
Quarantana	NE	1	Quarantana
Gath	NN	1	Gath
verbeißen	VVFIN	1	verbeißt
Bezeichnen	NN	1	Bezeichnen
daselbst	ADV	1	daselbst
Fessel|Fesseln	NN	1	Fesseln
nunmehr	ADV	1	nunmehr
dick	ADJA	1	dicker
Lektion	NN	1	Lektion
erleichtern	VVINF	1	erleichtern
Gelehrte	NN	1	Gelehrten
Silberstoff	NN	1	Silberstoff
kehren	VVFIN	1	kehrt
edeln	ADJA	1	edeln
Erbarmte	NN	1	Erbarmte
Handel	NN	1	Handel
Beteuern	NN	1	Beteuern
gen	APPR	1	gen
wiederfodert	VVFIN	1	wiederfodert
kauftet	VVFIN	1	kauftet
mindern	VVFIN	1	mindern
entlaufen	VVFIN	1	Entläuft
nimmer	ADV	1	nimmer
wiederfodern	NN	1	wiederfodern
triegt	ADJD	1	triegt
Entreißen	NN	1	Entreißen
Unglaublichers	NN	1	Unglaublichers
Weigerung	NN	1	Weigerungen
Höhnerei	NN	1	Höhnerei
empfingt	ADJD	1	empfingt
brennts	NN	1	brennts
rauschen	VVFIN	1	rauscht
ausgenommen	ADV	1	ausgenommen
vertrauter	ADJD	1	vertrauter
vorhabt	VVFIN	1	vorhabt
frommte	ADJA	1	frommte
stärkern	NN	1	stärkern
Frucht	NN	1	Frucht
Ehrenkleid	NN	1	Ehrenkleid
lässest	VVFIN	1	lässest
versichern	VVPP	1	versichert
Laßts	NN	1	Laßts
Bewundern	NN	1	Bewundern
Schachbrett	NN	1	Schachbrett
worunter	PWAV	1	worunter
aufsuchen	VVPP	1	aufgesucht
Anspruch	NN	1	Anspruch
Tapferkeit	NN	1	Tapferkeit
Werk	NN	1	Werken
Erlauben	NN	1	Erlauben
mans	VVFIN	1	mans
eröffnen	VVFIN	1	eröffne
wach	ADJA	1	wachen
Hätts	NN	1	Hätts
Partei	NN	1	Partei
herschicken	VVPP	1	hergeschickt
erweichen	VVINF	1	erweichen
verwünschen	VVPP	1	verwünscht
unhold	ADJD	1	unhold
Wirbel	NN	1	Wirbel
damals	ADV	1	damals
befallen	VVFIN	1	Befällt
fühlest	VVFIN	1	fühlest
Schwierigkeit	NN	1	Schwierigkeiten
Eremit	NN	1	Eremit
Armut	NN	1	Armut
abtun	VVPP	1	abgetan
Überspanntes	ADJA	1	Überspanntes
wurmisch	ADJD	1	wurmisch
gleichviel	ADV	1	Gleichviel
Kreatur	NN	1	Kreatur
Schweizer	NN	1	Schweizer
flößen	VVPP	1	geflößt
Geträumt	VVFIN	1	Geträumt
Bug	NN	1	Bug
Menschenmäkelei	NN	1	Menschenmäkelei
dichten	VVFIN	1	dichtet
Beliebt	ADJA	1	Beliebt
Bedürf	NN	1	Bedürf
Warnen	NN	1	Warnen
Haram	NN	1	Haram
hernach	ADV	1	hernach
Klage|Klagen	NN	1	Klagen
nehmts	NN	1	nehmts
bereiten	VVIMP	1	Bereite
zustoßen	VVFIN	1	zustößt
einzger	ADJA	1	einzger
vererben	VVFIN	1	vererbte
Antrag	NN	1	Antrag
Begnadigt	NN	1	Begnadigt
achtzehn	CARD	1	achtzehn
Herrlichkeit	NN	1	Herrlichkeit
Entschließen	NN	1	Entschließen
ermorden	VVPP	1	ermordet
mustern	VVFIN	1	mustert
gerungnen	ADJA	1	gerungnen
Plane	NN	1	Plane
spätre	ADJA	1	spätre
Treffen	NN	1	Treffen
Tempel	NN	1	Tempel
Bedeuten	NN	1	Bedeuten
würdger	NE	1	würdger
gottlob	ADV	1	Gottlob
verwehen	VVFIN	1	Verweht
Soldat	NN	1	Soldat
keimen	VVFIN	1	keimt
sinnen	VVFIN	1	sinnt
Edelmut	NN	1	Edelmut
seufzen	VVFIN	1	seufzen
anderwärts	ADV	1	anderwärts
Muselmanne	NN	1	Muselmanne
Busen	NN	1	Busen
erteilen	VVINF	1	erteilen
Ankunft	NN	1	Ankunft
schießen	VVFIN	1	schießt
nähmst	VVFIN	1	nähmst
Geleiten	NN	1	Geleiten
aufwiegen	VVIZU	1	aufzuwiegen
Stillestand	NN	1	Stillestand
Kapitulation	NN	1	Kapitulation
Selbsteigner	NN	1	Selbsteigner
martre	VVFIN	1	martre
bereden	VVINF	1	bereden
Verkenn	NN	1	Verkenn
Söhn	NN	1	Söhn
zollen	VVPP	1	gezollt
unverrückt	ADJD	1	unverrückt
Mond	NN	1	Monden
Tuch	NN	1	Tuch
bluten	VVFIN	1	blutet
gering	ADJA	1	geringsten
verstehn	VVFIN	1	verstehn
Fremde	NN	1	Fremden
Ebb	NN	1	Ebb
genügen	VVPP	1	genügt
angelegner	NN	1	angelegner
Erstaunen	NN	1	Erstaunen
Verrichtet	NN	1	Verrichtet
vergelten	VVINF	1	vergelten
verschloßnem	ADJA	1	verschloßnem
eingedenk	ADJD	1	eingedenk
schlüg	VVFIN	1	schlüg
Ergießung	NN	1	Ergießung
Menschenhass	NN	1	Menschenhaß
fürwahr	ADV	1	Fürwahr
Güt	NN	1	Güt
Waffenstillestandes	NN	1	Waffenstillestandes
philosophschen	ADJA	1	philosophschen
Fehls	NN	1	Fehls
Gotteslästerung	NN	1	Gotteslästerung
Schutz	NN	1	Schutze
unverloren	ADJD	1	unverloren
gewonnen	ADJD	1	Gewonnen
bemühen	VVFIN	1	bemüht
launisch	ADJD	1	launisch
Sprichwort	NN	1	Sprichwort
Christentempel	NN	1	Christentempel
Nächste	NN	1	Nächster
gesprächig	ADJD	1	gesprächiger
Verächtlich	NN	1	Verächtlich
Anlass	NN	1	Anlaß
sprudelnd	ADJD	1	sprudelnd
nachwirken	VVPP	1	nachgewirkt
Itzo	NE	1	Itzo
Gesprochen	NN	1	Gesprochen
herrschend	ADJA	1	herrschenden
größerm	NN	1	größerm
weisrer	ADJA	1	weisrer
Opfertier	NN	1	Opfertier
Kuss|Küssen	NN	1	Küssen
plauderst	VVFIN	1	plauderst
obbesagte	ADJA	1	obbesagte
Kranke	NN	1	Kranken
ersteigen	VVPP	1	erstiegen
unvermutet	ADJA	1	unvermuteten
Handelsleute	NN	1	Handelsleute
nisten	VVINF	1	nisten
verschränkt	ADJA	1	verschränkten
essen	VVPP	1	gegessen
allzuhäufig	ADJD	1	allzuhäufig
Erforscht	NN	1	Erforscht
abziehn	VVINF	1	abziehn
Muselmannes	NN	1	Muselmannes
täglich	ADJD	1	täglich
fodern	VVFIN	1	fodern
nass	ADJA	1	nassen
Verlaufen	NN	1	Verlaufen
belehren	VVINF	1	belehren
Jamerlonk	NN	1	Jamerlonk
unerhört	ADJD	1	unerhört
Saite	NN	1	Saite
Belohnet	NN	1	Belohnet
gehört	ADJD	1	Gehört
Eigensinn	NN	1	Eigensinn
Erfahren	NN	1	Erfahren
Tropfen	NN	1	Tropfen
Würmchen	NN	1	Würmchen
vors	APPRART	1	vors
zuteilen	VVPP	1	zugeteilt
pfui	ITJ	1	Pfui
Betreiben	NN	1	Betreiben
Summ	VVFIN	1	Summ
Ehre	NN	1	Ehre
Horcherin	NN	1	Horcherin
vorgetragne	ADJA	1	vorgetragne
schätzen	VVINF	1	schätzen
Wache|Wachen	NN	1	Wachen
blühen	VVINF	1	blühen
Verfallnen	ADJA	1	Verfallnen
lästig	ADJD	1	lästig
wackern	NN	1	wackern
witzelst	VVFIN	1	witzelst
Entzückung	NN	1	Entzückung
befestigen	VVINF	1	befestigen
müde	ADJD	1	müde
unerweislich	ADJD	1	unerweislich
Exempel	NN	1	Exempel
Ström	NN	1	Ström
Leiden	NN	1	Leiden
emsig	ADJD	1	emsig
all	FM	1	all
Biedermann	NN	1	Biedermann
Schuppe|Schuppen	NN	1	Schuppen
Stille	NN	1	Stille
missen	VVINF	1	missen
empfindlich	ADJD	1	empfindlich
bedächtig	ADJD	1	bedächtig
Heilige	NN	1	Heiliger
gestehen|stehen	VVPP	1	gestanden
Christenmensch	NN	1	Christenmensch
zugelernte	ADJA	1	zugelernte
geziemen	VVFIN	1	geziemte
schadt	ADJD	1	schadt
faselnd	ADJD	1	faselnd
durchdenken	VVIZU	1	durchzudenken
verstummen	VVINF	1	verstummen
Prälat	NN	1	Prälat
unbändigsten	ADJA	1	unbändigsten
fortfahren	VVFIN	1	fortfährt
Silber	NN	1	Silber
Verdenkt	VVIMP	1	Verdenkt
gewahr	ADJD	1	gewahr
begnadiget	VVFIN	1	begnadiget
hoffentlich	ADV	1	hoffentlich
Kluge	NE	1	Kluge
Schwermut	NN	1	Schwermut
Rücken	NN	1	Rücken
fördersamst	ADJD	1	fördersamst
belegen	VVINF	1	belegen
erschallen	VVPP	1	erschallt
hervor	PTKVZ	1	hervor
Brevier	NN	1	Brevier
vortragen	VVIZU	1	vorzutragen
ausweichen	VVIZU	1	auszuweichen
Nachen	NN	1	Nachen
Aussicht	NN	1	Aussicht
befleißen	VVPP	1	beflissen
zweimal	ADV	1	zweimal
ahndte	VVFIN	1	ahndte
hinaus	PTKVZ	1	hinaus
Plunder	NN	1	Plunder
Gabel	NN	1	Gabel
auflesen	VVPP	1	aufgelesen
essend	ADJD	1	essend
Lehre	NN	1	Lehre
Gemeine	NN	1	Gemeine
Gift	NN	1	Gift
wichtgere	ADJA	1	wichtgere
vertreten	VVINF	1	vertreten
Arabisch	NN	1	Arabisch
geliebt	ADJA	1	geliebtesten
lustig	ADJD	1	Lustig
plündern	VVINF	1	plündern
spartest	VVFIN	1	spartest
glaubs	VVFIN	1	glaubs
schwarz	ADJA	1	schwärzesten
ausmachen	VVPP	1	ausgemacht
Wozu	ADV	1	Wozu
übern	APPRART	1	übern
Hoffnung	NN	1	Hoffnung
gerechtet	ADJD	1	gerechtet
Verwandte	NN	1	Verwandte
fernern	ADJA	1	fernern
Vergeben	NN	1	Vergeben
heilen	VVPP	1	geheilt
Dawider	ADJD	1	Dawider
gehässig	ADJD	1	gehässig
Wußt	VVFIN	1	Wußt
Friedrichs	NE	1	Friedrichs
streiten	VVFIN	1	streiten
Block	NN	1	Block
kühn	ADJD	1	kühn
Teufel	NN	1	Teufels
enträtsle	VVFIN	1	enträtsle
Ebenbild	NN	1	Ebenbild
zweifelhaft	ADJA	1	zweifelhaften
Botenbrod	NN	1	Botenbrod
ledern	ADJD	1	ledern
klagen	VVFIN	1	klagt
Nächt	VVFIN	1	Nächt
kümmern	VVFIN	1	kümmert
herunter	ADV	1	herunter
Erquickung	NN	1	Erquickung
halts	VVFIN	1	halts
Besinn	NN	1	Besinn
reichre	ADJA	1	reichre
abschrecken	VVPP	1	abgeschreckt
Streiter	NN	1	Streitern
herab	PTKVZ	1	herab
anbringen	VVPP	1	angebracht
bedachen	VVFIN	1	bedacht
Geblüte	NN	1	Geblüte
Bst	NE	1	Bst
Röhre|Röhren	NN	1	Röhren
Göttliche	NN	1	Göttlichen
mischen	VVINF	1	mischen
trösten	VVINF	1	trösten
geringres	ADJA	1	geringres
Laun	NE	1	Laun
Bankert	NN	1	Bankert
unschätzbar	ADJA	1	unschätzbarem
List	NN	1	List
zehnmal	ADV	1	zehnmal
Selbzwanzigster	NN	1	Selbzwanzigster
Et	NE	1	Et
abscheulich	ADJD	1	abscheulich
dreimal	ADV	1	dreimal
Kehle	NN	1	Kehle
auszufinden	ADJD	1	auszufinden
Filz	NN	1	Filze
Saumtier	NN	1	Saumtier
Nerv	NN	1	Nerve
Ekel	NN	1	Ekel
wartst	VVFIN	1	wartst
Tausch	NN	1	Tausch
Putz	NN	1	Putz
wölben	VVPP	1	gewölbt
vorsichtger	NE	1	vorsichtger
Ast	NN	1	Äste
Same	NN	1	Samen
vermeint	ADJA	1	vermeinte
gleichsam	ADJD	1	Gleichsam
Kundschafterei	NN	1	Kundschafterei
Christendirne	NN	1	Christendirne
vermag	VVFIN	1	vermag
Alter	NN	1	Alter
ungefälligsten	ADJA	1	ungefälligsten
Anblick	NN	1	Anblick
bedürftig	ADJD	1	bedürftig
abgewinnen	VVINF	1	abgewinnen
spießen	VVINF	1	spießen
Tyrannei	NN	1	Tyrannei
behüten	VVFIN	1	behüte
Schauer	NN	1	Schauer
löblich	ADJD	1	löblich
kürzlich	ADJD	1	kürzlich
fähig	ADJD	1	fähig
ungerührt	ADJD	1	ungerührt
Flügel	NN	1	Flügeln
Rand	NN	1	Rande
Fuchs	NN	1	Fuchses
malet	ADJA	1	malet
malen	VVFIN	1	malt
entfernt	ADJD	1	entfernt
verehret	VVFIN	1	verehret
zerstreut	ADJD	1	zerstreut
Bessern	NN	1	Bessern
niederwirft	VVFIN	1	niederwirft
Erbieten	NN	1	Erbieten
nötigen	VVPP	1	Genötigt
Lippe	NN	1	Lippen
Mut	NN	1	Mute
unverdient	ADJD	1	unverdient
blank	ADJD	1	blank
Unentschlossenheit	NN	1	Unentschlossenheit
neugierge	ADJA	1	neugierge
unbewusst	ADJD	1	unbewußt
Dus	VVPP	1	Dus
abwägen	VVIZU	1	abzuwägen
Zeugnis	NN	1	Zeugnis
Berichtigen	NN	1	Berichtigen
Geliebt	NN	1	Geliebt
Mädchenseele	NN	1	Mädchenseele
Ritterschaft	NN	1	Ritterschaft
Bewundrung	NN	1	Bewundrung
Muster	NN	1	Muster
Naserinchen	NN	1	Naserinchen
vergelt	VVFIN	1	vergelt
Versprich	NN	1	Versprich
Muße	NN	1	Muße
Entschuldigen	NN	1	Entschuldigen
Gauch	NN	1	Gauch
Auswahl	NN	1	Auswahl
hineinstoßen	VVPP	1	hineingestoßen
kleben	VVFIN	1	klebt
unerschöpflich	ADJD	1	unerschöpflicher
Ändern	NN	1	Ändern
anwenden	VVFIN	1	anwende
verdanken	VVINF	1	verdanken
wehren	VVINF	1	wehren
fischen	VVINF	1	fischen
schaudere	VVFIN	1	schaudere
dämpfen	VVINF	1	dämpfen
verfehlen	VVPP	1	verfehlt
contra	ADV	1	contra
Laffe	NN	1	Laffe
Raum	NN	1	Raum
Eröffne	NN	1	Eröffne
Erröten	NN	1	Erröten
Sofort	NN	1	Sofort
bürgerlich	ADJA	1	bürgerliche
Brief	NN	1	Brief
ritterlich	ADJD	1	ritterlich
Faden	NN	1	Fäden
Fürsprach	NN	1	Fürsprach
freun	VVFIN	1	freun
bürgen	VVFIN	1	bürgt
Straße	NN	1	Straßen
einzuernten	VVIZU	1	einzuernten
süßern	ADJA	1	süßern
Tisch	NN	1	Tische
werter	ADJD	1	werter
Ursache	NN	1	Ursache
äußern	VVINF	1	äußern
dazwischen	PAV	1	Dazwischen
unentschlossen	ADJD	1	unentschlossen
beständig	ADJD	1	Beständig
Gestehn	NN	1	Gestehn
trügen	VVIMP	1	trüg
verdanket	VVFIN	1	verdanket
Ballen	NN	1	Ballen
Erwähnte	NN	1	Erwähnte
Christennamen	NN	1	Christennamen
schweifen	VVFIN	1	schweift
aufgelöset	VVPP	1	aufgelöset
wägst	VVFIN	1	wägst
begierig	ADJD	1	begierig
unmild	ADJD	1	unmild
verschiednen	ADJA	1	verschiednen
Floht	NN	1	Floht
Vorrat	NN	1	Vorrat
unrecht	ADJD	1	unrecht
Prunk	NN	1	Prunk
anverwandt	VVPP	1	anverwandt
Sonnenuntergang	NN	1	Sonnenuntergang
unterdrücken	VVINF	1	unterdrücken
Gesehn	NN	1	Gesehn
harren	VVFIN	1	harret
Findt	NN	1	Findt
Knoten	NN	1	Knoten
Kapital	NN	1	Kapital
zerreißet	VVFIN	1	zerreißet
Christenpilger	NN	1	Christenpilger
schwatz	VVFIN	1	schwatz
freiwillig	ADJD	1	freiwillig
Bekenn	VVFIN	1	Bekenn
ausstatten	VVPP	1	ausgestattet
Klügste	NN	1	Klügste
zerreißen	VVPP	1	zerrissen
verscheiden	VVPP	1	verschieden
Tebnin	NN	1	Tebnin
Sonderling	NN	1	Sonderlings
Zipfel	NN	1	Zipfel
Schachern	NN	1	Schachern
Schöpfer	NN	1	Schöpfer
reuen	VVINF	1	reuen
Falt	NN	1	Falt
getrost	ADV	1	Getrost
Klumpen	NN	1	Klumpen
hinwerfen	VVPP	1	hingeworfen
abmessen	VVPP	1	abgemessen
schwindelnd	ADJD	1	schwindelnd
Bliebst	VVFIN	1	Bliebst
glühen	VVFIN	1	glüht
Dienstfertigkeit	NN	1	Dienstfertigkeit
eilet	VVFIN	1	eilet
traun	ADJD	1	traun
Entscheid|Entscheiden	NN	1	Entscheiden
zugeschworen	VVPP	1	zugeschworen
versengen	VVPP	1	versengt
finster	ADJD	1	finster
zeitlich	ADJD	1	zeitlich
Bestritten	NN	1	Bestritten
bedurfte	VVFIN	1	bedurfte
Verfügung	NN	1	Verfügung
furchtsam	ADJA	1	Furchtsamen
wirzt	VVFIN	1	wirzt
Geflohn	NN	1	Geflohn
entkräften	VVPP	1	entkräftet
Tigris	NE	1	Tigris
Verfolgen	NN	1	Verfolgen
lachen	VVPP	1	gelacht
Verliert	NN	1	Verliert
Trug	NN	1	Trug
wechseln	VVFIN	1	wechselt
Beschwatzen	NN	1	Beschwatzen
überreden	VVINF	1	überreden
allerlieb	ADJD	1	Allerliebst
Genaue	NN	1	Genauer
Inhalt	NN	1	Inhalt
stumm	ADJD	1	stumm
nichten	ADJD	1	nichten
Angehörige	NN	1	Angehörigen
vorlügen	VVPP	1	vorgelogen
Herausschmiß	NN	1	Herausschmiß
Auftrag	NN	1	Auftrag
tausendfach	ADJD	1	tausendfach
Gleisnerei	NN	1	Gleisnerei
nützlich	ADJD	1	nützlich
erhaltnen	ADJA	1	erhaltnen
Erkundigte	NN	1	Erkundigte
verreden	ADJD	1	verreden
Ehre|Ehren	NN	1	Ehren
Reich|Reiche	NN	1	Reiche
Sand	NN	1	Sand
Pilgermahl	NN	1	Pilgermahl
verlohnt	VVFIN	1	verlohnt
errat	NN	1	errat
freudig	ADJD	1	freudig
einziehn	ADJD	1	einziehn
Erdkloß	NN	1	Erdkloß
gebahnet	VVPP	1	gebahnet
Treue	NN	1	Treue
tret	VVFIN	1	tret
Widerstand	NN	1	Widerstand
kürzste	ADJA	1	kürzste
dadurch	PAV	1	dadurch
Männin	NN	1	Männin
Eidam	NN	1	Eidam
wiegte	VVFIN	1	wiegte
Versuchts	NN	1	Versuchts
Besondern	NN	1	Besondern
gaffend	ADJD	1	gaffend
Witz	NN	1	Witzes
bedientest	VVFIN	1	bedientest
Mäuschen	NN	1	Mäuschen
eilig	ADJD	1	eilig
verwandeln	VVINF	1	verwandeln
ungeformten	ADJA	1	ungeformten
umher	ADV	1	Umher
lauschen	VVFIN	1	lauscht
streuen	VVFIN	1	streute
Abgeschmackters	NN	1	Abgeschmackters
Äser	NN	1	Äser
überraschen	VVFIN	1	überrascht
Befund	NN	1	Befunden
bliebs	VVFIN	1	bliebs
heute	ADV	1	heute
nähern	VVFIN	1	nähern
unterbleiben	VVINF	1	unterbleiben
spracht	VVFIN	1	spracht
Waffenstillestand	NN	1	Waffenstillestand
Plackerei	NN	1	Plackerei
Erfodert	NN	1	Erfodert
hießet	VVFIN	1	hießet
verteidgen	NE	1	verteidgen
Gottsfürchtge	ADJA	1	Gottsfürchtge
bewahren	VVFIN	1	Bewahre
irgendwo	ADV	1	irgendwo
einkassieren	VVINF	1	einkassieren
wittern	VVINF	1	wittern
Mittel	NN	1	Mittel
bekehren	VVINF	1	bekehren
näher	PTKVZ	1	näher
pressen	VVFIN	1	preßt
Bastard	NN	1	Bastard
säumen	VVINF	1	säumen
herein	PTKVZ	1	herein
Betriegen	NN	1	Betriegen
Arbeit	NN	1	Arbeit
Beschreiben	NN	1	Beschreiben
Raserei	NN	1	Raserei
ungelegen	ADJD	1	ungelegen
gach	VVFIN	1	gach
Sonnenschein	NN	1	Sonnenschein
Weizen	NN	1	Weizen
verhöhnen	VVINF	1	verhöhnen
kleinern	NN	1	kleinern
Entdeckung	NN	1	Entdeckung
Vorwand	NN	1	Vorwand
scheinet	VVFIN	1	scheinet
beschwör	VVFIN	1	beschwör
säh	VVFIN	1	säh
stören	VVINF	1	stören
begünstigen	VVINF	1	begünstigen
Löwe	NN	1	Löwe
Verhaßt	NN	1	Verhaßt
allererst	ADJD	1	allererst
herüber	ADV	1	herüber
verklagen	VVPP	1	verklagt
kannt	VVFIN	1	kannt
pochen	VVFIN	1	pocht
Gewundert	NN	1	Gewundert
Ghebern	NN	1	Ghebern
tanzen	VVFIN	1	tanze
habts	NN	1	habts
Mummerei	NN	1	Mummerei
frommt	VVFIN	1	frommt
Scheuer|Scheuern	NN	1	Scheuern
päpstlich	ADJA	1	päpstliches
tapfre	ADJA	1	tapfre
fesseln	VVFIN	1	fesselt
Argwohnt	VVFIN	1	Argwohnt
zausen	VVINF	1	zausen
Zwei	NN	1	Zwei
frischen	VVFIN	1	frische
schier	ADJD	1	schier
Verhehlen	NN	1	Verhehlen
schlechterdings	ADV	1	schlechterdings
Geschickte	NN	1	Geschickter
angelangen	VVPP	1	angelangt
Last	NN	1	Last
bieder	ADJD	1	bieder
erhellen	VVINF	1	erhellen
Opal	NN	1	Opal
ergießend	ADJA	1	ergießend
Diözes	NN	1	Diözes
verweilst	VVFIN	1	verweilst
Fasten	NN	1	Fasten
Div	NN	1	Div
Erbe	NN	1	Erbe
Acca	NE	1	Acca
entgelten	VVINF	1	entgelten
umfassen	VVINF	1	umfassen
Erkaufen	NN	1	Erkaufen
folglich	ADV	1	folglich
bös	ADJD	1	Bös
prall	ADJA	1	prallen
auffrischen	VVIZU	1	aufzufrischen
traft	VVFIN	1	traft
Schiff	NN	1	Schiffe
hinten	ADV	1	hinten
Zerstreuung	NN	1	Zerstreuung
Herab	NN	1	Herab
staunen	VVFIN	1	staunt
geborner	ADJA	1	geborner
vergehn	ADJD	1	vergehn
allzu	PTKA	1	allzu
Gotteshäuschen	NN	1	Gotteshäuschen
Uralte	NN	1	Uralte
Nehm	VVFIN	1	Nehm
Frank	NE	1	Frank
Brett	NN	1	Brett
ablegen	VVPP	1	abgelegt
Klima	NN	1	Klimas
Menschheit	NN	1	Menschheit
Spezerei	NN	1	Spezereien
Löschen	NN	1	Löschen
Schanze	NN	1	Schanze
ungestüm	ADJD	1	ungestüm
fingt	VVFIN	1	fingt
gefolgt	ADJD	1	gefolgt
unermesslich	ADJA	1	unermeßlichen
hinwieder	ADV	1	hinwieder
Bot	NN	1	Bot
Freigebigkeit	NN	1	Freigebigkeit
nachgrübeln	VVIZU	1	nachzugrübeln
Stockjude	NN	1	Stockjude
unterstehn	VVFIN	1	unterstehn
dulden	VVINF	1	dulden
zerstreuet	VVFIN	1	zerstreuet
wanns	NN	1	wanns
zerstreuen	VVPP	1	zerstreut
eiteln	NN	1	eiteln
Sipp	NN	1	Sipp
erwartend	ADJD	1	erwartend
Schwache	NN	1	Schwachen
Gesteuert	NN	1	Gesteuert
würdge	VVFIN	1	würdge
geschäftig	ADJD	1	geschäftig
Menschenfreund	NN	1	Menschenfreund
meinetwegen	ADV	1	meinetwegen
dauern	VVFIN	1	dauern
Maß	NN	1	Maß
Rute	NN	1	Rute
Bemächtigen	NN	1	Bemächtigen
gehorsam	ADJD	1	gehorsam
verfahren	VVINF	1	Verfahren
gewähren	VVINF	1	gewähren
leugst	VVFIN	1	leugst
Lügnerin	NN	1	Lügnerin
ableugnen	VVIZU	1	abzuleugnen
göttlich	ADJA	1	göttliche
betrogen	ADJA	1	Betrogene
Seil	NN	1	Seil
Empfänger	NN	1	Empfänger
Tritt	NN	1	Tritt
ungut	ADJD	1	ungut
Näschen	NN	1	Näschen
toben	VVPP	1	getobt
Betragen	NN	1	Betragens
Beiher	NN	1	Beiher
Unmittelbar	NN	1	Unmittelbar
Kindesstatt	NN	1	Kindesstatt
Sonnenscheine	NN	1	Sonnenscheine
schwierig	ADJD	1	schwierig
schmelzen	VVINF	1	schmelzen
willen	APPO	1	willen
Kellner	NN	1	Kellner
verwenden	VVPP	1	verwandt
zerschlagen	VVFIN	1	zerschlagen
Träne	NN	1	Träne
angingst	VVFIN	1	angingst
Vorderste	NN	1	Vorderste
Geiz	NN	1	Geiz
aufgeführt	ADJA	1	aufgeführten
Erzählen	NN	1	Erzählen
verschmitzt	ADJA	1	verschmitzter
gestanden	ADJD	1	gestanden
Klosterleute	NN	1	Klosterleute
schmeichelts	VVFIN	1	schmeichelts
Ersticken	NN	1	Ersticken
Hypothes	NN	1	Hypothes
Kostbare	NN	1	Kostbares
dringen	VVFIN	1	drang
vergnügter	ADJD	1	vergnügter
Arznei	NN	1	Arznei
hintergehst	VVFIN	1	hintergehst
Flug	NN	1	Fluge
floht	ADJD	1	floht
Flur	NN	1	Flur
Flut	NN	1	Flut
Verdienet	NN	1	Verdienet
Kanal	NN	1	Kanäle
erliegen	VVFIN	1	Erliegt
Vereinigen	NN	1	Vereinigen
Schläft	NN	1	Schläft
wards	VVFIN	1	wards
barfuß	ADJD	1	barfuß
unverzüglich	ADJD	1	unverzüglich
verlenken	VVINF	1	verlenken
Träumerei	NN	1	Träumerei
Nase	NN	1	Nase
gefaßt	ADJD	1	gefaßt
Speis	NN	1	Speis
rauben	VVFIN	1	raubt
Erlaubt	NN	1	Erlaubt
blöd	ADJA	1	blöde
beladen	ADJA	1	beladenen
Verbesserer	NN	1	Verbesserer
Gezeigt	NN	1	Gezeigt
Rückhalt	NN	1	Rückhalt
übrigens	ADV	1	übrigens
Hungern	NN	1	Hungerns
Ruhe	NN	1	Ruhe
Eitelkeit	NN	1	Eitelkeit
anhören	VVIZU	1	anzuhören
entfahren	VVFIN	1	entfuhr
Stufe	NN	1	Stufen
abgehen	VVIZU	1	abzugehen
Knuppen	NN	1	Knuppen
Fällt	NN	1	Fällt
beliebt	ADJD	1	beliebt
Tand	NN	1	Tand
Erwachsen	NN	1	Erwachsen
redten	VVFIN	1	redten
Herbst	NN	1	Herbst
Seltene	NN	1	Seltene
Weiß	NN	1	Weißen
abzubangen	VVIZU	1	abzubangen
Wachen	NN	1	Wachens
begnügen	VVFIN	1	Begnügt
unterwegens	ADJD	1	unterwegens
Machtspruch	NN	1	Machtspruch
Indes	NN	1	Indes
Ungewöhnlichste	NN	1	Ungewöhnlichste
Verstopfen	NN	1	Verstopfen
spornen	VVFIN	1	spornt
dahinter	PAV	1	dahinter
Summe|Summen	NN	1	Summen
aufgedunsnen	ADJA	1	aufgedunsnen
Lebendige	NN	1	Lebendigen
erzeigt	VVFIN	1	erzeigt
Bedenken	NN	1	Bedenken
Ausmergeln	NN	1	Ausmergeln
zeugen	VVFIN	1	zeugte
erzeige	VVFIN	1	erzeige
Wichtigers	NN	1	Wichtigers
Nehmts	NN	1	Nehmts
Jauchzen	NN	1	Jauchzen
Seufzen	NN	1	Seufzen
Benehmen	NN	1	Benehmen
läßst	VVFIN	1	läßst
Erscheinen	NN	1	Erscheinen
Karawan	NN	1	Karawan
undankbar	ADJA	1	undankbaren
geleiten|leiten	VVPP	1	Geleitet
anhalten	VVIZU	1	anzuhalten
Gekauft	NN	1	Gekauft
entlocken	VVPP	1	entlockt
unterhaltendste	ADJA	1	unterhaltendste
getrennt	ADJD	1	getrennt
Wahrheitstag	NN	1	Wahrheitstag
froh	ADJD	1	Froh
Beginnt	NN	1	Beginnt
Quelle	NN	1	Quelle
Verrückt	NN	1	Verrückt
Schnurre	NN	1	Schnurre
besteh	VVFIN	1	besteh
Dergleichen	NN	1	Dergleichen
entbieten	VVFIN	1	entbot
Lehrer	NN	1	Lehrern
Gebauet	NN	1	Gebauet
Vorfahr|Vorfahren	NN	1	Vorfahren
Nerv|Nerven	NN	1	Nerven
heim	ADV	1	heim
grünen	VVINF	1	grünen
Angelegenheit	NN	1	Angelegenheit
grader	ADJA	1	grader
vorgespreizte	ADJA	1	vorgespreizte
Adlerblick	NN	1	Adlerblick
Eilt	NE	1	Eilt
Zahn	NN	1	Zahn
Abscheuliche	NN	1	Abscheuliche
Beschäm	VVIMP	1	Beschäm
geschieden	ADJD	1	geschieden
erbarmen	VVINF	1	erbarmen
Ausbund	NN	1	Ausbund
Dieselbe	NE	1	Dieselbe
liebenswürdig	ADJD	1	liebenswürdig
säen	VVPP	1	gesät
Verbrennen	NN	1	Verbrennen
Gunst	NN	1	Gunst
hochzuschätzen	VVFIN	1	hochzuschätzen
Patriarche	NN	1	Patriarche
sammeln	VVPP	1	Gesammelt
gewärtig	ADJA	1	gewärtigen
Glatteis	NN	1	Glatteis
Geschwinder	NN	1	Geschwinder
hindern	VVINF	1	hindern
heilsam	ADJD	1	heilsamer
Zurüstungen	NN	1	Zurüstungen
beklemmen	VVFIN	1	beklemmt
Ordensregeln	NN	1	Ordensregeln
Wovor	VVFIN	1	Wovor
fett	ADJD	1	fett
merklich	ADJD	1	merklich
dreifach	ADJD	1	dreifach
worin	PWAV	1	Worin
Vorausgeschickt	NN	1	Vorausgeschickt
Sinnbilderst	VVFIN	1	Sinnbilderst
gereuen	VVPP	1	gereuen
Erfüllung	NN	1	Erfüllung
Folge	NN	1	Folgen
Kaiser	NE	1	Kaiser
Europäer	NN	1	Europäers
stiegt	VVFIN	1	stiegt
erdenken	VVPP	1	erdacht
schweben	VVPP	1	geschwebt
täuschen	VVPP	1	getäuscht
Laienbruders	NN	1	Laienbruders
vertilgen	VVFIN	1	vertilgen
Bewegungsgründe	NN	1	Bewegungsgründe
zweitenmale	ADJA	1	zweitenmale
glatt	ADJA	1	glatten
Erriet	NN	1	Erriet
Vaterland	NN	1	Vaterland
Beute	NN	1	Beute
Womit	NN	1	Womit
überreichtet	VVFIN	1	überreichtet
Verzweifeln	NN	1	Verzweifeln
Trotzkopf	NN	1	Trotzkopf
Verschwendung	NN	1	Verschwendung
Hafen	NN	1	Häfen
schändlich	ADJD	1	schändlich
Hineingeschrieben	VVFIN	1	Hineingeschrieben
ausredt	ADJD	1	ausredt
Häßliche	NN	1	Häßlichen
Pfiff	NN	1	Pfiff
Allein	NN	1	Allein
Ärmern	NN	1	Ärmern
beispringen	VVIZU	1	beizuspringen
niemands	NN	1	niemands
überdenken	VVFIN	1	überdenke
Flecken	NN	1	Flecken
Unglückliche	NN	1	Unglückliche
Holzstoß	NN	1	Holzstoß
morsch	ADJA	1	morschen
Knorr	NN	1	Knorr
Stiel	NN	1	Stiel
Unterricht	NN	1	Unterricht
fahren|führen	VVFIN	1	Führe
eifersüchtig	ADJD	1	eifersüchtig
Junge	NN	1	Junge
klar	ADJD	1	klar
Borgen	NN	1	Borgen
wems	NE	1	wems
Lastertat	NN	1	Lastertat
bemüh	VVFIN	1	bemüh
reißen	VVFIN	1	Reißt
Heil	NN	1	Heil
obendrein	ADV	1	obendrein
schönern	NN	1	schönern
dufte	ADJA	1	Dufte
Segen	NN	1	Segen
hinterbringen	VVFIN	1	hinterbringen
rund	ADV	1	rund
Mal|Malen	NN	1	Malen
Silbe	NN	1	Silbe
blutge	ADJA	1	blutge
unverhohlen	ADJD	1	unverhohlen
Vermöge	NN	1	Vermöge
Willkommnen	NN	1	Willkommnen
heilig	ADJA	1	heiligen
überfallen	VVINF	1	überfallen
Abschied	NN	1	Abschied
Mütterchen	NN	1	Mütterchen
verübeln	VVINF	1	verübeln
blindlings	ADV	1	blindlings
Linie	NN	1	Linie
Skrupel	NN	1	Skrupel
Verfälschen	NN	1	Verfälschen
Erschien	NN	1	Erschien
erwähnen	VVINF	1	erwähnen
entblößen	VVPP	1	entblößt
Rührung	NN	1	Rührung
wunderlich	ADJD	1	wunderlich
Geworden	VVFIN	1	Geworden
spüren	VVIMP	1	spür
einerlei	ADV	1	Einerlei
Warnung	NN	1	Warnung
Hafis	NE	1	Hafis
Richte	NN	1	Richte
unbestochnen	ADJA	1	unbestochnen
Schönheit	NN	1	Schönheit
dieserwegen	ADJD	1	dieserwegen
klopfen	VVFIN	1	klopfen
Mammon	NN	1	Mammon
Aufwand	NN	1	Aufwand
Apostasie	NN	1	Apostasie
auffinden	VVIZU	1	aufzufinden
bettelarm	ADJD	1	bettelarm
Sträfliches	NN	1	Sträfliches
Innerste	NN	1	Innersten
feind	ADJD	1	feind
Lager	NN	1	Lager
Fluss	NN	1	Flusse
hingeworfnen	ADJA	1	hingeworfnen
entfesseln	VVPP	1	entfesselt
Empor	VVFIN	1	Empor
arabisch	ADJD	1	arabisch
fürs	APPRART	1	fürs
blühn	VVFIN	1	blühn
arg	ADJD	1	arg
faul	ADJD	1	faul
wegstoßen	VVPP	1	weggestoßen
Höhle	NN	1	Höhle
Pah	NE	1	Pah
Kreuz	NN	1	Kreuz
beten	VVINF	1	beten
Gerechnet	NN	1	Gerechnet
dumm	ADJA	1	dumme
solls	VVFIN	1	solls
hinterbrechen	VVFIN	1	hinterbracht
Gefangene	NN	1	Gefangenen
abzudingen	VVIZU	1	abzudingen
Schönres	NN	1	Schönres
Gedächtnis	NN	1	Gedächtnis
Neffe	NN	1	Neffen
vermessen	VVPP	1	vermessen
silbern	ADJD	1	silbern
Überlegen	NN	1	Überlegen
Pilger	NN	1	Pilger
Verständige	NN	1	Verständigen
Syrien	NE	1	Syrien
betrügen	VVPP	1	betrogen
beziehen	VVPP	1	bezogen
munter	ADJD	1	munter
aushalten	VVPP	1	ausgehalten
sträuben	VVFIN	1	sträubt
erhören	VVPP	1	erhört
knickerte	VVFIN	1	knickerte
Heuchlerin	NN	1	Heuchlerin
Brauchts	NN	1	Brauchts
unweit	APPR	1	unweit
ha	NE	1	ha
stündlich	ADJD	1	stündlich
Stund	NN	1	Stund
Flamm	NN	1	Flamm
Quell	NN	1	Quell
Labsal	NN	1	Labsal
beßre	ADJA	1	beßre
wiegen	VVPP	1	gewogen
Nimms	NN	1	Nimms
Siedelei	NN	1	Siedelei
unwürdig	ADJD	1	Unwürdig
Kaufmann	NN	1	Kaufmann
Eröffnen	NN	1	Eröffnen
Prüfung	NN	1	Prüfung
größre	ADJA	1	größre
bedenklich	ADJD	1	Bedenklich
schlau	ADJA	1	schlauen
Persien	NE	1	Persien
streben	VVFIN	1	strebe
grau	ADJA	1	grauen
Geber	NN	1	Geber
stürmen	VVINF	1	stürmen
Wiederkunft	NN	1	Wiederkunft
heilgen	ADJA	1	heilgen
Absein	NN	1	Absein
neben	APPR	1	neben
Dufte	NN	1	Dufte
verbrannt	ADJD	1	Verbrannt
Hervorgetreten	VVFIN	1	Hervorgetreten
hiermit	PAV	1	Hiermit
Händchen	NN	1	Händchen
erträglichern	NN	1	erträglichern
bezaubern	VVPP	1	bezaubert
Messer	NN	1	Messer
zeichnen	VVFIN	1	zeichnet
verhindern	VVPP	1	verhindert
enthalten	VVINF	1	enthalten
Palästina	NE	1	Palästina
Verstoßt	VVFIN	1	Verstoßt
Ersehn	ADJD	1	Ersehn
Strick	NN	1	Stricke
Vertrauet	NN	1	Vertrauet
Geckereien	NN	1	Geckereien
Stütze	NN	1	Stütze
Judentum	NN	1	Judentum
verfällst	VVFIN	1	verfällst
Plätzchen	NN	1	Plätzchen
Indien	NE	1	Indien
entscheiden	VVINF	1	entscheiden
Knecht	NN	1	Knecht
Anteil	NN	1	Anteil
Spion	NN	1	Spion
Raubgesindel	NN	1	Raubgesindel
Drohen	NN	1	Drohen
Los	NN	1	Los
Heh	NE	1	Heh
nachher	ADV	1	Nachher
scherzen	VVFIN	1	scherzt
alters	ADV	1	Alters
Waffe	NN	1	Waffen
Erraten	NN	1	Erraten
ängstlich	ADJD	1	ängstlich
stumpfen	VVINF	1	stumpfen
vielmal	ADV	1	vielmal
Zung	NN	1	Zung
Scheidebrief	NN	1	Scheidebrief
allerlei	PIS	1	allerlei
Schickt	NN	1	Schickt
Rechenschaft	NN	1	Rechenschaft
geführet	VVFIN	1	geführet
innerhalb	ADJD	1	innerhalb
gottergebne	ADJA	1	gottergebne
Vorwurf	NN	1	Vorwurfs
schielen	VVFIN	1	schielt
Zutrauns	NN	1	Zutrauns
heische	ADJA	1	heische
entziehen	VVFIN	1	entzog
auserwählt	ADJA	1	auserwählte
Besinnen	NN	1	Besinnen
getrauen	VVIMP	1	getrau
mühsam	ADJD	1	mühsam
Ans	NE	1	Ans
Abglanz	NN	1	Abglanz
Sina	NE	1	Sina
Brautschatz	NN	1	Brautschatz
eintreten	VVFIN	1	eintritt
Konnts	NN	1	Konnts
Zierde	NN	1	Zierde
Geizigsten	NN	1	Geizigsten
Pracht	NN	1	Pracht
neugiergem	ADJA	1	neugiergem
Winseln	NN	1	Winseln
Mörder	NN	1	Mörder
undenkbar	ADJD	1	undenkbar
abhelfen	VVIZU	1	abzuhelfen
kränken	VVINF	1	kränken
greifen	VVINF	1	greifen
belauschen	VVINF	1	belauschen
Muskel	NN	1	Muskeln
Vergnügsam	ADJD	1	Vergnügsam
Posten	NN	1	Posten
beschreiben	VVPP	1	beschrieben
ersetzen	VVINF	1	ersetzen
Reit	VVFIN	1	Reit
Reis	NN	1	Reis
Prophet	NN	1	Propheten
Reiz	NN	1	Reizes
siebenmal	ADV	1	siebenmal
Wein	NN	1	Wein
stumpf	ADJA	1	stumpfen
Geistlichkeit	NN	1	Geistlichkeit
bewundern	VVINF	1	bewundern
Ungebührliche	NN	1	Ungebührliches
Wiege	NN	1	Wiege
halb	ADJD	1	halb
Zersprengen	NN	1	Zersprengen
Siebensache	NN	1	Siebensachen
Gerufen	NN	1	Gerufen
Mien	NE	1	Mien
Richterstuhl	NN	1	Richterstuhl
Bescheidne	ADJA	1	Bescheidne
Erheben	NN	1	Erheben
kleinst	PTKVZ	1	kleinst
Aufschluss	NN	1	Aufschluß
Wähnen	NN	1	Wähnen
martern	VVINF	1	martern
Zufall	NN	1	Zufall
mäkeln	VVINF	1	mäkeln
weh	ADJD	1	weh
zög	VVIMP	1	zög
Woche	NN	1	Wochen
vermählen	VVFIN	1	vermählt
umkehren	VVFIN	1	umkehrt
schmutzgen	ADJA	1	schmutzgen
fliehn	ADJD	1	fliehn
Eis	NN	1	Eis
Musterring	NN	1	Musterring
Ablauf	NN	1	Ablauf
persisch	ADJD	1	Persisch
bequem	ADJA	1	bequemeres
schade	ADJD	1	Schade
Nil|Nils	NE	1	Nils
Feuerkohlen	NN	1	Feuerkohlen
Original	NN	1	Original
nachts	ADV	1	Nachts
taugts	VVFIN	1	taugts
leidig	ADJA	1	leidige
erleben	VVFIN	1	erleben
unterbrechen	VVINF	1	unterbrechen
Beteurte	NN	1	Beteurte
desgleichen	ADV	1	desgleichen
Bekannt	NN	1	Bekannt
denken|gedenken	VVPP	1	gedacht
anschlagen	VVIZU	1	anzuschlagen
erpicht	ADJD	1	erpicht
Obern	NN	1	Obern
stutzest	VVFIN	1	stutzest
Umarmen	NN	1	Umarmen
rücken	VVINF	1	rücken
erkund	VVFIN	1	erkund
eilst	VVFIN	1	eilst
Schwab	NE	1	Schwab
Entwurf	NN	1	Entwürfe
Ort	NN	1	Ort
nachgeben	VVPP	1	nachgegeben
Strand	NN	1	Strand
Gnüge	NN	1	Gnüge
erziehn	VVINF	1	erziehn
Zange	NN	1	Zange
Verwiesen	NN	1	Verwiesen
walten	VVFIN	1	waltet
Ptolemais	NN	1	Ptolemais
Schweinefleisch	NN	1	Schweinefleisch
Jugend	NN	1	Jugend
Mamelucken	NN	1	Mamelucken
verlöschen	VVPP	1	verloschen
hetzen	VVFIN	1	hetzt
bestreiten	VVFIN	1	bestreitet
selb	PDAT	1	selben
Lüge	NN	1	Lüge
drein	ADV	1	drein
Amm	NN	1	Amm
Gewinn	NN	1	Gewinn
Gewünscht	NN	1	Gewünscht
trocknen	VVINF	1	trocknen
rühr	VVFIN	1	rühr
Paket	NN	1	Paket
ergiebig	ADJD	1	ergiebiger
Amt	NN	1	Amt
Sorgfalt	NN	1	Sorgfalt
wecken	VVFIN	1	weckt
unsertwillen	ADJA	1	unsertwillen
Vorauszusetzen	NN	1	Vorauszusetzen
gelobt	ADJA	1	gelobten
Bezeihen	NN	1	Bezeihen
hängen	VVFIN	1	hängt
hastig	ADJD	1	hastig
Beruf	NN	1	Beruf
Vertrauen	NN	1	Vertrauen
Abendländer|Abendland	NN	1	Abendländer
Gold	NN	1	Gold
gießen	VVFIN	1	goß
opfern	VVINF	1	opfern
sandt	ADJD	1	sandt
Stöber	NN	1	Stöber
Verschweig	NE	1	Verschweig
Damaskus	NE	1	Damaskus
zweifeln	VVFIN	1	zweifelt
Entzögest	VVFIN	1	Entzögest
ärgerlich	ADJD	1	ärgerlich
tragen|trügen	VVFIN	1	trüge
ertrinken	VVPP	1	ertrunken
Wunderkraft	NN	1	Wunderkraft
manchmal	ADV	1	manchmal
überliefern	VVPP	1	überliefert
Iman	NN	1	Iman
würdigen	VVPP	1	Gewürdigt
Haut	NN	1	Haut
warens	ADV	1	warens
trotzgen	ADJA	1	trotzgen
einbringen	VVPP	1	eingebracht
vermeine	VVFIN	1	vermeine
Geschmack	NN	1	Geschmack
Zeitung	NN	1	Zeitung
anreden	VVIZU	1	anzureden
auferziehen	ADJD	1	auferziehen
abzwacken	VVIZU	1	abzuzwacken
vertreiben	VVPP	1	vertrieben
Schwätzer	NN	1	Schwätzer
Zählen	NN	1	Zählens
würgen	VVINF	1	würgen
Gebar	NN	1	Gebar
Schlimmste	NN	1	Schlimmstes
vortrefflich	ADJD	1	vortrefflich
schadets	NN	1	schadets
