Title: Damon, oder die wahre Freundschaft
Number of all lemmas: 7385
Nummber of different lemmas: 1089

Lemma	POS	Frequency	Tokens
ich	PPER, PRF	505	ich, mir, mich, Ich
die	PDS, ART, PRELS, PRELAT, PDAT	330	das, die, Die, Das, des, dem, der, den, Der, Den, dessen, Dessen, deren, Dem
sein	VAFIN, PPOSAT, VAINF, VAPP	283	ist, war, sei, sind, seinem, wäre, wären, sein, bin, waren, seine, seinen, gewesen, Wäre, Ist, Sind, Seinen, Seinem, Sein, Sei, Seines, Seiner
Sie	PPER	281	Ihnen, Sie
er	PPER	215	ihn, ihm, er, Er, Ihn
haben	VAFIN, VAINF, VAPP, VAIMP	161	hat, haben, habe, hättest, hätte, hätten, gehabt, Habt, Hätte, habt, hatten, Haben, hatte, hab, Habe
werden	VAFIN, VAINF, VAPP	131	wird, wurden, Werden, werde, werden, würde, Wird, würden, Würde, wirst, worden, geworden
es	PPER	125	es, Es
eine	ART, PIS	124	ein, einen, einem, eine, einer, Einer, eines, Ein, Eine
zu	APPRART, PTKVZ, PTKZU, PTKA, APPR	114	zur, zu, Zum, zum, Zu
und	KON	112	und, Und
so	ADV	108	so, So
nicht	PTKNEG	100	nicht, Nicht
ihr	PPOSAT, PPER, PRF	96	ihrer, Ihre, ihr, ihrem, ihren, Ihr, ihre, Ihrem, Ihrer, Euch, euch, Ihren, Ihres
mein	PPOSAT	94	meine, meiner, mein, meinem, meines, Mein, Meiner, meinen
verstehen	VVINF, VVFIN, VVIMP	87	verstehen, verstehe, verstehst, versteht, Versteh, versteh
sie	PPER	84	sie, ihnen, Ihr
was	PWS, PRELS, PIS, PIAT	84	was, Was
wenn	KOUS	77	Wenn, wenn
dass	KOUS	74	daß
wollen	VMFIN, VMINF	68	will, Wollte, wollten, wollen, wollte, wollt
können	VMFIN, VVFIN, VMINF, VVINF	54	kann, Kann, können, könnten, Kannst, könnte, könnt, Könntet, Könnten, Könnte
Freund	NN, NE	52	Freunde, Freundes, Freund, Freunden
auch	ADV	50	auch
doch	ADV, KON	48	doch, Doch
Leander	NE	47	Leander
von	APPR, APPRART	46	von, vom
als	KOKOM, KOUS, KON	42	als, Als
Damon	NE	42	Damon
mit	APPR, PTKVZ	42	mit, Mit
ja	PTKANT, ADV	42	Ja, ja
aber	ADV, KON	41	aber, Aber
sich	PRF	41	sich
in	APPR, APPRART	40	in, In, im, ins
wir	PPER, PRF	39	wir, uns, Wir
nun	ADV	38	Nun, nun
wohl	ADV	38	wohl, Wohl
auf	APPR	36	auf, Auf
alle	PIAT, PIS	36	Alle, alles, allen, alle, allem, Alles, aller
nur	ADV	35	Nur, nur
sollen	VMFIN	34	sollten, sollte, soll, Sollte, Soll, sollen, Sollten, solle
für	APPR	33	für
dies	PDAT, PDS	33	diesen, dieses, Dieses, diesem, Diese, dieser, diese, dies
wie	KOUS, KOKOM	32	wie, Wie
noch	ADV, KON	31	Noch, noch
bei	APPR	29	bei, Bei
wissen	VVFIN	29	weiß, wußten, wüßte, wissen, Wissen, Wisset
müssen	VMFIN, VMINF	28	muß, müssen, mußtest, Müssen, müßte, Muß
Freundschaft	NN	27	Freundschaft
sagen	VVINF, VVFIN, VVPP, VVIMP	27	sagen, sage, sagten, sagt, gesagt, sag
man	PIS	25	man, Man
Herr	NN	25	Herren, Herr, Herrn
an	APPRART, APPR, PTKVZ	25	am, an
beide	PIS, PIAT	24	beide, Beide, beiden, beider
gut	ADJD, ADJA	23	gut, besser, besten, guter, guten, beste, gute
machen	VVINF, VVFIN, VVPP	23	machen, machten, macht, Machen, Mache, mache, gemacht
tun	VVPP, VVFIN, VVINF	22	getan, tun, täten, Tun, täte, tut, tue, tat
selbst	ADV	21	selbst
geben	VVFIN, VVINF, VVPP	20	gäbe, geben, gegeben, gäben, gibt, gebe
Frau	NN	20	Frau
Vetter	NE, NN	19	Vetter
schon	ADV	19	schon, Schon
andere	PIS, PIAT	19	andre, andern, andres, anderer
lassen	VVFIN, VVINF	19	Lassen, ließe, lasse, lassen, ließ, Laßt, läßt, laßt
lieb	ADJD, ADJA	19	lieber, Lieben, liebsten, liebster, Liebster, liebe
da	ADV, KOUS, PTKVZ	18	da, Da
Liebe	NN	18	Liebe
nichts	PIS	17	nichts, Nichts
oder	KON	17	oder, Oder
Himmel	NN	17	Himmel, Himmels
gehen	VVFIN, VVINF, VVIMP, VVPP	17	geht, gehen, Geh, geh, gegangen, gehe, Gehen
gewiss	ADJD, ADJA	16	gewiß, gewissen
einmal	ADV	16	einmal
glücklich	ADJA, ADJD	16	glücklichste, glücklichsten, glücklich
denn	ADV, KON	16	denn
du	PPER, PRF	16	Du, dich, dir, du
mögen	VMFIN	16	möchte, mögen, mag, möge
ach	ITJ	16	Ach, ach
verlieren	VVPP, VVFIN, VVINF	15	verloren, verliert, verlieren, verlöre, verlören, verliere
wieder	ADV	15	wieder
mehr	ADV	15	mehr
Unglück	NN	15	Unglück, Unglücke
sehen	VVFIN, VVINF, VVPP	15	sehe, sehen, gesehen, sähe, sieht
gleich	ADJD, ADJA	15	gleich, gleicher, gleichem, gleichen
O	NN	15	O
ob	KOUS, ADV	15	Ob, ob
ganz	ADV, ADJA	14	ganz, ganzes, ganze, ganzen
Vermögen	NN	14	Vermögen, Vermögens
nein	PTKANT	14	Nein, nein
wer	PWS	14	wer, wen, Wer, Wen
ha	NE	14	ha
dazu	PAV	13	dazu, Dazu
reden	VVFIN, VVINF	13	redete, Reden, redet, reden
Schiff	NN	13	Schiff, Schiffe
keine	PIAT, PIS	13	keine, keiner, keinen, keins, kein, Keines
Ehre	NN	13	Ehre
aus	APPR, PTKVZ	12	aus, Aus
hören	VVINF, VVFIN	12	hören, höre, Hören, höret, Höre
Herz	NN	12	Herz, Herzen, Herzens
glauben	VVFIN, VVINF, VVPP	12	glauben, glaube, Glauben, geglaubt
erst	ADV, ADJA	12	erst, erste, ersten
durch	APPR	11	durch
denken	VVFIN, VVINF	11	dächte, denkt, denken, Denkt
also	ADV	11	also
setzen	VVPP, VVINF, VVFIN	11	gesetzt, setzen, Setzen, Gesetzt, setzten
wahr	ADJD, ADJA	11	wahr, wahre
Gott	NN	11	Gott
lieben	VVINF, VVFIN, VVPP	11	lieben, geliebt, liebe, liebt, liebte
um	APPR, KOUI	11	um, Um
Lisette	NE	11	Lisette
über	APPR	10	über
bleiben	VVFIN, VVPP, VVINF	10	blieben, geblieben, bleibe, bleiben, bleibt, blieb, Bleiben
Recht	NN	10	Recht, Rechts
eben	ADV	10	eben
viel	ADV	10	viel
genug	ADV	10	genug
welche	PWS, PWAT, PRELS	10	Welchen, welche, welches, welcher, welchem
viele	PIAT, PIS	10	viel
kommen	VVFIN, VVINF	10	kommen, Kommen, käme, komme
bald	ADV	10	bald, Bald
vielleicht	ADV	10	vielleicht, Vielleicht
erklären	VVINF, VVFIN	9	erklären, erklärten, erklärt, erklärte, Erklären
er|es	PPER	9	Ihm
itzo	ADJA, VVFIN, ADJD	9	itzo
bekommen	VVINF, VVFIN, VVPP	9	bekommen
nach	PTKVZ, APPR	9	nach
sehr	ADV	9	sehr
verzeihen	VVFIN, VVINF, VVPP	9	verzeihen, verziehen, verzeiht
kömmt	VVFIN, ADJA	9	kömmt
zweifeln	VVFIN, VVINF	9	zweifle, Zweifelt, Zweifeln, zweifeln
unser	PPOSAT	9	unser, unsrer, unsere, unsers, Unsere, unserm, unserer
niederträchtig	ADJA, ADJD	8	niederträchtige, niederträchtig, niederträchtigen, niederträchtiger, Niederträchtig
wenige	PIS, PIAT	8	wenig
alsdenn	NE, NN	8	alsdenn
groß	ADJA, ADJD	8	größte, größten, groß, große, größtes
gegen	APPR	8	gegen
Leandern	NE	8	Leandern
aufrichtig	ADJD, ADJA	8	aufrichtig, aufrichtigen, aufrichtige, aufrichtiger, Aufrichtig
zärtlich	ADJD, ADJA	8	zärtlicher, zärtlichen, zärtlichste, zärtlichsten, zärtlich
bringen	VVINF, VVPP, VVFIN	8	bringen, gebracht, brächten, brachte, bringt
wo	PWAV	8	wo, Wo
suchen	VVFIN, VVINF	8	suchte, suchen, sucht, suchten
gar	ADV	8	gar
vor	APPR, PTKVZ	8	vor
Zeit	NN	8	Zeit
unglücklich	ADJD, ADJA	8	unglücklich, unglücklichste
zwei	CARD	8	zwei, Zwei
Nachricht	NN	8	Nachricht
gern	ADV	7	gern
edel	ADJA, ADJD	7	edlere, edler, edle, edel
niemand	PIS	7	niemand, Niemand, niemanden
Neigung	NN	7	Neigung, Neigungen
eher	ADV	7	eher
Witwe	NN	7	Witwe
nehmen	VVFIN, VVINF	7	nahm, nehmen, Nehmen, nähmen
euer	PPOSAT	7	Eurer, Eure, Euer
Vergnügen	NN	7	Vergnügen
finden	VVFIN, VVINF, VVPP	7	Findet, finden, finde, gefunden
verlassen	VVFIN, VVPP	7	Verlassen, verlasse, verlassen
Ha	NE	7	Ha
Geld	NN	7	Gelder, Geldern, Geld, Geldes
fein	ADJD	7	Fein, fein
hier	ADV	7	hier, Hier
empfindlich	ADJD	6	empfindlicher, empfindlich
Leben	NN	6	Leben, Lebens
Pflicht	NN	6	Pflichten, Pflicht
ohne	APPR, KOUI	6	ohne
neu	ADJA	6	neue, neuem
Absicht	NN	6	Absichten
Madam	NN	6	Madam
großmütig	ADJD, ADJA	6	großmütig, großmütigen
halten	VVFIN, VVINF	6	halten, Halten, halte
Reichtum	NN	6	Reichtum, Reichtümer
Gedanke	NN	6	Gedanken
Handel	NN	6	Handel
bitten	VVINF, VVFIN	6	bitten, bittet, bitte
klein	ADJA, ADJD	6	kleiner, klein, kleines, kleine
anfangen	VVINF, VVIZU, VVFIN	6	anfangen, anzufangen, anfängt
diese	PDS	6	dieses, dieser, diese
je	ADV, KOUS, APPR	6	Je, je
beleidigen	VVINF, VVFIN, VVPP	6	beleidigen, beleidigten, beleidigt
scheinen	VVFIN	6	scheint, schien, scheinen
dürfen	VMFIN	6	dürfte, darf, Darf
unter	APPR	6	unter, Unter
Art	NN	6	Art
Hand	NN	6	Händen, Hand
helfen	VVFIN, VVINF, VVPP	6	hilft, helfen, geholfen
etwas	ADV	6	etwas
selber	ADV	5	selber
besitzen	VVFIN, VVPP	5	besäße, besitze, besitzen, besessen
folgen	VVFIN, VVINF, VVIMP	5	folgten, folgen, folgt
darauf	PAV	5	darauf
Rede|Reden	NN	5	Reden
heiraten	VVINF	5	heiraten
warten	VVFIN, VVINF	5	warten, warteten
wegen	APPR, APPO	5	wegen
Wort	NN	5	Wort
vollkommen	ADJD, ADJA	5	vollkommen, Vollkommen, vollkommene
Ursache	NN	5	Ursache
Glück	NN	5	Glück
sonst	ADV	5	sonst
verdrießlich	ADJD, ADJA	5	verdrießlich, Verdrießliche
beleidiget	VVFIN	5	beleidiget
recht	ADJD	5	recht
sorgen	VVFIN, VVINF	5	Sorgen, sorgen
kennen	VVFIN, VVINF	5	kenne, kennen
Nebenbuhler	NN	5	Nebenbuhler, Nebenbuhlern
meinen	VVFIN	5	meinen, meine
besorgen	VVFIN	5	besorge, besorgte, besorgten
Welt	NN	5	Welt
leicht	ADJD	5	leicht, leichter
jung	ADJA	5	jungen, junge
versuchen	VVINF, VVFIN	4	versuchen, versuchten, Versuchen
Seele	NN	4	Seelen, Seele
Freier	NN	4	Freier
aufs	APPRART	4	aufs
Tonne	NN	4	Tonne, Tonnen
Person	NN	4	Person
Gut	NN	4	Güter, Gut
mirs	ADJD	4	mirs
liebenswürdig	ADJA, ADJD	4	liebenswürdigen, liebenswürdigsten, liebenswürdige, liebenswürdig
Entschluss	NN	4	Entschluß, Entschlusses
Leanders	NE	4	Leanders
zeigen	VVFIN, VVINF	4	zeigen
danken	VVINF	4	danken
schimpfen	VVINF, VVPP, VVFIN	4	schimpfen, geschimpft, schimpfte, schimpft
damit	KOUS, PAV	4	damit
sehnen	VVIMP	4	sehn
untergehen	VVPP	4	untergegangen
antworten	VVINF	4	antworten
angenehm	ADJA, ADJD	4	angenehme, angenehm
solche	PIAT	4	solchen, solche
stehen	VVFIN	4	stünde, steht, stehet, stünden
Ja	NN	4	Ja
schwach	ADJD	4	schwach
heute	ADV	4	Heute, heute
desto	KON	4	desto
möglich	ADJA, ADJD	4	möglichstes, möglich, mögliche
andermal	ADV	4	andermal
Schande	NN	4	Schande
nie	ADV	4	nie
Gold	NN	4	Goldes
meinig	PPOSS	4	meinige, meinigen
Beleidigung	NN	4	Beleidigungen
allerdings	ADV	4	allerdings
empfinden	VVINF, VVFIN	4	empfinden, empfinde
hübsch	ADJD, ADJA	4	hübsch, hübsche, hübschen
schweigen	VVFIN, VVIMP, VVINF	4	schwiegen, schweig, schweigt, schweigen
einander	PRF	4	einander
davon	PAV, PTKVZ	4	davon
Haus	NN	4	Haus, Hause, Häusern
süß	ADJA	4	süßen, süße
lang	ADJD	4	länger, lang
notwendig	ADJD	4	notwendig, Notwendig
dienen	VVINF, VVFIN, VVPP	3	dienen, dient, gedient
zuwider	PTKVZ, ADV	3	zuwider
deswegen	PAV	3	deswegen
Erbe|Erben	NN	3	Erben
übel	ADJD	3	übel
Tag	NN	3	Tagen, Tage
gestehen	VVINF, VVFIN	3	gestehen
Liebhaber	NN	3	Liebhaber
Verzeihung	NN	3	Verzeihung
vorher	ADV	3	vorher
verstehn	VVFIN	3	verstehn
bereden	VVINF	3	bereden
St	NE	3	St
befürchten	VVFIN	3	Befürchten, befürchte
paar	PIS, PIAT	3	Paar
Augenblick	NN	3	Augenblick
Probe	NN	3	Probe
verlangen	VVFIN, VVPP	3	verlangen, verlangt
Frage	NN	3	Frage
Hui	NE	3	Hui
halb	ADJA, ADJD	3	halbe, halb
entreißen	VVINF	3	entreißen
Verstehn	VVFIN	3	Verstehn
liegen	VVPP, VVFIN	3	gelegen, liegen, liegt
endlich	ADV	3	endlich
unterscheiden	VVFIN, VVINF, VVPP	3	unterschieden, unterscheiden
vorkommen	VVINF	3	vorkommen
Scham	NN	3	Scham
behalten	VVINF	3	behalten
einerlei	PIAT, ADV	3	einerlei
raten	VVFIN, VVINF	3	rate, raten
ankommen	VVINF, VVPP	3	ankommen, angekommen
schlagen	VVINF, VVFIN	3	schlagen, schlüge, schlage
jen	PDAT, PDS	3	jener, Jener, jenen
Aufführung	NN	3	Aufführung
umsonst	ADV	3	umsonst
Rede	NN	3	Rede
Umstand	NN	3	Umständen, Umstände
ichs	ADJD	3	ichs
dasjenige	PDS	3	dasjenige
kurz	ADJA, ADJD	3	kurzem, Kurz, kurzen
ausüben	VVIZU	3	auszuüben
vorstellen	VVINF, VVPP, VVFIN	3	vorstellen, vorgestellt, vorstelle
erhalten	VVPP	3	erhalten
leben	VVFIN, VVIMP	3	Lebt, Leb, Leben
unsre	PPOSAT	3	Unsre, unsre
klug	ADJD	3	klug, klüger
dein	PPOSAT	3	deine, dein
Dank	NN	3	Dank
überlegen	VVFIN	3	Überlegen
allezeit	ADV	3	allezeit
Glücke	NN	3	Glücke
böse	ADJA	3	bösen, böse
dadurch	PAV	3	dadurch
wider	PTKVZ, APPR	3	wider
Sache	NN	3	Sachen
gleichviel	ADV	3	gleichviel
eitel	ADJA, ADJD	3	eitle, eitel
Madame	NN	3	Madame
Liebste	NN	3	Liebste, Liebsten
einzig	ADJA	3	einzige
wenig	ADV	3	wenig
Untreue	NN	3	Untreue
entdecken	VVFIN, VVINF	3	entdeckten, entdecken, Entdecken
verzeihen|verziehen	VVFIN	3	Verziehen, verziehen
vertrauen	VVINF, VVFIN	3	vertrauen, vertraue
weg	PTKVZ, ADV	3	weg
Auge	NN	3	Augen
Schimpf	NN	3	Schimpfe, Schimpf
anwenden	VVFIN, VVINF	3	anwendeten, anwenden
Gelegenheit	NN	3	Gelegenheit
schade	ADJD	3	Schade, schade
bloß	ADJA, ADJD	3	bloßer, bloß, bloße
Vorschlag	NN	3	Vorschlag
allzu	PTKA	3	allzu
wünschen	VVINF, VVFIN	3	wünschen, wünschte
einige	PIAT, PIS	3	einige
entschließen	VVPP, VVINF	3	entschlossen, entschließen
daran	PAV	3	daran
ehe	KOUS	3	Ehe, ehe
munter	ADJD	3	munter
Hälfte	NN	3	Hälfte
etwan	NE	3	etwan
weder	KON	3	weder, Weder
Verdruss	NN	3	Verdruß
erfahren	VVPP, VVINF	2	erfahren
Eidschwur	NN	2	Eidschwur
Traum	NN	2	Träume
gesteh	VVFIN	2	gesteh
Liebeserklärung	NN	2	Liebeserklärungen, Liebeserklärung
Sprache	NN	2	Sprache
reizender	ADJD	2	reizender
voraus	PTKVZ	2	voraus
verliebt	ADJA	2	verliebten, verliebte
wohin	PWAV	2	wohin
billig	ADJD	2	billig
wählen	VVINF	2	Wählen, wählen
Wahl	NN	2	Wahl
Ihrigen	NN	2	Ihrigen
fehlen	VVFIN	2	fehlt
schenken	VVPP, VVFIN	2	geschenkt, schenken
trotz	APPR	2	trotz
wiederholen	VVFIN, VVINF	2	wiederholte, wiederholen
Gütigkeit	NN	2	Gütigkeit
lustig	ADJD	2	lustig
banqueroute	NN	2	banqueroute
weil	KOUS	2	weil
gewissenhaft	ADJD	2	gewissenhaft
Grillenfänger	NN	2	Grillenfänger
schaden	VVFIN, VVINF	2	schadet, schaden
Wasser	NN	2	Wasser
sachte	ADV	2	sachte
wertester	ADJA	2	wertester
bewusst	ADJA	2	bewußten
begehen	VVPP	2	begangen
redlich	ADJA, ADJD	2	redliche, redlich
Ausschlag	NN	2	Ausschlag
hintergehen	VVPP, VVINF	2	hintergangen, hintergehen
unmöglich	ADJD	2	unmöglich
zugleich	ADV	2	zugleich
vergessen	VVPP, VVINF	2	vergessen
anstehen	VVFIN, VVINF	2	ansteht, anstehen
schmeicheln	VVFIN, VVINF	2	schmeicheln
Gegenstand	NN	2	Gegenstand
einig	ADJD	2	einig
deutlich	ADJD	2	deutlich
teils	ADV	2	teils
Verdacht	NN	2	Verdacht
mal	ADV	2	mal
Kapitale	NN	2	Kapitalen, Kapitale
eigen	ADJA	2	eigenen
erwählen	VVPP, VVINF	2	erwählt, erwählen
hoffen	VVFIN	2	hoffe
Ers	ADJD	2	Ers
schändlich	ADJA, ADJD	2	schändlichen, schändlich
versichre	VVFIN	2	versichre
antreffen	VVPP	2	angetroffen
übereinstimmen	VVFIN, VVINF	2	übereinstimmte, übereinstimmen
Rat	NN	2	Rat
itzt	VVFIN, ADJD	2	itzt
unbekannt	ADJD	2	unbekannt
nötigen	VVINF, VVFIN	2	nötigen, nötige
ei	NE	2	Ei
prächtig	ADJD, ADJA	2	prächtig, prächtige
schämen	VVFIN	2	schäme, schämen
Verstand	NN	2	Verstand
derjenige	PDS	2	denjenigen
Irrung	NN	2	Irrung
weniger	ADV	2	weniger
ihrige	PPOSAT	2	Ihrige
desgleichen	ADV	2	desgleichen
Begriff	NN	2	Begriffen, Begriffe
irren	VVINF, VVFIN	2	irren, irre
Henker	NN	2	Henker
blind	ADJA, ADJD	2	blinden, blind
wagen	VVFIN, VVPP	2	wagt, gewagt
Narr	NN	2	Narren, Narr
einen	ADJA, VVIMP	2	einen, ein
gedenken	VVINF, VVFIN	2	gedenken
zwar	ADV	2	zwar
Banqueroute	NN	2	Banqueroute
nennen	VVFIN	2	nennen, nennt
zittern	VVFIN	2	zittere
Närrin	NN	2	Närrin
wenigstens	ADV	2	wenigstens
Gemüt	NN	2	Gemüter, Gemüt
verbinden	VVPP	2	verbunden
einbilden	VVINF	2	einbilden
leugnen	VVINF	2	leugnen
derohalben	NN	2	derohalben
Einfall	NN	2	Einfall
gerühret	ADJD, VVPP	2	gerühret
beinahe	ADV	2	Beinahe, beinahe
überlassen	VVPP	2	überlassen
jemand	PIS	2	jemanden, jemand
Mode	NN	2	Mode
kostbar	ADJA	2	kostbarste, kostbare
aushalten	VVINF, VVIZU	2	aushalten, auszuhalten
beistehen	VVIZU, VVINF	2	beizustehen, beistehen
einsehen	VVINF, VVIZU	2	einsehen, einzusehen
Weg	NN	2	Weg
ungegründeten	ADJA	2	ungegründeten
o	NE, ADJA	2	o
beurteilen	VVFIN	2	beurteilt, beurteile
Pöbel	NN	2	Pöbel
weswegen	PWAV	2	weswegen
bekümmern	VVFIN, VVPP	2	bekümmert
Großmut	NN	2	Großmut
Sanftmut	NN	2	Sanftmut
fünfmal	ADV	2	Fünfmal
etwa	ADV	2	etwa
annehmen	VVINF	2	annehmen
schwer	ADJD	2	schwer, schwerer
Zweifel	NN	2	Zweifel
Tausch	NN	2	Tausch
gefallen	VVINF, VVFIN	2	gefallen, gefällt
trauen	VVFIN	2	trauen
aufhelfen	VVIZU, VVINF	2	aufzuhelfen, aufhelfen
schreiben	VVPP	2	geschrieben
stumm	ADJA	2	stumme
weiter	PTKVZ	2	weiter
versichern	VVFIN	2	versichert, Versichern
drum	PAV	2	Drum
Geschenk	NN	2	Geschenk
Fehler	NN	2	Fehler, Fehlers
Schaden	NN	2	Schaden
Wahrheit	NN	2	Wahrheit
erschrecken	VVFIN	2	Erschrecken, erschrecken
teilen	VVINF, VVFIN	2	teilen, teilten
entziehen	VVINF, VVPP	2	entziehen, entzogen
Sturm	NN	2	Sturme
scheinbar	ADJA, ADJD	2	scheinbare, scheinbar
Handlung	NN	2	Handlung
freund	ADJD	2	Freund
bestürzen	VVPP	2	bestürzt
erzählen	VVFIN, VVINF	2	erzähle, erzählen
vernünftig	ADJA, ADJD	2	vernünftigsten, vernünftig
eigennützig	ADJA, ADJD	2	eigennützige, eigennützig
vermuten	VVPP, VVFIN	2	vermutet, vermuteten
verunglücken	VVPP	2	verunglückt
manche	PIS	2	mancher, manchem
warum	PWAV	2	warum, Warum
dabei	PAV	2	dabei
ab	PTKVZ	2	ab
alleine	PTKVZ, ADV	2	alleine
stellen	VVFIN, VVPP	2	stellt, gestellt
Mannsperson	NN	2	Mannspersonen
sprechen	VVFIN, VVPP	2	spricht, gesprochen
just	ADV	2	just
Mutter	NN	2	Mutter
anders	ADV	2	anders
abwarten	VVINF, VVIZU	2	abwarten, abzuwarten
niemals	ADV	2	niemals
schwören	VVINF, VVPP	2	schwören, geschworen
erwarten	VVINF	2	erwarten
bis	KOUS, APPR	2	bis
Spötterei	NN	2	Spöttereien
widerfahren	VVFIN, VVPP	2	widerführe, widerfahren
fünf	CARD	2	fünf
hieher	NN	2	hieher
lesen	VVFIN	2	lese
schicken	VVPP, VVINF	2	geschickt, schicken
ungestüm	ADJD, ADJA	2	ungestüm, ungestümes
fragen	VVINF	2	fragen
verschweigen	VVINF, VVPP	2	verschweigen, verschwiegen
Gesicht	NN	2	Gesichte
gestünde	VVFIN	2	gestünde
daraus	PAV	2	daraus
vergelten	VVFIN	2	vergelte
Ostindien	NE	2	Ostindien
fern	ADJD	2	ferner, fern
zürnen	VVINF, VVFIN	2	zürnen
besondern	VVFIN	2	besondre
stark	ADJD	2	stärker, Stark
handeln	VVINF	2	handeln
verdienen	VVPP, VVFIN	2	verdient
übrig	ADJD	2	übrig
Mensch	NN	2	Mensch
am	PTKA	2	am
hart	ADJA	2	harte, harten
gesetzt	ADJD	2	Gesetzt, gesetzt
Klugheit	NN	2	Klugheit
Testament	NN	2	Testamente
ausschlagen	VVINF	2	ausschlagen
Exempel	NN	2	Exempel
Lust	NN	2	Lust
trennen	VVINF	2	trennen
Leichtsinnigkeit	NN	2	Leichtsinnigkeit
Erfüllung	NN	1	Erfüllung
werfen	VVINF	1	werfen
verhungern	VVINF	1	verhungern
Nase	NN	1	Nase
Verlust	NN	1	Verlust
alt	ADJA	1	alten
dagegen	PAV	1	dagegen
Winter	NN	1	Winter
quälen	VVFIN	1	quält
gescheute	ADJA	1	gescheute
zustoßen	VVPP	1	zugestoßen
übrigens	ADV	1	übrigens
betrübt	ADJA	1	betrübte
stehlen	VVPP	1	gestohlen
Übereilung	NN	1	Übereilung
ohngeachtet	NE	1	ohngeachtet
philosophisch	ADJD	1	philosophisch
entzücket	NN	1	entzücket
schwerlich	ADJD	1	schwerlich
gemein	ADJD	1	gemein
recht|rechts	ADJA	1	rechten
vorfallender	ADJA	1	vorfallender
gestern	ADV	1	gestern
Tat	NN	1	Taten
Rang	NN	1	Rang
gröblich	ADJD	1	gröblich
beliebt	ADJD	1	beliebt
Misstrauen	NN	1	Mißtrauen
gewahr	ADJD	1	gewahr
heißen	VVFIN	1	heißt
Banquerouten	NN	1	Banquerouten
reichlich	ADJD	1	reichlicher
ausschweifend	ADJA	1	ausschweifende
Kleinigkeit	NN	1	Kleinigkeit
Wolf	NN	1	Wolfe
belebt	ADJA	1	belebter
gottesvergessen	ADJD	1	gottesvergessen
Gram	NN	1	Grams
vereinigen	VVINF	1	vereinigen
Brief	NN	1	Briefe
gütig	ADJD	1	gütig
würdig	ADJD	1	würdig
dahinter	PAV	1	dahinter
einlaufen	VVPP	1	eingelaufen
Verschwiegenheit	NN	1	Verschwiegenheit
übermorgen	ADV	1	übermorgen
unterstehen	VVINF	1	unterstehen
Galimathias	NN	1	Galimathias
gegründet	ADJD	1	gegründeter
Falschheit	NN	1	Falschheit
Reizung	NN	1	Reizungen
verleumden	VVINF	1	verleumden
Rückkunft	NN	1	Rückkunft
weißen	VVFIN	1	weißt
erdulden	VVINF	1	erdulden
hegen	VVINF	1	hegen
scheinet	VVFIN	1	scheinet
jede	PIS	1	jeder
Zuwurf	NN	1	Zuwurf
grausam	ADJA	1	Grausamer
Summe	NN	1	Summe
fliehen	VVINF	1	fliehen
kützeln	VVFIN	1	kützeln
schänden	VVFIN	1	schänden
überzeugen	VVPP	1	überzeugt
Stolze	NN	1	Stolze
treffen	VVINF	1	treffen
ergeben	VVPP	1	ergeben
Glücksgüter	NN	1	Glücksgüter
verbergen	VVPP	1	verborgen
Verdienst	NN	1	Verdienst
gottlos	ADJA	1	gottlose
Darnach	ADV	1	Darnach
Beschäftigung	NN	1	Beschäftigung
widern	VVIMP	1	Wider
berede	VVFIN	1	berede
vorplaudern	VVINF	1	vorplaudern
Mühe	NN	1	Mühe
verlieben	VVPP	1	verliebt
wenigste	PIAT	1	wenigsten
häufig	ADJD	1	häufig
Ton	NN	1	Ton
drauf	PAV	1	drauf
Neugierigkeit	NN	1	Neugierigkeit
Tod	NN	1	Tode
Gleiche	NN	1	Gleiches
untereinander	ADV	1	untereinander
geschehen	VVPP	1	geschehen
Schwärmerei	NN	1	Schwärmereien
erkläret	ADJD	1	erkläret
Urteil	NN	1	Urteilen
streiten	VVFIN	1	streite
widerlegen	VVINF	1	widerlegen
bezeigen	VVFIN	1	bezeigte
zugehen	VVFIN	1	zuging
worüber	PWAV	1	worüber
trotzen	VVFIN	1	trotzt
würdigen	VVFIN	1	würdigen
inständig	ADJD	1	inständig
Jugend	NN	1	Jugend
taub	ADJD	1	taub
untreu	ADJD	1	untreu
bestreben	VVFIN	1	bestreben
Sage	NE	1	Sage
Angelegenheit	NN	1	Angelegenheiten
Rache	NN	1	Rache
Wesentliche	NN	1	Wesentlichen
laß	ADJD	1	laß
Gegenwart	NN	1	Gegenwart
Unterschied	NN	1	Unterschied
Worinne	NN	1	Worinne
wirklich	ADJD	1	wirklich
beitragen	VVINF	1	beitragen
anvertrauen	VVIZU	1	anzuvertrauen
Gasthof	NN	1	Gasthof
zwischen	APPR	1	Zwischen
Bezeigen	NN	1	Bezeigen
anbringen	VVPP	1	angebracht
stolz	ADJA	1	stolze
Gunst	NN	1	Gunst
satt	ADJD	1	satt
nachteilig	ADJA	1	nachteilige
verschwenderisch	ADJA	1	verschwenderische
ersetzen	VVINF	1	ersetzen
beruhen	VVFIN	1	beruht
rasend	ADJD	1	rasend
Fall	NN	1	Fall
ziemlich	ADV	1	ziemlich
Not	NN	1	Not
Verlassenschaft	NN	1	Verlassenschaft
jemals	ADV	1	jemals
standhaft	ADJA	1	standhafte
zufrieden	ADJD	1	zufrieden
zehnmal	ADV	1	zehnmal
Erklärung	NN	1	Erklärungen
schwärmst	VVFIN	1	schwärmst
Gasthofe	NN	1	Gasthofe
genau	ADJD	1	genau
Unkosten	NN	1	Unkosten
dumm	ADJA	1	dumme
verliebter	ADJD	1	verliebter
Vorwurf	NN	1	Vorwürfe
Gesellschaft	NN	1	Gesellschaft
Empfindlichkeit	NN	1	Empfindlichkeit
nachlässiger	ADJD	1	nachlässiger
vollends	ADV	1	vollends
Aufrichtigkeit	NN	1	Aufrichtigkeit
bestimmen	VVINF	1	bestimmen
gereuen	ADJD	1	gereuen
betrügen	VVINF	1	betrügen
zuschreiben	VVINF	1	zuschreiben
ausfündig	ADJD	1	ausfündig
horchen	VVFIN	1	horchen
erdichtet	ADJA	1	erdichtete
verachtungswürdiger	ADJA	1	verachtungswürdiger
schallen	VVFIN	1	schallen
Freierei	NN	1	Freierei
woran	PWAV	1	woran
Wertester	NN	1	Wertester
unersetzlich	ADJA	1	unersetzlichen
erwägen	VVFIN	1	erwägen
Ansehen	NN	1	Ansehen
wundern	VVPP	1	gewundert
Hase	NN	1	Hasen
tragen	VVINF	1	tragen
Verzeihungen	NN	1	Verzeihungen
närrisch	ADJA	1	närrischen
tauschen	VVINF	1	tauschen
löblich	ADJA	1	löbliche
falsch	ADJA	1	falsche
flüchtig	ADJD	1	flüchtig
morgen	ADV	1	morgen
seltsam	ADJD	1	seltsam
Schäfchen	NN	1	Schäfchen
gründen	VVPP	1	gegründet
tausend	CARD	1	tausend
spielen	VVFIN	1	spielte
Seite	NN	1	Seite
verblendenden	ADJA	1	verblendenden
ostindische	ADJA	1	ostindische
Lüge|Lügen	NN	1	Lügen
unzählig	ADJA	1	unzähligen
entzückt	ADJD	1	entzückt
Seits	NN	1	Seits
erlauben	VVFIN	1	Erlauben
tot	ADJD	1	tot
ablaufen	VVIZU	1	abzulaufen
Arm|Arme	NN	1	Armen
naseweis	ADJD	1	naseweis
Erleichterung	NN	1	Erleichterung
eifersüchtig	ADJD	1	eifersüchtig
genennet	NE	1	genennet
bekömmt	VVFIN	1	bekömmt
zugestehen	VVINF	1	zugestehen
erstaunet	VVFIN	1	erstaunet
Verräterei	NN	1	Verräterei
aufhören	VVPP	1	aufgehört
Galgenschwengeln	NN	1	Galgenschwengeln
Mühle	NN	1	Mühle
lachen	VVFIN	1	lacht
Verzeihen	NN	1	Verzeihen
vorwerfen	VVIZU	1	vorzuwerfen
tadeln	VVINF	1	tadeln
frei	ADJD	1	frei
schuldig	ADJD	1	schuldig
unerträglich	ADJD	1	unerträglich
geheim	ADJA	1	geheime
bißgen	NN	1	bißgen
Teil	NN	1	Teil
ungegründet	ADJD	1	ungegründet
zukommen	VVINF	1	zukommen
hinlänglich	ADJD	1	hinlänglich
Licht	NN	1	Licht
Geschicklichkeit	NN	1	Geschicklichkeit
hinderlich	ADJD	1	hinderlich
Abschied	NN	1	Abschied
hassen	VVINF	1	hassen
vermöge	APPR	1	vermöge
Versuch	NN	1	Versuch
fallen	VVFIN	1	falle
unnötig	ADJD	1	unnötig
Bund	NN	1	Bundes
bewaffnen	VVFIN	1	bewaffnet
einnehmen	VVPP	1	eingenommen
Statt	NN	1	Statt
wunderlich	ADJD	1	wunderlich
vorteilhaft	ADJA	1	vorteilhaftesten
dahin	PAV	1	dahin
vermögend	ADJD	1	vermögend
Dienerin	NN	1	Dienerin
befinden	VVFIN	1	befinde
wodurch	PWAV	1	wodurch
herkommen	VVPP	1	hergekommen
ewig	ADJD	1	ewig
ungetreu	ADJA	1	ungetreuer
verbieten	VVPP	1	verboten
Feuer	NN	1	Feuer
schlecht	ADJD	1	schlecht
bescheiden	VVPP	1	beschieden
Gegenliebe	NN	1	Gegenliebe
Rtlr	NN	1	Rtlr
nahe	PTKVZ	1	nahe
genießen	VVFIN	1	Genießen
Leute	NN	1	Leute
Gegengunst	NN	1	Gegengunst
umschreiben	VVINF	1	umschreiben
beschämen	VVPP	1	beschämt
kaltsinnig	ADJD	1	kaltsinnig
unüberwindlich	ADJA	1	unüberwindlichen
verpflichten	VVPP	1	verpflichtet
Eigennutz	NN	1	Eigennutz
traurig	ADJA	1	traurige
verblenden	VVPP	1	verblendet
Tauschen	NN	1	Tauschen
Wichtige	NN	1	Wichtige
Scherz	NN	1	Scherz
zaudern	VVFIN	1	zaudern
schamhaft	ADJD	1	schamhaft
entschuldigen	VVINF	1	entschuldigen
Gunstbezeigungen	NN	1	Gunstbezeigungen
betreffen	VVFIN	1	betrifft
vorhin	ADV	1	vorhin
Streich	NN	1	Streich
zwölf	CARD	1	zwölf
wundersam	ADJD	1	wundersam
genennt	VVFIN	1	genennt
anfangs	ADV	1	anfangs
seh	XY	1	seh
allein	ADV	1	Allein
Stand	NN	1	Stande
Empfindung	NN	1	Empfindungen
Schelmstück	NN	1	Schelmstück
dafür	PAV	1	dafür
unterdrücken	VVPP	1	unterdrückt
Vorwande	NN	1	Vorwande
Unrecht	NN	1	Unrecht
menschlich	ADJA	1	menschlichen
Mitleiden	NN	1	Mitleiden
gescheit	ADJD	1	gescheiter
Frauenzimmers	NN	1	Frauenzimmers
Wand	NN	1	Wände
Einfallen	NN	1	Einfallen
schuld	ADJD	1	schuld
Leibesbeschaffenheit	NN	1	Leibesbeschaffenheit
ausholen	VVINF	1	ausholen
Verbrechen	NN	1	Verbrechen
Sperling	NN	1	Sperlinge
Soldatenmode	NN	1	Soldatenmode
versehen	VVINF	1	versehen
ltzo	NN	1	ltzo
ausstehen	VVINF	1	ausstehen
Hab	NN	1	Hab
Schluss	NN	1	Schluß
verrichten	VVINF	1	verrichten
Glücklichsten	NN	1	Glücklichsten
immer	ADV	1	immer
frisch	ADJD	1	Frisch
güldne	ADJA	1	güldne
Einöde	NN	1	Einöde
verinteressiert	VVFIN	1	verinteressiert
erleichtern	VVINF	1	erleichtern
Königin	NN	1	Königin
seinige	PPOSAT	1	seinige
Bestreben	NN	1	Bestreben
merken	VVFIN	1	merke
erzürnet	NE	1	erzürnet
vergnügt	ADJD	1	vergnügt
Bauersfrau	NN	1	Bauersfrau
wert	ADJD	1	wert
gleichwo	ADV	1	gleichwo
Notwendigkeit	NN	1	Notwendigkeit
Waage	NN	1	Waage
Anhalten	NN	1	Anhalten
ungesund	ADJD	1	ungesund
Frauenzimmer	NN	1	Frauenzimmer
Knall	NN	1	Knall
Fuß	NN	1	Füßen
schüchtern	VVINF	1	schüchtern
Verziehn	VVFIN	1	Verziehn
befreien	VVINF	1	befreien
blindlings	ADV	1	blindlings
allerlieb	ADJA	1	allerliebster
Heirat|Heiraten	NN	1	Heiraten
beschimpfet	VVFIN	1	beschimpfet
herausfordern	VVINF	1	herausfordern
besonder	ADJA	1	besonderes
töricht	ADJA	1	törichten
fähig	ADJD	1	fähig
unvergeblich	ADJD	1	unvergeblich
Bettlerin	NN	1	Bettlerin
Angesicht	NN	1	Angesicht
fallen|fällen	VVFIN	1	fällt
Philosophin	NN	1	Philosophin
geschwind	ADJD	1	geschwind
Bosheit	NN	1	Bosheit
Entschlusse	NN	1	Entschlusse
verhasst	ADJD	1	verhaßt
uneigennützigsten	ADJA	1	uneigennützigsten
einigermaßen	ADV	1	einigermaßen
nützlich	ADJD	1	nützlich
Reue	NN	1	Reue
Kapital	NN	1	Kapital
Notlüge	NN	1	Notlügen
würfeln	VVINF	1	würfeln
Schale	NN	1	Schale
Anblick	NN	1	Anblick
bestehen	PTKVZ	1	bestehen
entweder	KON	1	Entweder
Träne|Tränen	NN	1	Tränen
gehässig	ADJD	1	gehässiger
meiste	PIS	1	meisten
wuchern	VVPP	1	gewuchert
Begierde	NN	1	Begierde
Unruhe	NN	1	Unruhe
Lob	NN	1	Lobe
verdammt	ADJA	1	verdammte
Jahr	NN	1	Jahre
besinnen	VVFIN	1	besinnen
kämpfen	VVINF	1	kämpfen
willen	APPO	1	willen
gedulden	VVINF	1	gedulden
Schwierigkeit	NN	1	Schwierigkeit
Nichte	NN	1	nichte
herbestellet	ADJD	1	herbestellet
Ganze	NN	1	Ganze
Schweig	NE	1	Schweig
zehn	CARD	1	zehn
entzückend	ADJA	1	entzückende
Kreatur	NN	1	Kreaturen
behüten	VVFIN	1	Behüte
albern	ADJD	1	albern
durchaus	ADV	1	durchaus
heraus	ADV	1	heraus
vielmal	ADV	1	vielmal
erhaben	ADJA	1	erhabenen
Tugend	NN	1	Tugend
selig	ADJD	1	selig
unschuldig	ADJD	1	unschuldig
Rechenschaft	NN	1	Rechenschaft
Rockknöpfe	NN	1	Rockknöpfe
verbunden	ADJD	1	verbunden
parat	ADJD	1	parat
fest	ADJD	1	fest
Floh	NN	1	Floh
hoch	ADJD	1	hoch
loben	VVINF	1	loben
fühlen	VVFIN	1	fühle
Vorurteil	NN	1	Vorurteil
bewahren	VVINF	1	bewahren
Fall|Fällen	NN	1	Fällen
Antrag	NN	1	Antrag
Treue	NN	1	Treue
Nachwelt	NN	1	Nachwelt
Heirat	NN	1	Heirat
lahm	ADJD	1	lahm
ein	PTKVZ	1	ein
Hoffnung	NN	1	Hoffnung
@card@	CARD	1	12000
nütze	ADV	1	nütze
Unwürdigern	NN	1	Unwürdigern
Arbeit	NN	1	Arbeit
aufbringen	VVINF	1	aufbringen
gewisseste	ADJA	1	gewisseste
ändern	VVPP	1	geändert
betrüben	VVFIN	1	betrübt
halt	ADV	1	Halt
sauer	ADJD	1	sauer
Reich|Reiche|Reichen	NN	1	Reichen
Mund	NN	1	Munde
Reichtume	NN	1	Reichtume
mächtig	ADJA	1	mächtiger
Haar	NN	1	Haar
hierinne	NN	1	hierinne
legen	VVFIN	1	Legen
verunglücket	VVFIN	1	verunglücket
geirret	ADJD	1	geirret
fällen	VVPP	1	gefällt
darbieten	VVINF	1	darbieten
erholen	VVINF	1	erholen
oft	ADV	1	oft
Vereinigung	NN	1	Vereinigung
Schwäche	NN	1	Schwäche
Kummer	NE	1	Kummer
verfluchen	VVPP	1	Verflucht
mengest	VVFIN	1	mengest
aussöhnen	VVIZU	1	auszusöhnen
Abend	NN	1	Abends
brechen	VVINF	1	brechen
Dienst	NN	1	Dienste
Vater	NN	1	Vater
trocknen	VVFIN	1	trockne
vorschlagen	VVINF	1	vorschlagen
Zufalle	NN	1	Zufalle
Glücklichste	NN	1	Glücklichste
gewinnen	VVINF	1	gewinnen
Geier	NN	1	Geier
voll	ADJD	1	Voll
Geschlecht	NN	1	Geschlechts
Kraft	NN	1	Kräften
gewollt	ADJD	1	gewollt
Erfahrung	NN	1	Erfahrung
Vorwand	NN	1	Vorwand
beunruhigen	VVINF	1	beunruhigen
Zärtliche	NN	1	Zärtliche
beunruhiget	VVFIN	1	beunruhiget
begegnen	VVPP	1	begegnet
geschickt	ADJD	1	geschickt
Kohle	NN	1	Kohlen
womit	PWAV	1	Womit
Damons	NN	1	Damons
schlimm	ADJD	1	schlimm
Vernunft	NN	1	Vernunft
vernehmen	VVPP	1	vernommen
Regel	NN	1	Regel
verdammen	VVINF	1	verdammen
Gleichgewicht	NN	1	Gleichgewichte
Ohr	NN	1	Ohre
uneinig	ADJD	1	uneinig
hinter	APPR	1	hinter
Zeuge	NN	1	Zeuge
getreuste	ADJA	1	getreuste
Beifall	NN	1	Beifall
seinetwegen	ADV	1	seinetwegen
begleiten	VVFIN	1	begleiten
vorgesucht	VVPP	1	vorgesucht
Mährgen	NN	1	Mährgen
Punkt	NN	1	Punkt
bemühen	VVINF	1	bemühen
Angst	NN	1	Angst
verziehen	VVINF	1	verziehen
erkundigen	VVINF	1	erkundigen
Sammelplatz	NN	1	Sammelplatz
zuvor	ADV	1	zuvor
vergeben	VVINF	1	vergeben
He	NE	1	He
führen	VVFIN	1	führt
Maus	NE	1	Maus
gesund	ADJA	1	gesunden
acht	CARD	1	acht
Gewinst	NN	1	Gewinst
weit	ADJD	1	weit
verachtungswert	ADJD	1	verachtungswert
lossprechen	VVINF	1	lossprechen
Itzo	NE	1	Itzo
artig	ADJA	1	artige
Bräutigam	NN	1	Bräutigam
nötig	ADJD	1	nötig
Grab	NN	1	Grab
geizig	ADJD	1	geizig
ausdrücklich	ADJD	1	ausdrücklich
neidisch	ADJD	1	neidisch
Antrage	NN	1	Antrage
vergnügen	VVFIN	1	vergnügt
erworbener	ADJA	1	erworbener
verderben	VVINF	1	verderben
nachsetzen	VVIZU	1	nachzusetzen
Feindschaft	NN	1	Feindschaft
Alsdenn	NE	1	Alsdenn
verursachen	VVINF	1	verursachen
Unwürdige	NN	1	Unwürdigen
abfinden	VVINF	1	abfinden
Hartnäckigkeit	NN	1	Hartnäckigkeit
verargen	VVINF	1	verargen
schätzen	VVFIN	1	schätzte
ausnehmende	ADJA	1	ausnehmende
unbillig	ADJD	1	unbillig
vorbringen	VVIZU	1	vorzubringen
beschließen	VVPP	1	beschlossen
Geheimnis	NN	1	Geheimnis
Zweck	NN	1	Zweck
ausschütten	VVINF	1	ausschütten
tändeln	VVINF	1	tändeln
zählen	VVFIN	1	zählt
Nötiges	NN	1	Nötiges
vorhalten	VVFIN	1	vorhalte
davor	PAV	1	davor
mitbringen	VVFIN	1	mitbringen
beschwerlich	ADJD	1	beschwerlich
leider	ADV	1	leider
nunmehr	ADV	1	nunmehr
fort	ADV	1	fort
Ansehung	NN	1	Ansehung
binden	VVINF	1	binden
Vertrauen	NN	1	Vertrauen
verkündigen	VVPP	1	verkündigt
seit	KOUS	1	Seit
sterben	VVFIN	1	sterbe
übereilet	ADJD	1	übereilet
Antwort	NN	1	Antwort
wär	VVFIN	1	wär
ungeschickt	ADJD	1	ungeschickt
Dienen	NN	1	Dienen
bestrebte	VVFIN	1	bestrebte
getröste	ADJD	1	getröste
treten	VVFIN	1	treten
Wucher	NN	1	Wucher
wohlgemachte	ADJA	1	wohlgemachte
gelangen	VVINF	1	gelangen
verführen	VVINF	1	verführen
Geiz	NN	1	Geiz
zanken	VVINF	1	zanken
Anbeter	NN	1	Anbeter
fallen|gefallen	VVPP	1	gefallen
pfui	ITJ	1	Pfui
Freundin	NN	1	Freundin
nah	ADJD	1	näher
unwahrscheinlich	ADJD	1	unwahrscheinlich
vorsagen	VVPP	1	vorgesagt
banquerout	NN	1	banquerout
betragen|betrügen	VVFIN	1	betrügen
eigentlich	ADV	1	eigentlich
aufopfern	VVIZU	1	aufzuopfern
Erstaunen	NN	1	Erstaunen
weichet	ADJD	1	weichet
gehöret	NN	1	gehöret
Verdrusse	NN	1	Verdrusse
unerschrocknen	ADJA	1	unerschrocknen
dran	PTKVZ	1	dran
müde	ADJD	1	müde
unschmackhaft	ADJD	1	unschmackhaft
ums	APPRART	1	ums
gerecht	ADJA	1	Gerechter
zugreifen	VVPP	1	zugegriffen
holen	VVFIN	1	holt
Schmerz	NN	1	Schmerz
Alsdann	NE	1	Alsdann
lernen	VVINF	1	lernen
