Title: Der Schatz
Number of all lemmas: 11596
Nummber of different lemmas: 1581

Lemma	POS	Frequency	Tokens
die	PDS, ART, PRELS, PRELAT	667	Das, dem, die, das, der, Die, des, den, Der, Den, Dem, deren, Des
ich	PPER, PRF	608	ich, mir, Ich, mich, Mir
sein	VAINF, VAFIN, PPOSAT, VAPP	483	sein, bin, wäre, wären, ist, sind, Seinen, war, sei, Sein, gewesen, Ist, Seinem, seiner, seine, Seine, seines, Bin, Sind, seinen, seinem, bist, waren, Sei, War, seid, Bist
Sie	PPER	300	Sie, Ihnen
eine	ART, PIS	256	ein, Ein, eine, einer, einem, Eine, einen, eines, Einem, Einen
er	PPER	249	Er, Ihn, er, ihm, ihn
nicht	PTKNEG	225	nicht, Nicht
haben	VAFIN, VAINF, VAPP	220	hat, haben, habe, Hat, hätte, hatten, Hätte, hast, hätten, Habe, hatte, Haben, gehabt, hättest
und	KON	214	und, Und
es	PPER	168	es, Es
zu	PTKZU, APPR, APPRART, PTKA, PTKVZ	160	zu, Zum, zum, zur, Zu
so	ADV	153	so, So
mein	PPOSAT	139	mein, meinen, meine, meiner, meinem, Mein, Meine
dass	KOUS	123	daß, Daß
was	PWS, PIS, PRELS	112	was, Was
wollen	VMFIN, VMINF	106	wollten, will, wollte, wollen, willst, Willst, Wollen, Will, wollt, Wollt, wolle
Herr	NN	105	Herr, Herrn
werden	VAFIN, VAPP, VAINF	102	wird, würden, werden, wurde, würde, worden, Würde, geworden, werde, Wirst, wirst
wenn	KOUS	96	Wenn, wenn
du	PPER, PRF	95	Du, du, dich, dir
ihr	PPER, PPOSAT, PRF	94	ihr, ihre, ihrer, ihres, Ihre, ihrem, ihren, Ihr, Ihrem, Ihrer, Ihren, Ihres, Euch
in	APPR, APPRART	92	in, im, In, Im, Ins, ins
sie	PPER	92	sie, ihnen, Ihr
können	VMFIN, VMINF	88	könnte, kann, können, Kann, Können, Könnte, könne, kannst, könnten, konnte
aber	KON, ADV	85	Aber, aber
doch	ADV, KON	84	doch, Doch
sollen	VMFIN	83	soll, sollten, sollte, sollen, Sollte, Soll, solle, solltest, sollt, sollst
von	APPR, APPRART	80	von, Von, vom
sich	PRF	80	sich, Sich
gut	ADJD, ADJA	73	gut, guten, gute, besser, beste, guter, Guten, besten, Gut, gutes, gutem, Guter
noch	ADV, KON	71	noch, Noch
ja	PTKANT, ADV	70	Ja, ja
auf	APPR, PTKVZ	68	auf, Auf
müssen	VMFIN, VMINF	67	muß, müßte, müssen, mußte, Müßte, Muß, mußt, müßten
wohl	ADV	66	wohl, Wohl
sagen	VVPP, VVFIN, VVINF, VVIMP	66	gesagt, sage, sagen, Sagen, sagt, Sagten, sagte, sagst, sag, Sagt
nun	ADV	65	Nun, nun
auch	ADV	64	auch, Auch
mit	PTKVZ, APPR	63	mit, Mit
wie	KOKOM, KOUS	62	wie, Wie
nur	ADV	61	nur, Nur
als	KOKOM, KOUS, KON	60	als, Als
alle	PIAT, PIS	60	alles, allen, alle, Alles, aller, allem, Alle
für	APPR	53	für, Für
Lelio	NE	52	Lelio
bei	APPR, APPRART	51	bei, beim, Bei
denn	ADV, KON	49	denn, Denn
an	PTKVZ, APPR, APZR, APPRART	49	An, an, am
wieder	ADV	45	wieder
sehen	VVINF, VVIMP, VVPP, VVFIN	44	sehen, sieh, gesehen, sieht, Sehen, sehe, sah, Siehst, siehst, sähe, Sieh
wissen	VVFIN, VVINF, VVPP	41	wissen, weiß, Wissen, wüßte, gewußt, wußte
man	PIS	40	man, Man
Haus	NN	40	Hause, Haus, Häuser
lassen	VVFIN, VVINF, VVPP, VVIMP	38	lasse, lassen, gelassen, laßt, Lassen, läßt, Laß
gehen	VVINF, VVFIN, VVIMP	38	gehen, gehe, ginge, Gehe, Geh, ging, geht, Geht, Gehen, geh
kommen	VVINF, VVFIN, VVIMP, VVPP	38	kommen, Kommen, käme, komme, kam, Komm, gekommen
machen	VVINF, VVFIN, VVPP	35	machen, macht, Machen, gemacht, Mache, machst
geben	VVINF, VVFIN, VVPP	34	geben, gibt, gebe, Gebe, gegeben, gäben, gab
tun	VVFIN, VVINF, VVPP	33	tu, tun, tut, getan, tat, Tun, taten, tust
Jahr	NN	33	Jahr, Jahre, Jahren
Philto	NN, NE, ADJD	33	Philto
ganz	ADJD, ADV, ADJA	33	ganz, ganze, ganzer, ganzen, ganzes, Ganz
eben	ADV	33	eben, Eben
Anselmo	NE	32	Anselmo
schon	ADV	32	schon, Schon
Sohn	NN	30	Sohn, Sohne
lieb	ADJD, ADJA, PTKVZ	30	lieb, lieber, Lieber, liebster, liebes, liebe, lieben
Taler	NN	30	Taler, Talern
Mann	NN	30	Manne, Mann, Männer, Mannes
alt	ADJD, ADJA	30	alt, alte, alter, alten, altem
gar	ADV	30	gar, Gar
Maskarill	NE, ADJD	30	Maskarill
Vater	NN	29	Vater, Vaters
Freund	NN, NE	29	Freund, Freunde, Freundes
da	ADV, KOUS, PTKVZ	28	da, Da
dies	PDAT	28	dieses, diesen, diese, dieser, diesem, Dieses, Diese
hier	ADV	26	hier, Hier
mehr	ADV, PIAT	25	mehr
nichts	PIAT, PIS	24	nichts, Nichts
sprechen	VVFIN, VVINF, VVPP	24	Spricht, sprechen, spreche, gesprochen, sprach, sprächen, sprichst, spricht
ohne	APPR, KOUI	24	ohne, Ohne
um	PTKVZ, KOUI, APPR	23	um, Um
keine	PIAT, PIS	23	keine, kein, keinen
Geld	NN	23	Geld, Gelde
gewiss	ADJD, ADJA	22	gewiß, gewissen, Gewiß, gewisse
selbst	ADV	22	selbst
wir	PPER, PRF	22	wir, uns
aus	APPR, PTKVZ	21	aus
hören	VVFIN, VVINF, VVIMP	21	höre, hören, hörte, hör, Hören, Höre, hört
viele	PIS, PIAT	21	viel, vieles, vielen
etwas	PIS, PIAT, ADV	21	etwas
dein	PPOSAT	21	deine, deinen, deiner, dein, deinem
Staleno	NE	21	Staleno
wer	PWS	21	wer, Wer, wen
jetzt	ADV	20	jetzt, Jetzt
heißen	VVFIN, VVINF	20	heißt, Heißt, heiße, heißen, hieße, hieß
oder	KON	20	oder, Oder
kennen	VVPP, VVFIN, VVINF, VVIMP	20	gekannt, kennt, kennen, kennte, kenne, Kennen, kenn, Kennst
recht	ADJD, ADJA	20	recht, rechter, Recht
Leute	NN	19	Leuten, Leute
genug	ADV	19	genug
tausend	CARD	19	tausend
sehr	ADV	19	sehr
wo	PWAV	18	wo, Wo
nehmen	VVFIN, VVINF, VVPP, VVIMP	18	Nehmen, nehme, nähme, nehmen, genommen, nahm, nimmt, nimm, nehmt
welche	PRELS, PWAT	17	welchen, welches, welchem, Welche, welcher, welche
Name	NN	17	Namen, Name
O	NN	17	O
vor	APPR, PTKVZ	16	vor, Vor
gleich	ADJD	16	gleich
groß	ADJA, ADJD	15	größte, großes, größten, Große, groß, großer, größer
Schwester	NN	14	Schwester
Mädchen	NN	14	Mädchen
Wort	NN	14	Wort, Worte
viel	ADV	14	viel
wahr	ADJD, ADJA	14	wahr, wahre
denken	VVINF, VVFIN	14	denken, denke, dachten, dächte, Denkst
je	ADV	14	je, Je
ob	KOUS	14	ob
Leander	NE	14	Leander
Anselmus	NE	14	Anselmus
Mündel	NN	14	Mündel, Mündels
Vormund	NN	14	Vormund, Vormünder, Vormunds
glauben	VVFIN, VVINF, VVPP	14	glaube, glaubte, glauben, geglaubt, glaubt
gegen	APPR	13	gegen
finden	VVFIN, VVINF	13	fände, finden, findet, fand
bringen	VVFIN, VVPP	13	bringt, gebracht, bringen, Bringe, bringe
kriegen	VVFIN, VVINF	13	kriegt, kriege, kriegten, kriegen
also	ADV	13	also
wohnen	VVFIN, VVINF, VVPP	13	wohnt, wohnen, gewohnt
Aussteuer	NN	13	Aussteuer
Raps	NN	13	Raps
erst	ADJA, ADV	12	ersten, erst, erste
leihen	VVINF, VVFIN, VVPP	12	leihen, leihe, Leihe, geliehen
ehrlich	ADJA, ADJD	12	ehrliche, ehrlicher, ehrlichen, ehrlich
meinen	VVFIN	12	Meine, Meinen, meinen, meinte, meinten, meine, meinst
über	APPR	12	über
wenige	PIS, PIAT	12	wenig, Wenig, wenigen, weniger
durch	APPR	12	durch
warum	PWAV	12	warum, Warum
mögen	VMFIN	12	mögen, mag, möchte, Mögen, möchten
Brief	NN	12	Briefe
Interesse	NN	12	Interessen
niemand	PIS	11	niemanden, niemand, Niemand
Tochter	NN	11	Tochter
klein	ADJD, ADJA	11	klein, kleine, kleiner, kleinen, kleinste
andere	PIS, PIAT	11	andrer, andern, andere, andre
vielleicht	ADV	11	Vielleicht, vielleicht
Hand	NN	11	Hände, Hand, Händen
ach	ITJ	11	Ach
einmal	ADV	11	einmal
nach	APPR, PTKVZ	11	Nach, nach
nennen	VVFIN, VVINF	11	nennt, nennen, Nenne, Nennen, nenne
arm	ADJD, ADJA	11	arm, armen, armes, arme, armer
Betrieger	NN	11	Betrieger
halten	VVFIN, VVPP, VVINF	11	halte, gehalten, halten, Halten, Halte
Koffer	NN	11	Koffer
weg	ADV, PTKVZ	11	weg
Seite	NN	10	Seite, Seiten
verdienen	VVINF, VVFIN, VVPP	10	verdienen, verdient
ei	NE, FM	10	Ei, ei
fragen	VVFIN, VVINF	10	frage, fragen, fragten, fragte, fragt
ab	PTKVZ	10	ab
bekommen	VVINF, VVPP	10	bekommen
reden	VVINF, VVFIN	10	reden, Reden, redet
Kind	NN	10	Kinder, Kindern, Kind
zwar	ADV	10	zwar, Zwar
damit	KOUS, PAV	10	damit
verkaufen	VVPP, VVINF	10	verkauft, verkaufen
bald	ADV	10	bald, Bald
bezahlen	VVPP, VVINF	9	bezahlt, bezahlen, Bezahlt
lüderlichen	ADJA	9	lüderlichen
dürfen	VMFIN	9	darf, dürfte, Darf
unter	APPR	9	unter, Unter
lange	ADV	9	lange
sechs	CARD	9	sechs, sechse
geschwind	ADJD, ADJA	9	geschwind, Geschwind, geschwinden
sonst	ADV	9	sonst, Sonst
kömmt	VVFIN, ADJD	9	kömmt
bleiben	VVFIN, VVINF	9	bliebe, bleiben, bleibt
wenigstens	ADV	9	Wenigstens, wenigstens
stehen	VVFIN, VVINF, VVIMP	9	stünde, stehen, steht, Steh
leben	VVINF, VVFIN	9	leben, Leben, lebt
jung	ADJD, ADJA	9	jung, junge, jungen
wirklich	ADJD	8	wirklich
Unglück	NN	8	Unglück, Unglücke
Sache	NN	8	Sache
erfahren	VVPP, VVFIN, VVINF	8	erfahren, erfuhr, erfährt, erfahre
kaufen	VVINF, VVPP, VVFIN	8	kaufen, gekauft
Gott	NN	8	Gott
weit	ADJD	8	weit
einige	PIAT, PIS	8	einige, einigen, einiges
schön	ADJD, ADJA	8	schön, schönste, schöne, schönes, schöner
Frau	NN	8	Frau
Auge	NN	8	Augen, Auge
freilich	ADV	8	freilich, Freilich
Nachricht	NN	8	Nachricht, Nachrichten
neun	CARD	7	neun, Neun
Person	NN	7	Person, Personen
bitten	VVFIN	7	bitte
Schuld	NN	7	Schuld, Schulden
Zeit	NN	7	Zeit
Tag	NN	7	Tag, Tage, Tagen
wegen	APPR, APPO	7	wegen
Kerl	NN	7	Kerl, Kerls
kurz	ADJD, ADJA	7	Kurz, kurze, kurz, kurzem
richtig	ADJD	7	richtig, richtiger
fünf	CARD	7	fünf, Fünf
weil	KOUS	7	weil
funfzig	NN, CARD	7	funfzig
darauf	PAV	7	darauf
beide	PIS	7	beides, beide
lang	ADJD, ADJA	7	länger, lange, langen
letzt	ADJA	7	letzter, letzten, letzte
reich	ADJA, ADJD	7	reichsten, reich, reiche, reichen, reichste
jemand	PIS	7	jemand, jemanden
setzen	VVINF, VVPP, VVFIN	7	setzen, gesetzt, setze, Setzt, setzte
Welt	NN	7	Welt
davon	PTKVZ, PAV	7	davon
vortrefflich	ADJA, ADJD	7	vortrefflicher, vortrefflich, vortrefflichen
allein	ADV	7	allein, Allein
wahrhaftig	ADJD	6	Wahrhaftig, wahrhaftig
Barschaft	NN	6	Barschaft
neu	ADJA	6	neuen, neue
vierzig	CARD	6	vierzig
Herz	NN	6	Herz, Herzens, Herzen
Streich	NN	6	Streiche, Streich
anders	ADV	6	anders
bis	KOUS, KON	6	bis, Bis
Ha	NE	6	Ha
zählen	VVPP, VVINF, VVFIN	6	gezählt, zählen, zählt
gehören	VVFIN	6	gehört, gehören
selber	ADV	6	selber
immer	ADV	6	immer
einzig	ADJA, ADJD	6	einzige, einzigen, einzig, einziger
zwanzig	CARD	6	zwanzig
dabei	PAV	6	dabei
Vorsprecher	NN	6	Vorsprecher
alsdann	VVFIN, ADJD, VVIMP	6	alsdann
nein	PTKANT	6	Nein, nein
endlich	ADV	6	endlich, Endlich
sechstausend	CARD	6	sechstausend, Sechstausend
Jungfer	NN	6	Jungfer
heute	ADV	6	heute
indem	KOUS	6	Indem
gern	ADV	6	gern
übrig	ADJD, ADJA	6	übrig, übrige, übriges
Ernst	NN, NE	6	Ernst
etwa	ADV	6	etwa
Kopf	NN	6	Kopfe, Kopf
Mensch	NN	6	Menschen, Mensch
drei	CARD	5	drei
Frage	NN	5	Frage
Ware	NN	5	Waren
brauchen	VVFIN, VVINF	5	brauchte, brauche, brauchen
Fuß	NN	5	Fuße, Füßen
diese	PDS	5	diese, Dieses, dieser, dieses
Geschlecht	NN	5	Geschlechts, Geschlechte, Geschlechter, Geschlecht
Zweifel	NN	5	Zweifel
nie	ADV	5	nie, Nie
unglücklich	ADJD, ADJA	5	unglücklich, unglücklicher
stoßen	VVINF, VVFIN	5	stoßen, stößt
Art	NN	5	Art
funfzehn	CARD	5	funfzehn
lieben	VVINF, VVFIN, VVPP	5	lieben, liebe, geliebt
fort	PTKVZ, ADV	5	fort, Fort
sieben	CARD	5	sieben
Degen	NE, NN	5	Degen
betrügen	VVPP	5	betrogen
darinne	NN, VVFIN	5	darinne
unterdessen	ADV	5	unterdessen, Unterdessen
ansehen	VVFIN, VVINF, VVIZU	5	ansieht, ansehen, anzusehen
sauer	ADJD, ADJA	5	sauer, saure
möglich	ADJA, ADJD	5	möglichstes, mögliche, möglich
übel	ADJD	5	übel
sondern	KON	5	sondern
Henker	NN	5	Henker
fallen	VVINF, VVFIN	5	fallen, fiel
Dienst	NN	5	Dienst, Diensten, Dienste
sitzen	VVINF, VVFIN	5	sitzen, sitze
Gesicht	NN	5	Gesicht, Gesichte
Himmel	NN	5	Himmel
Vorwerk	NN	5	Vorwerk
zehn	CARD	5	zehn
Kaufmann	NN, NE	5	Kaufmann
suchen	VVFIN, VVINF	5	suchte, suchen, suche
besinnen	VVFIN, VVINF	5	besinne, besinnt, besinnen, Besinnen
Stadt	NN	5	Stadt
Kamilla	NE	5	Kamilla
seit	APPR	5	seit
laß	ADJD	4	laß
Fisch	NN	4	Fische
Pate	NN	4	Pate
frei	ADJA, ADJD	4	freiem, frei
Rips	NN	4	Rips
laufen	VVFIN	4	läuft, lief
verraten	VVFIN, VVPP	4	verrät, verraten, verrate
anfangen	VVIZU, VVINF, VVFIN	4	anzufangen, anfangen, anfängt
schämen	VVFIN, VVINF	4	schämt, schämen
fangen	VVFIN, VVINF	4	fangen, fange, fängt
stecken	VVINF, VVFIN	4	stecken, steckt, steckte
halb	ADJA, ADJD	4	halben, halb, halbe
Prozent	NN	4	Prozent
Lohn	NN	4	Lohn
Teich	NN	4	Teiche
solche	PIAT	4	solchen, solche
großmütig	ADJD, ADJA	4	großmütig, großmütige
merken	VVINF, VVPP, VVFIN	4	merken, gemerkt, merke
herum	ADV, PTKVZ	4	herum
ein	PTKVZ	4	ein
aussehen	VVPP, VVIZU, VVFIN	4	ausgesehen, auszusehen, aussieht
Trinkgeld	NN	4	Trinkgeld
bloß	ADJA, ADJD	4	bloßen, bloß
Teufel	NN	4	Teufel
Gewissen	NN	4	Gewissen
mirs	ADJD	4	mirs
närrisch	ADJD, ADJA	4	närrisch, närrische, Närrisch
Rat	NN	4	Rat
Busch	NN	4	Busch, Busche
vollkommen	ADJA, ADJD	4	vollkommenen, vollkommene, vollkommen
Vorwerke	NN	4	Vorwerke
Ding	NN	4	Dingen, Ding, Dinge
schaffen	VVINF, VVPP	4	schaffen, geschafft
fast	ADV	4	fast
geschehen	VVFIN, VVPP	4	geschieht, geschehen, geschähe
lügen	VVFIN, VVINF, VVPP	4	lügst, lüge, lügen, gelogen
tausendmal	ADV	4	tausendmal
Bruder	NN	4	Bruder, Brüder
Kamillen	NN, VVINF, VVFIN	4	Kamillen
danken	VVFIN, VVPP	4	danke, gedankt
eher	ADV	4	eher, Eher
Teil	NN	4	Teils, Teile, Teil
weisen	VVPP, VVFIN, VVINF	4	gewiesen, weise, weisen
zurück	PTKVZ, ADV	4	zurück
neugierig	ADJD, ADJA	4	neugierig, neugierigen
Gallipoli	NE	4	Gallipoli
Herzensfreund	NN	4	Herzensfreund
mitkriegen	VVFIN, VVINF	4	mitkriegt, mitkriegen
ziehen	VVFIN, VVINF, VVPP	4	zog, ziehen, gezogen
verschließen	VVPP	4	verschlossen, Verschlossen
wünschen	VVINF	4	wünschen
Jugend	NN	4	Jugend
ha	NE	4	ha
dazu	PAV	3	dazu
jemals	ADV	3	jemals
pflegen	VVINF, VVFIN	3	pflegen, pflegte
Gasse	NN	3	Gasse
Zeug	NN	3	Zeug
nichtswürdig	ADJA	3	nichtswürdige, nichtswürdigen
sicher	ADJD	3	sichrer, sicher
hundert	CARD	3	hundert
antreffen	VVINF, VVIZU	3	antreffen, anzutreffen
Augenblick	NN	3	Augenblick
Wille	NN	3	Willen
wahrscheinlich	ADJD	3	wahrscheinlich
ansehnlich	ADJA, ADJD	3	ansehnliche, ansehnlich
Lelane	NE, NN	3	Lelane
daher	PAV	3	daher
rufen	VVINF, VVFIN	3	rufen, rief
wider	APPR	3	wider
Aufsicht	NN	3	Aufsicht
Erlaubnis	NN	3	Erlaubnis
wenig	ADV	3	wenig, Wenig
legen	VVFIN, VVINF	3	legen
jetzo	ADJD	3	jetzo
Beweis	NN	3	Beweis, Beweise
Tugend	NN	3	Tugend
Asinus	NE, NN	3	Asinus
Bißchen	NN	3	Bißchen
leer	ADJD	3	leer
nu	ITJ	3	Nu, nu
verstehen	VVFIN, VVIMP	3	versteht, versteh
fehlen	VVFIN, VVPP	3	fehlt, Gefehlt, gefehlt
Vermögen	NN	3	Vermögen, Vermögens
Unrecht	NN	3	Unrecht, Unrechtes
Dieb	NN	3	Diebe, Dieb
bekümmern	VVPP, VVINF	3	bekümmert, bekümmern
Nachschuß	NN	3	Nachschuß
umarmen	VVINF, VVFIN	3	umarmen
Wirtschaft	NN	3	Wirtschaft
Stiletti	NN	3	Stiletti
schuldig	ADJD	3	schuldig
behalten	VVINF, VVFIN	3	behalten, behielte
schlecht	ADJA, ADJD	3	schlechten, schlecht
anvertrauen	VVFIN, VVINF	3	anvertraute, anvertrauen
wert	ADJD	3	wert
sonderbar	ADJD, ADJA	3	Sonderbar, sonderbar, sonderbarer
König	NN	3	Königen, Könige
Dardanellen	NN	3	Dardanellen
fallen|fällen	VVFIN	3	fällt
aufsuchen	VVIZU, VVINF, VVFIN	3	aufzusuchen, aufsuchen, aufsuche
verzeihen	VVFIN, VVIMP	3	verzeihen, Verzeih, Verzeihen
Spitzbube	NN	3	Spitzbuben, Spitzbube
fein	ADJD	3	fein
Arm|Arme	NN	3	Arme
am	PTKA	3	Am, am
sobald	KOUS	3	Sobald, sobald
gleichwohl	KOUS, ADV	3	gleichwohl
Spiel	NN	3	Spiele
wohin	PWAV	3	Wohin, wohin
verzweifelt	ADJD, ADJA	3	verzweifelt, verzweifelter
Tod	NN	3	Tode, Todes
darum	PAV	3	darum
Recht	NN	3	Recht
Fall	NN	3	Fälle, Fall, Falls
Vorschlag	NN	3	Vorschlag, Vorschlage
Leandern	VVINF, NE	3	Leandern
nimmermehr	ADV	3	nimmermehr
Schatz	NN	3	Schatz
Haar	NN	3	Haar, Haare
Umstand	NN	3	Umstände, Umständen
Bediente	NN	3	Bedienten, Bedienter
meinig	PPOSS	3	Meinigen, meinigen
versuchen	VVINF	3	versuchen
hin	ADV	3	hin
Straße	NN	3	Straße
allerlieb	ADJA	3	allerliebstes, allerliebster
seh	NE	3	seh
klug	ADJD	3	klug
Dank	NN	3	Dank
Freundschaft	NN	3	Freundschaft
scheinen	VVINF, VVFIN	3	scheinen, scheint
meinetwegen	ADV	3	meinetwegen
leicht	ADJD	3	leicht
mitgeben	VVPP	3	mitgegeben
wiederkommen	VVINF, VVPP	3	wiederkommen, wiedergekommen
Leben	NN	3	Lebens, Leben
Ort	NN	3	Ort, Orte
willkommen	ADJD	3	willkommen, Willkommen
nötig	ADJD, ADJA	3	nötig, nötige
dreißig	CARD	3	dreißig
Hut	NN	3	Hut
hoch	ADJA, ADJD	3	höchsten, hoch, höher
warten	VVINF, VVFIN	3	warten, Warte
liegen	VVPP, VVINF, VVFIN	3	gelegen, liegen, liegt
rund	ADJA, ADV	3	rundes, rund
kaum	ADV	3	kaum
heraus	ADV, PTKVZ	3	heraus
Ewigkeit	NN	3	Ewigkeit
Ausschweifung	NN	3	Ausschweifungen, Ausschweifung
ists	VVFIN, ADJD	3	ists
begehen	VVPP, VVINF	3	begangen, begehen
zeigen	VVINF, VVFIN	3	zeigen, zeigte
vier	CARD	3	vier
fremd	ADJA, ADJD	3	fremde, fremd
Liebe	NN	3	Liebe
freudig	ADJD	3	freudig
Gelegenheit	NN	3	Gelegenheit
Kamille	NN	3	Kamille
gerne	ADV	3	gerne
daran	PAV	3	daran
melden	VVFIN, VVINF	3	meldet, melden
zweifeln	VVFIN	3	zweifelst, zweifeln, zweifle
vergessen	VVPP	2	vergessen
gerade	ADV, ADJA	2	gerade, gerades
träumen	VVPP	2	geträumt
Handelsmann	NN	2	Handelsmann
Korne	NN	2	Korne
toll	ADJD	2	toll
annehmen	VVINF	2	annehmen
dort	ADV	2	dort
überzeugen	VVPP	2	überzeugt
vorher	ADV	2	vorher
Mangel	NN	2	Mangel
wenigsten	ADV	2	wenigsten
er|es	PPER	2	Ihm
spät	ADJD	2	spät
springen	VVFIN	2	sprang
wann	PWAV	2	wann, Wann
kehren	VVFIN, VVPP	2	kehre, gekehrt
vorig	ADJA	2	vorigen, voriges
versprechen	VVFIN, VVPP	2	versprach, versprochen
wegkommen	VVINF	2	wegkommen
außerordentlich	ADJD	2	außerordentlich
Antwort	NN	2	Antwort
klingen	VVFIN	2	klingt
weniger	ADV	2	weniger
sahe	VVFIN	2	sahe
dahin	PAV	2	dahin
Ernste	NE, NN	2	Ernste
Gedanke	NN	2	Gedanken
Rohr	NN	2	Rohr
kaltsinnig	ADJD	2	kaltsinnig
entschuldigen	VVFIN, VVINF	2	entschuldigen
angenehm	ADJA, ADJD	2	angenehmsten, angenehm
Gewalt	NN	2	Gewalt
singen	VVFIN, VVINF	2	singt, singen
Neubegierde	NN	2	Neubegierde
Ausstattung	NN	2	Ausstattung
jede	PIAT	2	jeden, jedes
sacht	ADJD	2	sachter
Schwein	NN	2	Schwein, Schweine
fest	ADJA, ADJD	2	feste, fest
Hälfte	NN	2	Hälfte
Zehne	NN	2	Zehne
verzeihen|verziehen	VVFIN	2	Verziehen
Gesundheit	NN	2	Gesundheit
dankbar	ADJD	2	dankbar
schwarz	ADJA	2	schwarzen, schwarze
Ton	NN	2	Tone
Arm	NN	2	Arm
Wechsel	NN	2	Wechsel
o	ADJA, ADJD	2	o
denken|gedenken	VVPP	2	gedacht
Arnolph	NE	2	Arnolph
woran	PWAV	2	woran
fern	ADJD, ADJA	2	ferner, fernere
Topp	NN	2	Topp
Ende	NN	2	Ende
Partie	NN	2	Partie
Hund	NN	2	Hund, Hunde
zurechte	NN	2	zurechte
ergehen	VVINF	2	ergehen
Punkt	NN	2	Punkt
namens	APPR	2	Namens
schwerlich	ADJD	2	schwerlich, Schwerlich
Tat	NN	2	Tat
Pandolfo	NN	2	Pandolfo
Summe	NN	2	Summe
Absicht	NN	2	Absicht
Pest	NN	2	Pest
verbergen	VVPP	2	verborgen
verlieben	VVPP, VVINF	2	verliebt, verlieben
glücklich	ADJA	2	glücklicher, glückliche
hoffen	VVFIN	2	hoffe
Bouteille	NN	2	Bouteille
böse	ADJA, ADJD	2	böse
Ehrenschuld	NN	2	Ehrenschulden
Kränzchen	NN	2	Kränzchen
Torheit	NN	2	Torheit
Beutel	NN	2	Beutel
spielen	VVINF	2	spielen
bekömmt	ADJD, VVFIN	2	bekömmt
Verräter	NN	2	Verräter
List	NN	2	List
völlig	ADJA	2	völliger
Münze	NN	2	Münze
Prophezeiung	NN	2	Prophezeiung
Schrecken	NN	2	Schrecken
vertrauen	VVFIN, VVINF	2	vertraue, vertrauen
antworten	VVFIN, VVINF	2	Antworte, antworten
ohnfehlbar	ADJD	2	ohnfehlbar
Geduld	NN	2	Geduld
lernen	VVPP, VVINF	2	gelernt, lernen
wunderbar	ADJD, ADJA	2	wunderbar, wunderbarer
führen	VVFIN, VVINF	2	führte, führen
Weg	NN	2	Weg, Weges
bereits	ADV	2	bereits
garstig	ADJA	2	garstiger, garstigen
Fenster	NN	2	Fenstern, Fenster
hinterlassen	VVFIN, VVINF	2	hinterließ, hinterlassen
verachten	VVINF, VVPP	2	verachten, verachtet
väterlich	ADJA	2	väterlichen, väterliches
Boden	NN	2	Boden
freundschaftlich	ADJD	2	freundschaftlich
entweder	KON	2	entweder
verdammt	ADJA	2	verdammter
Güte	NN	2	Güte
tragen	VVINF	2	tragen
Paphlagonien	NN	2	Paphlagonien
hernach	ADV	2	hernach
zugleich	ADV	2	zugleich
eigennützig	ADJA	2	eigennützige, eigennützigen
sinnen	VVFIN	2	Sinnen
schießen	VVINF	2	schießen
Fremde	NN	2	Fremde
vergelten	VVINF, VVPP	2	vergelten, vergolten
schicken	VVFIN, VVINF	2	schicke, schicken
vergeben	VVINF	2	vergeben
gesprächig	ADJD	2	gesprächig
Rap	NN	2	Rap
jagen	VVFIN	2	jage, jagen
Neigung	NN	2	Neigung
stark	ADJA, ADJD	2	stärksten, stark
rechnen	VVINF	2	rechnen
ah	ITJ	2	ah, Ah
pfui	ITJ	2	Pfui, pfui
Ehre	NN	2	Ehre
Mühe	NN	2	Mühe
leihest	ADJD, VVFIN	2	leihest
Exempel	NN	2	Exempel
gibts	VVFIN, NN	2	gibts
Stille	NN	2	Stille
hinein	ADV	2	hinein
laut	ADJD	2	lauter
immerhin	ADV	2	immerhin
leichtsinnig	ADJA, ADJD	2	leichtsinnige, leichtsinnig
hervor	PTKVZ	2	hervor
zweimal	ADV	2	zweimal
verleumden	VVINF	2	verleumden
hinaus	ADV, PTKVZ	2	hinaus
leid	ADJD	2	leid
besitzen	VVFIN	2	besitze, besitzen
Viehsterben	NN	2	Viehsterben
Ei	NN	2	Ei
verlieren	VVINF, VVPP	2	verlieren, verloren
herab	PTKVZ	2	herab
Küste	NN	2	Küste
vorbei	ADV	2	vorbei
Schlingel	NN	2	Schlingel
Erde	NN	2	Erde
vollends	ADV	2	vollends
heiraten	VVINF	2	heiraten
gleichsam	ADJD	2	gleichsam
Ers	NE	2	Ers
Verleumdung	NN	2	Verleumdungen
Kürzesten	NN	2	Kürzesten
ersparen	VVINF	2	ersparen
Verkaufen	NN	2	Verkaufen
bedenken	VVFIN	2	Bedenke, bedenke
Vergebung	NN	2	Vergebung
vertun	VVINF, VVPP	2	vertun, vertan
tragisch	ADJA, ADJD	2	tragische, Tragisch
kostbar	ADJA	2	kostbare
Anstecken	NN	2	Anstecken
Freude	NN	2	Freude
Großmut	NN	2	Großmut
fähig	ADJD	2	fähig
engen	VVFIN	2	enge
Katze	NN	2	Katze
Bettlerin	NN	2	Bettlerin
zusammen	ADV	2	zusammen
stürzen	VVFIN	2	stürzte
unschuldig	ADJD	2	unschuldig
fließen	VVPP, VVFIN	2	geflossen, floß
gehören|hören	VVPP	2	gehört
verlassen	VVFIN, VVPP	2	verließ, verlassen
reisen	VVFIN, VVINF	2	reise, reisen
allenfalls	ADV	2	Allenfalls, allenfalls
vermuten	VVINF, VVFIN	2	vermuten, vermutete
Blutigel	NN	2	Blutigel
Alte	NN	2	Alte, Alten
beschwören	VVFIN	2	beschwöre
Zufall	NN	2	Zufall
Finger	NN	2	Fingern
Wunder	NN	2	Wunder
Herd|Herde	NN	2	Herde
dafür	PAV	2	dafür
geizig	ADJA	2	geiziger, geizigen
daraus	PAV	2	daraus
Geheimnis	NN	2	Geheimnis
Häuschen	NN	2	Häuschen
helfen	VVINF	2	helfen
Ansehung	NN	2	Ansehung
Ansel	NE	2	Ansel
fallen|gefallen	VVPP	2	gefallen
Schurke	NN	2	Schurke
Zug	NN	2	Zügen
Abwesenheit	NN	2	Abwesenheit
holen	VVINF, VVFIN	2	holen, holte
taugen	VVFIN	2	taugt
vollwichtigen	ADJA	2	vollwichtigen
früh	ADJD	2	früh
Blitz	NN	2	Blitz
gütig	ADJD, ADJA	2	gütiger, gütigen
abgeben	VVIZU, VVPP	2	abzugeben, abgegeben
voll	ADJA, ADJD	2	volles, voll
Land	NN	2	Lande
Ja	NN	2	Ja
zwischen	APPR	2	zwischen
ziemlich	ADV	2	ziemlich
rechtschaffnen	ADJA	2	rechtschaffnen
paar	PIAT	2	Paar
worin	PWAV	2	worin
@card@	CARD	2	175
Reisende	NN	2	Reisender, Reisenden
morgen	ADV	2	morgen
seltsam	ADJA, ADJD	2	seltsame, seltsam
fahren|führen	VVFIN	2	führe
Anfang	NN	2	Anfang, Anfangs
wovon	PWAV	2	wovon
Narr	NN	2	Narren, Narr
Warnung	NN	2	Warnung, Warnungen
Vorwurf	NN	2	Vorwürfe, Vorwurf
Dukaten	NN	2	Dukaten
einbilden	VVINF	2	einbilden
Anton	NE	2	Anton
ichs	ADJD	2	ichs
zärtlich	ADJA, ADJD	2	zärtliches, zärtlich
aushalten	VVPP, VVINF	2	ausgehalten, aushalten
Glück	NN	2	Glück
Sonne	NN	2	Sonne
Schmeichelei	NN	2	Schmeichelei, Schmeicheleien
Kauf	NN	2	Kaufs, Kaufe
reif	ADJD	2	reif
gram	ADJD	2	gram
Heller	NN	2	Heller
bezaubern	VVPP, VVFIN	2	bezaubert
verhindern	VVINF, VVPP	2	verhindern, verhindert
Rolle	NN	2	Rolle
sogleich	ADV	2	sogleich
Wahrheit	NN	2	Wahrheit
ändern	VVINF	2	ändern
Eckhause	NN	2	Eckhause
allzuviel	PIS	2	Allzuviel, allzuviel
oft	ADV	2	oft
worauf	PWAV	2	worauf, Worauf
belaufen	VVFIN, VVPP	2	beläuft, belaufen
Ohr	NN	2	Ohren
Nichte	NN	2	Nichten
Rabe	NN	2	Rabe
Wenige	ADJA	2	Wenige
wetten	VVFIN	2	wetten, wette
dahinter	PAV	2	Dahinter, dahinter
ander	ADJA, ADV	2	ander
eins	CARD	2	eins
erkennen	VVINF	2	erkennen
fürs	APPRART	2	fürs
hastig	ADJD	2	hastig
treten	VVFIN, VVINF	2	Tritt, treten
natürlich	ADV, ADJA	2	natürlich, natürlichen
wegreisete	VVFIN	2	wegreisete
Alsdann	NE, ADJD	2	Alsdann
Respekt	NN	1	Respekt
hats	NN	1	hats
betteln	VVINF	1	betteln
gesteh	VVFIN	1	gesteh
nieder	PTKVZ	1	nieder
Zweifler	NN	1	Zweifler
Sprache	NN	1	Sprache
gänzlich	ADJA	1	gänzlichen
voraus	PTKVZ	1	voraus
rücklings	ADV	1	rücklings
Schönheit	NN	1	Schönheit
Tausend	NN	1	Tausenden
staubigten	ADJA	1	staubigten
abliegen	VVPP	1	abgelegen
recht|rechts	ADJA	1	rechte
fürchterlich	ADJA	1	fürchterlichen
Menschenverstand	NN	1	Menschenverstand
Ende|Enden	NN	1	Enden
gucken	VVFIN	1	Guckt
deutsch	NN	1	Deutsch
Messer	NN	1	Messer
Anstößige	NN	1	Anstößiges
Miene	NN	1	Miene
klügrer	ADJA	1	klügrer
Wasser	NN	1	Wasser
Eingeschlagen	NN	1	Eingeschlagen
ungefähr	ADJD	1	ungefähr
übermäßig	ADJA	1	übermäßige
gottlos	ADJA	1	gottloser
Andre	NE	1	Andre
allzeit	ADV	1	allzeit
gesinnt	ADJD	1	gesinnt
Taschenspieler	NN	1	Taschenspieler
erfreuen	VVFIN	1	erfreut
reichen	VVFIN	1	reicht
Gefälligkeit	NN	1	Gefälligkeit
drauf	PAV	1	drauf
Acht	NN	1	Acht
ausfallen	VVPP	1	ausgefallen
obenhin	ADV	1	obenhin
niederträchtig	ADJD	1	niederträchtig
Gemeinschaft	NN	1	Gemeinschaft
Aufopferung	NN	1	Aufopferung
zuwider	PTKVZ	1	zuwider
Text	NN	1	Text
Trommelschläger	NN	1	Trommelschläger
versorgen	VVINF	1	versorgen
Uneigennützigkeit	NN	1	Uneigennützigkeit
anstehen	VVINF	1	anstehen
sterben	VVPP	1	gestorben
Termin	NN	1	Termin
satt	ADJD	1	satt
Neue	NN	1	Neues
A	NN	1	A
mieten	VVINF	1	mieten
hüten	VVFIN	1	hüte
billig	ADJD	1	billig
wegfliegen	VVPP	1	weggeflogen
Winkel	NN	1	Winkel
Stunde	NN	1	Stunde
Tälerchen	NN	1	Tälerchen
letzthin	ADV	1	letzthin
Wolf	NE	1	Wolf
eigen	ADJA	1	eigner
herausziehen	VVINF	1	herausziehen
stinkend	ADJA	1	stinkenden
bisher	ADV	1	bisher
teilen	VVFIN	1	Teilen
Klotz	NE	1	Klotz
anhängen	VVPP	1	angehangen
Lunte	NN	1	Lunte
Stirne	NN	1	Stirne
abwehren	VVIZU	1	abzuwehren
Holz	NN	1	Holz
geliebt	ADJA	1	geliebten
Beschwörer	NN	1	Beschwörer
beißen	VVPP	1	gebissen
anrichten	VVPP	1	angerichtet
versöhnen	VVINF	1	versöhnen
Horn	NN	1	Horn
angehen	VVINF	1	angehen
nichtswürdiger	ADJA	1	nichtswürdiger
darnach	ADV	1	darnach
gefährlich	ADJD	1	gefährlich
abhauen	VVINF	1	abhauen
raten	VVFIN	1	rate
zuletzt	ADV	1	zuletzt
tot	ADJD	1	tot
verbannen	VVINF	1	verbannen
Schlüssel	NN	1	Schlüssel
Lelios	NE	1	Lelios
Gesinnung	NN	1	Gesinnungen
Dampf	NN	1	Dampf
albern	ADJD	1	albern
nahe	PTKVZ	1	nahe
Post	NN	1	Post
galant	ADJA	1	galante
Nichtswürdiger	NN	1	Nichtswürdiger
bedanken	VVFIN	1	bedanke
ähnlich	ADJD	1	ähnlich
Gang	NN	1	Gang
Vergnügen	NN	1	Vergnügen
treu	ADJD	1	Treu
Trumpf	NN	1	Trümpfe
durchaus	ADV	1	durchaus
modern	VVFIN	1	modert
rar	ADJD	1	rar
Mitleid	NN	1	Mitleids
herrschen	VVFIN	1	herrschen
leugnen	VVINF	1	leugnen
Anschlag	NN	1	Anschlag
Gegend	NN	1	Gegend
Einfall	NN	1	Einfall
Band	NN	1	Bänder
Historie	NN	1	Historie
Ungelegenheit	NN	1	Ungelegenheit
Asi	NE	1	Asi
empfangen	VVPP	1	empfangen
gemeint	ADJA	1	gemeinte
menschlich	ADJA	1	menschlichem
herauskommen	VVINF	1	herauskommen
edelmütiger	ADJA	1	edelmütiger
ausgeben	VVIZU	1	auszugeben
weswegen	PWAV	1	weswegen
Papier	NN	1	Papiere
Todbette	NN	1	Todbette
rechtschaffen	ADJA	1	rechtschaffene
ermorden	VVINF	1	ermorden
ehrvergeßner	ADJA	1	ehrvergeßner
schimpflich	ADJA	1	schimpflichen
wachsen	VVFIN	1	wächst
schreiben	VVPP	1	geschrieben
dieselb	PDAT	1	dieselbe
weiter	ADV	1	weiter
erhalten	VVINF	1	erhalten
spendabeln	NN	1	spendabeln
beikommen	VVIZU	1	beizukommen
Schwierigkeit	NN	1	Schwierigkeit
Ausflucht	NN	1	Ausflüchte
Nichtswürdigkeit	NN	1	Nichtswürdigkeit
Dritte	NN	1	Dritten
unzeitig	ADJA	1	unzeitige
Unwille	NN	1	Unwillen
behorcht	VVFIN	1	behorcht
abschlägliche	ADJA	1	abschlägliche
Grund	NN	1	Grund
abkaufen	VVPP	1	abgekauft
belieben	VVPP	1	beliebt
Gewächs	NN	1	Gewächse
Rechenschaft	NN	1	Rechenschaft
stehlen	VVPP	1	gestohlen
Aufmerksamkeit	NN	1	Aufmerksamkeit
ängstigen	VVFIN	1	Ängstige
Posse	NN	1	Possen
Manier	NN	1	Manieren
begehst	VVFIN	1	begehst
Willkommen	NN	1	Willkommen
Quintessenz	NN	1	Quintessenz
Anerbietens	NN	1	Anerbietens
Handlung	NN	1	Handlungen
desto	KON	1	desto
erzählen	VVFIN	1	erzählt
wenden	VVINF	1	wenden
Schande	NN	1	Schanden
manche	PIAT	1	manche
notdürftig	ADJD	1	notdürftig
schließen	VVINF	1	schließen
Lehre|Lehren	NN	1	Lehren
ohngefähr	ADJD	1	ohngefähr
gefällig	ADJA	1	gefälligen
brennen	VVINF	1	brennen
gewinnen	VVINF	1	gewinnen
weise	ADJA	1	weiser
indisch	ADJA	1	indische
Anfange	NN	1	Anfange
Anerbieten	NN	1	Anerbieten
gewollt	ADJD	1	gewollt
unten	ADV	1	unten
Geier	NN	1	Geier
wobei	PWAV	1	wobei
Schmähung	NN	1	Schmähungen
Traurigste	NN	1	Traurigste
widerfahren	VVPP	1	widerfahren
verdenken	VVINF	1	verdenken
Verschwender	NN	1	Verschwender
Baum	NN	1	Baum
grauen	VVINF	1	grauen
hundertmal	ADV	1	hundertmal
He	NE	1	He
verschwinden	VVPP	1	verschwunden
Gras	NN	1	Gras
Ahne|Ahnen	NN	1	Ahnen
verschweigen	VVPP	1	verschwiegen
missbrauchen	VVINF	1	mißbrauchen
nochmals	ADV	1	nochmals
Komödie	NN	1	Komödie
Geschichte	NN	1	Geschichte
vorkommen	VVFIN	1	vorkäme
unbillig	ADJD	1	unbillig
Hang	NN	1	Hang
sporenstreichs	NN	1	sporenstreichs
Reinlichkeit	NN	1	Reinlichkeit
ersticken	VVPP	1	erstickt
schweigen	VVIMP	1	Schweig
Besitzer	NN	1	Besitzer
mitbringen	VVFIN	1	mitbrächte
nunmehr	ADV	1	nunmehr
deinig	PPOSS	1	Deinige
Liverei	NN	1	Liverei
Stück	NN	1	Stücken
vergaffen	VVFIN	1	vergafft
bedienen	VVINF	1	bedienen
verschwendet	ADJA	1	verschwendete
Gurgel	NN	1	Gurgel
rätselhaft	ADJD	1	rätselhaft
Glosse	NN	1	Glossen
jährlich	ADJD	1	jährlich
zwanzigen	ADJA	1	zwanzigen
Amerika	NE	1	Amerika
waschen	VVPP	1	gewaschen
Pferd	NN	1	Pferde
Äußerste	NN	1	Äußerste
verwünschter	VVFIN	1	verwünschter
ausgraben	VVINF	1	ausgraben
erregen	VVINF	1	erregen
alleweile	ADV	1	alleweile
herzlich	ADJD	1	herzlich
anklopfen	VVINF	1	anklopfen
deswegen	PAV	1	deswegen
Ansatz	NN	1	Ansatz
Wen	NE	1	Wen
Hannibal	NE	1	Hannibal
Rand	NN	1	Rande
Großvater	NN	1	Großvater
aufsetzen	VVFIN	1	aufsetzen
Goldstück	NN	1	Goldstücke
Narrenspossen	NN	1	Narrenspossen
zahlen	VVFIN	1	zahlen
verhalten	VVINF	1	verhalten
wohlfeilen	VVFIN	1	wohlfeilen
zuziehen	VVPP	1	zugezogen
zurückkommen	VVINF	1	zurückkommen
ausstechen	VVPP	1	ausgestochen
bange	ADJD	1	bange
Verlangen	NN	1	Verlangen
Herrchen	NN	1	Herrchen
stören	VVINF	1	stören
vorstellen	VVPP	1	vorgestellt
dienstfertiger	ADJA	1	dienstfertiger
Verbesserung	NN	1	Verbesserungen
angucken	VVFIN	1	anguckt
lesen	VVINF	1	lesen
Sehen	NN	1	Sehen
Schloss	NN	1	Schlösser
schleppen	VVINF	1	schleppen
gekauft	ADJA	1	gekaufte
gedrungen	ADJD	1	gedrungen
unnütz	ADJA	1	unnützen
Kahlkopf	NN	1	Kahlkopf
Warte|Warten	NN	1	Warten
gestern	ADV	1	gestern
Sage	NN	1	Sage
würdig	ADJD	1	würdig
beifällt	VVFIN	1	beifällt
beantworten	VVINF	1	beantworten
unverhofft	ADJA	1	unverhoffte
schrecken	VVFIN	1	schreckt
Vieh	NN	1	Vieh
dawider	ADV	1	dawider
verborgen	ADJA	1	verborgenen
schlimm	ADJD	1	schlimm
Schmutz	NN	1	Schmutze
unaussprechlich	ADJA	1	unaussprechliches
Verderben	NN	1	Verderben
nähren	VVFIN	1	nähren
Stelle	NN	1	Stelle
Verleumder	NN	1	Verleumder
bescheiden	ADJD	1	bescheiden
entbehren	VVINF	1	entbehren
Schelmstücken	NN	1	Schelmstücken
grämen	VVINF	1	grämen
werfen	VVFIN	1	warf
versichre	VVFIN	1	versichre
Schäfchen	NN	1	Schäfchen
Anführer	NN	1	Anführer
drücken	VVFIN	1	Drücke
Lüge|Lügen	NN	1	Lügen
Gelassenheit	NN	1	Gelassenheit
aufhalten	VVINF	1	aufhalten
Letzte	NN	1	Letzte
ernstlich	ADJD	1	ernstlich
Sammler	NN	1	Sammler
betriegen	ADJA	1	betriegen
blasen	VVINF	1	blasen
Jude	NN	1	Jude
beneidenswürdiger	ADJA	1	beneidenswürdiger
quitt	ADJD	1	quitt
gilts	NN	1	gilts
Bock	NN	1	Bock
Ansehen	NN	1	Ansehen
Begriff	NN	1	Begriff
umsehen	VVFIN	1	umsieht
Ernte	NN	1	Ernte
vorfallen	VVPP	1	vorgefallen
Atem	NN	1	Atem
aufheben	VVPP	1	aufgehoben
schlagen	VVPP	1	geschlagen
versterben	VVPP	1	verstorben
reifen	VVINF	1	reifen
verheiratet	ADJD	1	verheiratet
anvertrauet	VVFIN	1	anvertrauet
ehrvergessener	VVFIN	1	ehrvergessener
Anwerbung	NN	1	Anwerbung
bemerken	VVPP	1	bemerkt
gehn	VVFIN	1	gehn
bauen	VVPP	1	gebaut
nachdächte	VVFIN	1	nachdächte
freuen	VVFIN	1	Freuen
werd	VVFIN	1	ward
bestehen	VVFIN	1	besteht
traurig	ADJA	1	trauriger
vornehm	ADJA	1	vornehmen
ans	APPRART	1	Ans
Hals	NN	1	Hals
Bescheidenheit	NN	1	Bescheidenheit
lebhaft	ADJD	1	lebhaft
allzubald	NE	1	allzubald
einschlagen	VVPP	1	eingeschlagen
betauernswürdige	ADJA	1	betauernswürdige
Mitleiden	NN	1	Mitleiden
ohnedem	ADJD	1	ohnedem
nachsehen	VVINF	1	nachsehen
jedermann	PIS	1	jedermann
licht	ADJD	1	lichter
einsehen	VVINF	1	einsehen
zusammenhalten	VVINF	1	zusammenhalten
fassen	VVFIN	1	fassen
auszuposaunen	VVIZU	1	auszuposaunen
Tadel	NN	1	Tadel
daselbst	ADV	1	daselbst
erstlich	ADJD	1	erstlich
dick	ADJA	1	dicke
schmerzen	VVINF	1	schmerzen
Aufzuge	NN	1	Aufzuge
Niederträchtigkeit	NN	1	Niederträchtigkeit
Wahnwitzigen	NN	1	Wahnwitzigen
entlaufen	VVPP	1	entlaufen
schwer	ADJD	1	schwer
Begebenheit	NN	1	Begebenheit
verwildern	VVPP	1	verwildert
erkundiget	VVFIN	1	erkundiget
Schwanz	NN	1	Schwanz
erkundigen	VVFIN	1	erkundige
abstatten	VVINF	1	abstatten
Kapwein	NN	1	Kapwein
schreien	VVFIN	1	schrie
Viertel	NN	1	Viertel
vorgeben	VVFIN	1	vorgeben
erstaunend	ADJD	1	erstaunend
Anspruch	NN	1	Anspruch
brauchen|gebrauchen	VVPP	1	gebraucht
vorgebt	VVFIN	1	vorgebt
mans	ADJD	1	mans
Glücke	NN	1	Glücke
Vorsprecherin	NN	1	Vorsprecherin
zugegen	ADJD	1	zugegen
gehörig	ADJA	1	gehörigen
saufen	VVFIN	1	soff
Armut	NN	1	Armut
offenherzig	ADJD	1	offenherzig
ausziehen	VVPP	1	ausgezogen
gleichviel	ADV	1	gleichviel
behüten	VVFIN	1	Behüte
Stich	NN	1	Stiche
verhelfen	VVINF	1	verhelfen
dergleichen	PIS	1	dergleichen
Abreise	NN	1	Abreise
übersehen	VVINF	1	übersehen
Bettel	NN	1	Bettel
Träne|Tränen	NN	1	Tränen
murmeln	VVINF	1	murmeln
Verschulden	NN	1	Verschulden
Schrot	NN	1	Schrot
Höflichkeit	NN	1	Höflichkeit
nah	ADJA	1	nächste
Gefängnis	NN	1	Gefängnisse
Ankunft	NN	1	Ankunft
Schwäche	NN	1	Schwäche
Ehre|Ehren	NN	1	Ehren
Wäsche	NN	1	Wäsche
Abend	NN	1	Abends
reiseten	VVFIN	1	reiseten
martre	VVFIN	1	martre
Gattung	NN	1	Gattung
erkenntlich	ADJD	1	erkenntlich
gering	ADJA	1	geringste
teilhaftig	ADJD	1	teilhaftig
allerchristlich	ADJA	1	allerchristlichste
unglaublich	ADJD	1	unglaublich
Hefe	NN	1	Hefen
Lehnstuhle	NN	1	Lehnstuhle
Gauner	NN	1	Gauner
ohnmächtig	ADJD	1	ohnmächtig
Achtel	NN	1	Achtel
anselmisiert	ADJD	1	anselmisiert
Engel	NN	1	Engel
wozu	PWAV	1	wozu
auslegen	VVPP	1	ausgelegt
einhändiget	VVFIN	1	einhändiget
hieher	NN	1	hieher
einhändigen	VVINF	1	einhändigen
meisterlich	ADJD	1	meisterlich
sichs	NN	1	sichs
Leutchen	NN	1	Leutchen
ausreden	VVINF	1	ausreden
Betrachtung	NN	1	Betrachtungen
empfinden	VVPP	1	empfunden
bitte	ADV	1	bitte
zürnen	VVINF	1	zürnen
her	APZR	1	her
vermachen	VVFIN	1	vermachte
los	ADJD	1	los
ehe	KOUS	1	ehe
ersinnen	VVPP	1	ersonnen
Wurf	NN	1	Wurf
Stall	NN	1	Ställe
zuerst	ADV	1	zuerst
Kanal	NN	1	Kanal
Tropfen	NN	1	Tropfen
Hof	NN	1	Hof
ernsthaft	ADJD	1	ernsthaft
Schwager	NN	1	Schwager
gewünschter	ADJA	1	gewünschter
gesetzt	ADJD	1	gesetzt
Luder	NN	1	Luder
Neige	NN	1	Neige
Hafen	NN	1	Hafen
weltbekannt	ADJA	1	weltbekannten
dienen	VVINF	1	dienen
bekräftigen	VVFIN	1	bekräftige
Elle	NN	1	Elle
Nachrede|Nachreden	NN	1	Nachreden
ersäufen	VVPP	1	ersäuft
Nachteiligste	NN	1	Nachteiligste
italienisch	ADJA	1	italienische
Superbes	NN	1	Superbes
Kommen	NN	1	Kommen
elend	ADJA	1	elenden
drehen	VVFIN	1	drehte
Reise	NN	1	Reise
Rest	NN	1	Rest
begleiten	VVINF	1	begleiten
Rind	NN	1	Rinder
Kleinigkeit	NN	1	Kleinigkeit
Strafe	NN	1	Strafe
unerträglich	ADJD	1	unerträglich
Schaf	NN	1	Schafe
Plunder	NN	1	Plunder
berühmt	ADJA	1	berühmten
Körper	NN	1	Körper
grausam	ADJD	1	grausam
Pommer	NN	1	Pommern
vertreten	VVPP	1	vertreten
treffen	VVINF	1	treffen
Gnade	NN	1	Gnade
Barmherzigkeit	NN	1	Barmherzigkeit
Verdienst	NN	1	Verdiensten
meist	PIAT	1	meisten
Anfangsbuchstabe	NN	1	Anfangsbuchstaben
Freudentagen	NN	1	Freudentagen
Bezahlung	NN	1	Bezahlung
ausmachen	VVIZU	1	auszumachen
vorbeugen	VVIZU	1	vorzubeugen
nachsagen	VVINF	1	nachsagen
häufig	ADJD	1	häufig
Europa	NE	1	Europa
Wein	NN	1	Weine
äußer	ADJA	1	äußerste
gegenwärtig	ADJD	1	gegenwärtig
St	NE	1	St
rupfen	VVINF	1	rupfen
Koche	NN	1	Koche
entanselmisieren	VVINF	1	entanselmisieren
edel	ADJA	1	Edles
ungeratner	ADJA	1	ungeratner
herunter	ADV	1	herunter
weißen	VVFIN	1	weißt
ohngeachtet	VVFIN	1	ohngeachtet
ungeratnen	ADJA	1	ungeratnen
ablegen	VVIZU	1	abzulegen
prophezeien	VVFIN	1	prophezeit
Acker	NN	1	Äcker
Haushälterin	NN	1	Haushälterin
Überweg	NN	1	Überwegen
Schneider	NN	1	Schneider
Pauke	NN	1	Pauke
abscheulich	ADJA	1	abscheulichen
Eignes	NN	1	Eignes
Alter	NN	1	Alter
Stein	NE	1	Stein
genannt	ADJA	1	genannten
bezahls	NN	1	bezahls
Zorn	NN	1	Zorn
überschlagen	VVFIN	1	überschlage
Fuchs	NN	1	Fuchs
zufreien	VVFIN	1	zufreien
getreuerer	ADJA	1	getreuerer
erstern	NN	1	erstern
erlauben	VVPP	1	erlaubt
freigebig	ADJD	1	freigebig
Pilz	NN	1	Pilze
Schlimmern	NN	1	Schlimmern
schimpfen	VVINF	1	schimpfen
Verkehr	NN	1	Verkehr
Leides	NN	1	Leides
zuvorkommen	VVPP	1	zuvorgekommen
viermal	ADV	1	viermal
Verführer	NN	1	Verführer
brüderlich	ADJA	1	brüderliche
misslich	ADJA	1	mißlichen
Avisobriefe	NN	1	Avisobriefe
irren	VVFIN	1	irre
riechen	VVINF	1	riechen
zufrieden	ADJD	1	zufrieden
wagen	VVFIN	1	wagen
frech	ADJD	1	frech
ausgehen	VVINF	1	ausgehen
Figur	NN	1	Figur
untergehen	VVPP	1	untergegangen
gereiset	VVPP	1	gereiset
weitläuftiger	ADJD	1	weitläuftiger
darüber	PAV	1	darüber
ruhig	ADJD	1	ruhiger
unverschämt	ADJA	1	unverschämten
Mittel	NN	1	Mittel
Rast-	TRUNC	1	Rast-
Nahrung	NN	1	Nahrung
Verrichtung	NN	1	Verrichtungen
überall	ADV	1	überall
Ursache	NN	1	Ursache
stehn	VVPP	1	stehn
Schranke	NN	1	Schranken
schamrot	ADJD	1	schamrot
schlafen	VVINF	1	schlafen
Vorwissen	NN	1	Vorwissen
unrecht	ADJD	1	unrecht
eisern	ADJA	1	eiserne
Achtung	NN	1	Achtung
abtreten	VVINF	1	abtreten
Schubsacke	NN	1	Schubsacke
Verbrechen	NN	1	Verbrechen
ausstehen	VVPP	1	ausgestanden
Freiheit	NN	1	Freiheit
Ehrentitel	NN	1	Ehrentitel
nachdem	KOUS	1	nachdem
irgend	ADV	1	irgend
größrer	ADJA	1	größrer
furchtsam	ADJD	1	furchtsam
gerechtfertiget	VVFIN	1	gerechtfertiget
haften	VVFIN	1	haften
beruhigen	VVINF	1	beruhigen
Darlehn	NN	1	Darlehn
treiben	VVINF	1	treiben
Sorge	NN	1	Sorge
abschneiden	VVINF	1	abschneiden
schurkisch	ADJA	1	schurkischen
manchmal	ADV	1	manchmal
dumm	ADJD	1	dumm
gefaßt	ADJD	1	gefaßt
Treugen	NN	1	Treugen
infam	ADJA	1	infamer
vorschlagen	VVINF	1	vorschlagen
etliche	PIAT	1	etlichen
dadurch	PAV	1	dadurch
Schaden	NN	1	Schaden
Schnappsack	NN	1	Schnappsack
reisete	VVFIN	1	reisete
Gibraltar	NE	1	Gibraltar
rücken	VVIMP	1	rück
Unerfahrenheit	NN	1	Unerfahrenheit
Huhn	NN	1	Hühner
weder	KON	1	weder
Geizhals	NN	1	Geizhalses
Gespenste	NN	1	Gespenste
verübt	ADJA	1	verübte
Strafpredigt	NN	1	Strafpredigt
verdrüßlich	ADJD	1	verdrüßlich
Heirat	NN	1	Heirat
bewegen	VVFIN	1	bewegen
herein	ADV	1	herein
nützen	VVINF	1	nützen
vorüber	ADV	1	vorüber
Besuch	NN	1	Besuch
Beistand	NN	1	Beistand
fühlen	VVFIN	1	fühlt
fortbringen	VVINF	1	fortbringen
Maska	NE	1	Maska
andermal	ADV	1	andermal
Wanne	NN	1	wannen
fällen	VVPP	1	gefällt
stellen	VVFIN	1	stellen
Zehnmalen	NN	1	Zehnmalen
tanzen	VVFIN	1	tanzen
gehts	NN	1	gehts
erschrecken	VVFIN	1	erschrak
verändern	VVPP	1	verändert
probieren	VVINF	1	probieren
Zerstreuer	NN	1	Zerstreuer
Last	NN	1	Last
verhüten	VVFIN	1	verhüte
abgetragen	ADJA	1	Abgetragene
Schämen	NN	1	Schämen
erwarten	VVINF	1	erwarten
Gärtner	NN	1	Gärtner
weiß	ADJD	1	weiß
Schiff	NN	1	Schiffe
Fluch	NN	1	Fluch
allzu	PTKA	1	allzu
offenbar	ADJD	1	offenbar
beträchtlich	ADJA	1	beträchtliches
Kommission	NN	1	Kommission
Engeland	NN	1	Engeland
dreihundert	CARD	1	dreihundert
Treppe	NN	1	Treppe
Rom	NE	1	Rom
allerdings	ADV	1	allerdings
dauern	VVFIN	1	dauern
Kapua	NN	1	Kapua
ablassen	VVFIN	1	abläßt
fruchtlos	ADJD	1	fruchtlos
Schicksal	NN	1	Schicksal
verteufelt	ADJA	1	verteufelten
Feind	NN	1	Feinden
besorgen	VVFIN	1	besorgten
Betragen	NN	1	Betragens
sowohl	KON	1	sowohl
Frauenzimmer	NN	1	Frauenzimmer
Eckhaus	NN	1	Eckhaus
verwenden	VVINF	1	verwenden
Böse	NN	1	Bösen
Profitchen	NN	1	Profitchen
Mas	ADJA	1	Mas
erteilen	VVINF	1	erteilen
rechtschaffenste	ADJA	1	rechtschaffenste
Bursche	NN	1	Burschen
Anlass	NN	1	Anlaß
weltberühmt	ADJA	1	weltberühmten
entlegen	ADJA	1	entlegenen
einschlafen	VVPP	1	eingeschlafen
Familie	NN	1	Familie
zuhören	VVPP	1	zugehört
Not	NN	1	Not
Nötige	NN	1	Nötige
abgehen	VVPP	1	abgegangen
Ochse	NN	1	Ochsen
Auflauf	NN	1	Auflauf
ermangeln	VVINF	1	ermangeln
Wohlfahrt	NN	1	Wohlfahrt
Fass	NN	1	Fasse
gestehen	VVFIN	1	gestehe
Bedenken	NN	1	Bedenken
prahlen	VVINF	1	prahlen
Verspare	VVFIN	1	Verspare
unvergleichlich	ADJA	1	unvergleichliche
sehnlich	ADJD	1	sehnlich
Aussaat	NN	1	Aussaat
umsiehet	VVFIN	1	umsiehet
anhalten	VVINF	1	anhalten
redt	ADJD	1	redt
selbe	PDS	1	selben
Solo	NN	1	Solo
Siegel	NN	1	Siegel
Korb	NN	1	Korb
erklären	VVINF	1	erklären
befehlen	VVFIN	1	befehlen
unverantwortlich	ADJD	1	unverantwortlich
Nachdruck	NN	1	Nachdruck
Lang	NE	1	Lang
Rapsen	NN	1	Rapsen
Gut	NN	1	Gut
reifern	ADJA	1	reifern
Bescheid	NN	1	Bescheid
begreifen	VVINF	1	begreifen
vergraben	VVPP	1	vergraben
voraussahe	ADJA	1	voraussahe
Zahn	NN	1	Zähnen
Zahl	NN	1	Zahlen
ruinieren	VVINF	1	ruinieren
liebenswürdig	ADJA	1	liebenswürdige
vergnügen	VVPP	1	vergnügt
Schwur	NN	1	Schwur
fett	ADJA	1	fette
empfehlen	VVINF	1	empfehlen
Scheltworte	NN	1	Scheltworte
Dasmal	ADV	1	Dasmal
klar	ADJD	1	klar
Verstand	NN	1	Verstand
halfs	VVFIN	1	halfs
verlangen	VVFIN	1	verlangt
Taube	NN	1	Tauben
Sinn	NN	1	Sinne
Spitze	NN	1	Spitzen
ausgeklagten	ADJA	1	ausgeklagten
Verschwendung	NN	1	Verschwendungen
Zunge	NN	1	Zunge
gleichgültig	ADJD	1	gleichgültig
befallen	VVPP	1	befallen
vierhundert	CARD	1	vierhundert
unbekannt	ADJD	1	unbekannt
Nachbar	NN	1	Nachbarn
huschen	VVIMP	1	husch
Wende	NN	1	Wenden
Seinigen	NN	1	Seinigen
Rip	NN	1	Rip
Gefahr	NN	1	Gefahr
Nu	NN	1	Nu
reißen	VVFIN	1	riß
bekennen	VVFIN	1	bekenne
Übel	NN	1	übeln
abwenden	VVIZU	1	abzuwenden
bestätiget	VVFIN	1	bestätiget
Absehen	NN	1	Absehen
entblößen	VVINF	1	entblößen
wunderlich	ADJD	1	wunderlich
rechtschaffner	ADJA	1	rechtschaffner
anzeigen	VVINF	1	anzeigen
wohlfeil	ADJD	1	wohlfeil
nachzählen	VVINF	1	nachzählen
ungerschen	ADJA	1	ungerschen
gelten	VVINF	1	gelten
zuhalten	VVFIN	1	zuhält
aussprechen	VVPP	1	ausgesprochen
Träger	NN	1	Träger
aufrichtig	ADJA	1	aufrichtiges
hager	ADJD	1	hager
Euchs	VVFIN	1	Euchs
unhöflich	ADJA	1	unhöflichen
Esel	NN	1	Esel
losmachen	VVINF	1	losmachen
hinterbrechen	VVFIN	1	hinterbracht
vorhin	ADV	1	vorhin
prächtig	ADJA	1	prächtigsten
adieu	ADV	1	Adieu
wegnehmen	VVIZU	1	wegzunehmen
Wohnung	NN	1	Wohnung
plaudern	VVFIN	1	plaudern
Kosten	NN	1	Kosten
Empfang	NN	1	Empfang
Loch	NN	1	Loch
uneben	ADJA	1	unebene
Wetter	NN	1	Wetter
einander	PRF	1	einander
dreißigjährig	ADJA	1	dreißigjährigen
Ofen	NN	1	Öfen
Rabatt	NN	1	Rabatt
Sage|Sagen	NN	1	Sagen
anschlagen	VVINF	1	anschlagen
Pst	NN	1	Pst
Betriegereien	NN	1	Betriegereien
Schelm	NN	1	Schelm
geredt	ADJD	1	geredt
Gelehrsamkeit	NN	1	Gelehrsamkeit
schlau	ADJD	1	schlau
Auster	NN	1	Austern
seitdem	PAV	1	seitdem
grau	ADJA	1	grauen
Danksagung	NN	1	Danksagung
verlorne	ADJA	1	verlorne
bessern	VVINF	1	bessern
packen	VVFIN	1	packe
Marsch	NN	1	Marsch
wirs	ADJD	1	wirs
mags	NN	1	mags
Niederlage	NN	1	Niederlage
versündigen	VVFIN	1	versündigen
vorrücken	VVIZU	1	vorzurücken
Stoff	NN	1	Stoff
sparen	VVPP	1	gespart
überlegen	VVPP	1	überlegt
drum	PAV	1	Drum
allezeit	ADV	1	allezeit
insbesondere	ADV	1	insbesondere
drohend	ADJA	1	drohende
Laterne	NN	1	Laterne
Galgen	NN	1	Galgen
Knecht	NN	1	Knecht
aufgebracht	ADJD	1	aufgebracht
Lob	NN	1	Lob
gesund	ADJD	1	gesund
Krieg	NN	1	Kriege
prellen	VVFIN	1	prellt
scherzen	VVINF	1	scherzen
Ansi	NE	1	Ansi
Ansa	NE	1	Ansa
allerlei	PIAT	1	allerlei
Rechnung	NN	1	Rechnungen
allmählig	ADJD	1	allmählig
einschmeißen	VVPP	1	eingeschmissen
Flasche	NN	1	Flasche
Früchtchen	NN	1	Früchtchen
Skripturen	NN	1	Skripturen
Schuhblätter	NN	1	Schuhblätter
Hoffnung	NN	1	Hoffnung
henken	VVPP	1	gehenkt
längst	ADV	1	längst
entdecken	VVINF	1	entdecken
Verzeichnis	NN	1	Verzeichnis
Sperling	NN	1	Sperling
Mörder	NN	1	Mörder
Prophet	NN	1	Propheten
siebenmal	ADV	1	siebenmal
kleben	VVINF	1	kleben
Buckel	NN	1	Buckel
retten	VVINF	1	retten
schriftlich	ADJD	1	schriftlich
Mundwerk	NN	1	Mundwerk
Drittel	NN	1	Drittel
Lebtage	NN	1	Lebtage
verwehren	VVINF	1	verwehren
Leuteschinder	NN	1	Leuteschinder
Gläubiger	NN	1	Gläubiger
aufhören	VVINF	1	aufhören
getan	ADJA	1	getanen
Magd	NN	1	Magd
Karte	NN	1	Karte
schwören	VVINF	1	schwören
eigentlich	ADV	1	eigentlich
schade	ADJD	1	Schade
womit	PWAV	1	womit
nachts	ADV	1	Nachts
höflich	ADJD	1	höflich
letztemal	ADV	1	letztemal
untergestütztem	ADJA	1	untergestütztem
durchbringen	VVPP	1	durchgebracht
Vorgebirge	NN	1	Vorgebirge
zwei	CARD	1	zwei
Kindische	NN	1	Kindisches
fahren	VVFIN	1	fuhr
nackend	ADJD	1	nackend
rechtfertigen	VVINF	1	rechtfertigen
aufstehen	VVINF	1	aufstehen
Gewölbe	NN	1	Gewölbe
abwesend	ADJD	1	abwesend
Erstlich	ADJD	1	Erstlich
geheim	ADJA	1	geheimes
schätzen	VVINF	1	schätzen
derselb	PDAT	1	desselben
Wendischen	NN	1	Wendischen
Allernotwendigsten	NN	1	Allernotwendigsten
aussterben	VVPP	1	ausgestorben
he	ITJ	1	he
entsetzlich	ADJD	1	entsetzlich
Diener	NN	1	Diener
Pflasterstein	NN	1	Pflastersteinen
ärgerlich	ADJD	1	ärgerlich
überliefern	VVINF	1	überliefern
verkleiden	VVINF	1	verkleiden
Haut	NN	1	Haut
Million	NN	1	Million
Kniff	NN	1	Kniffe
Frühjahr	NN	1	Frühjahr
einbringen	VVFIN	1	einbringt
versagen	VVFIN	1	versage
außer	APPR	1	Außer
erschreckst	VVFIN	1	erschreckst
Testament	NN	1	Testamente
Schwätzer	NN	1	Schwätzer
Lust	NN	1	Lust
