Title: Der Misogyn
Number of all lemmas: 12369
Nummber of different lemmas: 1788

Lemma	POS	Frequency	Tokens
ich	PPER, PRF	700	ich, mich, mir, Ich, meiner
die	ART, PDS, PRELS, PRELAT, PDAT	592	den, Die, der, das, Das, die, dem, des, deren, Der, dessen
sein	VAFIN, VAINF, VAPP, PPOSAT	459	ist, sein, Ist, gewesen, seines, bist, bin, seiner, war, wäre, wärst, sind, seinen, Sind, seinem, seine, wären, Bist, Bin, sei, War, waren, Sei, seid
Sie	PPER	403	Sie, Ihnen
nicht	PTKNEG	264	nicht, Nicht
haben	VAFIN, VAINF, VAPP	260	haben, Hätte, habe, hat, hätten, hast, hatten, hätte, hatte, Habe, gehabt, Haben, Hat, hättest, habt, hattet, Hätten, Hast, Hatte
eine	ART, PIS	259	eine, einem, einen, Ein, ein, einer, Eine, Einem, Einen, eines
zu	APPRART, APPR, PTKZU, PTKA, PTKVZ, ADV	209	zum, zu, Zu, zur, Zum
und	KON	197	und, Und
es	PPER	191	es, Es
mein	PPOSAT	190	mein, meine, meinem, meinen, meiner, Meine, meines, Mein
er	PPER	187	er, ihn, Er, ihm
dass	KOUS	184	daß, Daß
so	ADV	162	so, So
du	PPER, PRF	159	du, dich, dir, Du
werden	VAFIN, VAINF, VAPP	150	wird, werde, werden, würde, würden, geworden, wirst, Werde, Wird, würdest, worden, wurde
ihr	PPOSAT, PPER	144	Ihr, Ihren, Ihrer, ihrem, ihre, Ihre, ihr, Ihrem, ihrer, Ihres, ihres, euch, ihren
wollen	VMFIN, VMINF	128	will, willst, wollen, wolltest, wollte, wolle, wollten, Willst, Will, Wollt
können	VMFIN, VMINF	121	kann, können, kannst, könntest, könne, könnte, Können, konnten, Könnte, könnten, Konnte, Kann
in	APPRART, APPR	120	ins, in, In, im, Im
sie	PPER	115	sie, ihnen, Ihr
mit	APPR, PTKVZ	101	mit, Mit
wenn	KOUS	97	wenn, Wenn
Herr	NN	90	Herr, Herrn, Herren
sollen	VMFIN	86	soll, sollst, sollte, sollten, Soll, sollen, Sollen, sollt
doch	ADV, KON	84	doch, Doch
als	KOUS, KOKOM, KON	83	als, Als
nur	ADV	79	nur, Nur
wie	KOKOM, KOUS	79	Wie, wie
was	PWS, PRELS, PIS	76	Was, was
von	APPR, APPRART	75	von, Von, vom
müssen	VMFIN, VMINF	75	müssen, muß, müßten, mußte, Muß, müßte, müsse, mußt, müßt
aber	KON, ADV	73	aber, Aber
sagen	VVPP, VVINF, VVIMP, VVFIN	71	gesagt, sagen, sag, sagst, Sagen, sage, sagt, Sage
sich	PRF	68	sich
auf	APPR, PTKVZ	62	auf, Auf
auch	ADV	61	auch, Auch
Lelio	NE	58	Lelio
machen	VVPP, VVINF, VVFIN	57	gemacht, machen, machte, macht, Machen, Mache, Macht, mache
noch	ADV, KON	55	noch, Noch
nun	ADV	52	nun, Nun
ja	ADV, PTKANT	51	ja, Ja
alle	PIAT, PIS	50	alles, Alles, allen, alle, allem, Aller, aller, all
wissen	VVFIN, VVINF	49	weiß, wissen, Wissen, wußte, wisse, wüßte, Wüßte, wüßten
wir	PPER, PRF	49	wir, uns, Wir
dies	PDAT	48	dieses, diese, diesem, dieser, diesen, Diese, Dieser, Dieses
Vater	NN	47	Vater, Vaters
dein	PPOSAT	46	deines, dein, deinen, deinem, deiner, deine, Dein, Deine
sehen	VVINF, VVFIN, VVIMP, VVPP	44	sehen, sehe, sah, sähe, siehst, Sieh, sieht, gesehen, sieh, Sehen, Sähe
wohl	ADV	44	wohl
für	APPR	43	für, Für
denn	ADV, KON	43	denn, Denn
man	PIS	42	man, Man
an	PTKVZ, APPR, APPRART	42	an, An, am
gut	ADJD, ADJA	39	gut, guten, gute, gutem, besten, guter, besser, Gut, gutes
gehen	VVIMP, VVFIN, VVINF, VVPP	36	Geh, Geht, gehen, geht, gegangen, gehe, Gehet, Gehen, gehet, geh
aus	PTKVZ, APPR	33	aus, Aus
Schwester	NN	32	Schwester
lieb	ADJD, ADJA	32	lieber, liebster, lieb, liebsten, Liebste, liebste, Liebe, liebst, liebe, lieben
Sohn	NN	32	Sohn, Söhne, Sohne, Sohnes
schon	ADV	32	schon, Schon
kommen	VVINF, VVFIN, VVPP, VVIMP	31	kommen, Kommen, käme, gekommen, komme, komm, kommt
lassen	VVINF, VVFIN, VVIMP	31	lassen, ließe, läßt, Laß, Lassen, ließ, laßt, lasse
hören	VVFIN, VVINF	30	hörst, hören, Höre, höre, Hörst, hört, Hören
Bruder	NN	30	Bruders, Bruder
Leander	NE	29	Leander
eben	ADV	29	eben, Eben
Hilaria	NE	28	Hilaria
glauben	VVINF, VVFIN, VVPP	28	glauben, glaubt, Glaubst, geglaubt, glaube, glaubte, glaubten
gewiss	ADJD, ADJA	27	gewiß, Gewiß, gewissen, gewisse, gewisser
mehr	ADV, PIAT	27	mehr, Mehr
ganz	ADV, ADJA, ADJD	27	ganz, ganzes, ganze, Ganz, ganzen
selbst	ADV	26	selbst
tun	VVINF, VVFIN, VVPP	26	tun, tut, getan, tust, tue, taten
nichts	PIAT, PIS	25	nichts, Nichts
andere	PIS, PIAT	25	andere, andern, andrer, andre
einmal	ADV	24	einmal, Einmal
da	PTKVZ, KOUS, ADV	24	da, Da
bei	APPR	24	bei
sehr	ADV	24	sehr
Tochter	NN	23	Tochter
oder	KON	23	oder, Oder
vor	APPR, PTKVZ, ADV, APPRART	23	vor, Vor, Vors
lieben	VVINF, VVFIN, VVPP	22	lieben, liebte, liebe, geliebt, Lieben
viele	PIAT, PIS	21	vielen, viel, vieles, vielem, viele
mögen	VMFIN	21	mag, möchte, mögen, magst, möchten, Möchte
Solbist	NN	21	Solbist
wieder	ADV	20	wieder, Wieder
denken	VVINF, VVFIN, VVIMP	20	denken, dächte, Denken, dächten, denk, denke, denkt
Valer	NE	20	Valer
ob	KOUS	20	Ob, ob
über	APPR	20	über, Über
keine	PIAT	20	keine, keinen, kein
Laura	NE	19	Laura
gar	ADV	19	gar
O	NN	19	O
schön	ADJA, ADJD	19	schönes, schönen, schön, schönste, Schönste, schöne, schöner
Liebe	NN	19	Liebe
welche	PIAT, PRELS, PWAT, PIS, PWS	18	Welch, welche, welchen, welcher, Welche, welches, welchem
jetzt	ADV	18	jetzt, Jetzt
bringen	VVPP, VVINF, VVFIN	18	gebracht, bringen, brachte, bringe, Bringe
Mann	NN	18	Manne, Mann, Mannes
nach	APPR, PTKVZ	18	nach, Nach
Auge	NN	18	Augen
gleich	APPR, ADJA, ADJD	18	gleich, gleichen, gleicher, Gleich
dürfen	VMFIN, VMINF	17	dürfte, Darf, durfte, darf, durften, dürfen
Weib	NN	17	Weiber, Weibern, Weib
halten	VVPP, VVINF, VVFIN	17	gehalten, halten, hältst, hält, halte
geben	VVINF, VVFIN, VVPP	16	geben, Geben, gebe, gegeben
wo	PWAV	16	Wo, wo
erst	ADV, ADJA	16	erst, erste, ersten
nehmen	VVINF, VVFIN, VVIMP, VVPP	16	nehmen, nehme, nimmst, nimm, genommen, Nehmen
durch	APPR, PTKVZ	16	durch
Unglück	NN	16	Unglück, Unglücke
Leandern	NE, VVINF, NN	16	Leandern
recht	ADJD, PTKVZ	15	recht, Recht
unser	PPOSAT	15	unsere, unserm, unser, Unsere, unsrer, unsres
also	ADV	15	also
allein	ADV	15	allein, Allein
ab	PTKVZ	14	ab
wenige	PIS, PIAT	14	wenig, weniger, wenige
kömmt	VVFIN, ADJA, ADJD	14	kömmt
um	APPR, KOUI	14	um, Um
Frau	NN	14	Frau
genug	ADV	14	genug
wer	PWS	14	Wer, wer
gegen	APPR	13	gegen, Gegen
groß	ADJA, ADJD	13	größtes, groß, größte, große, großen, größer, großer
je	ADV, KOUS	13	Je, je
etwas	PIAT, PIS, ADV	13	etwas
nein	PTKANT	13	Nein, nein
finden	VVFIN, VVINF, VVPP	13	finde, findet, finden, gefunden
Wumshäter	NN	13	Wumshäter
bald	ADV	13	bald, Bald
Johann	NE	12	Johann
Prozess	NN	12	Prozeß, Prozesses, Prozesse
endlich	ADV	12	endlich, Endlich
bleiben	VVIMP, VVFIN, VVINF	12	Bleib, bleibt, bleib, bleiben, Bleiben
unmöglich	ADJD	12	unmöglich, Unmöglich
glücklich	ADJD, ADJA	11	glücklich, glücklichen
antworten	VVFIN, VVINF	11	Antworte, antworte, antworten, Antworten
erfahren	VVPP, VVFIN, VVINF	11	erfahren, erfuhr, erfährt, erführe
heute	ADV	11	heute, Heute
warum	PWAV	11	Warum, warum
zwar	ADV	11	zwar
weil	KOUS	11	weil
lang	ADJD, ADJA	11	länger, lange
Welt	NN	11	Welt
stehen	VVFIN, VVINF, VVIMP	11	steht, stehen, stehe, stehst, Steh, steh
setzen	VVPP, VVINF	11	Gesetzt, setzen, gesetzt
Herz	NN	10	Herz, Herzen
Pars	NN	10	Pars
wahr	ADJD, ADJA	10	wahr, wahren
vielleicht	ADV	10	Vielleicht, vielleicht
Hand	NN	10	Händen, Hand
Tag	NN	10	Tage, Tag, Tagen
hoffen	VVINF, VVFIN, VVIMP	10	hoffen, hoffe, hoff
ohne	APPR, KOUI	10	ohne
klug	ADJD	10	klug
bis	APPR, KON, KOUS	10	bis, Bis
viel	ADV	10	viel
hier	ADV	10	hier, Hier
Mensch	NN	10	Menschen, Mensch
drei	CARD	9	drei, Drei
wirklich	ADJD	9	wirklich, Wirklich
Zeit	NN	9	Zeit
unter	APPR	9	unter
schweigen	VVFIN, VVIMP	9	schweigen, Schweig, schweige, schweigt, schweig
folgen	VVINF, VVFIN	9	folgen, folge
immer	ADV	9	immer
leicht	ADJD	9	leicht, leichter
Sache	NN	9	Sache, Sachen
einzig	ADJA, ADJD	9	einzigen, einzige, einzig, einziger
kennen	VVFIN, VVINF, VVIMP, VVPP	9	kenne, kennen, kenn, gekannt, kennet
bekommen	VVPP, VVFIN, VVINF	9	bekommen, bekomme
erstaunen	VVFIN, VVPP, VVINF	9	erstaune, erstaunt, erstaunen, Erstaunen
damit	PAV, KOUS	9	damit, Damit
oft	ADV	9	oft
freilich	ADV	9	freilich, Freilich
Wort	NN	8	Wort, Worten, Worte
klein	ADJD, ADJA	8	klein, kleinen, kleine, kleiner
anders	ADV	8	anders
gewinnen	VVPP, VVFIN, VVINF	8	gewonnen, gewinne, gewinnen
kurz	ADJD, ADJA	8	kurz, kurzen, Kurz
merken	VVFIN, VVINF, VVPP	8	merkt, Merken, merken, gemerkt
einander	PRF	8	einander
verlieren	VVPP, VVINF, VVFIN	8	verloren, verlieren, verliert
möglich	ADJA, ADJD	8	möglichen, möglich
Paradies	NN	8	Paradies, Paradiese
Jungfer	NN	8	Jungfer, Jungfern
weit	ADJD	8	weit, Weit
Frauenzimmer	NN	8	Frauenzimmer
Himmel	NN	8	Himmel
wenigstens	ADV	8	wenigstens
eher	ADV	8	eher
Rede	NN	8	Rede
suchen	VVFIN, VVINF, VVPP	8	suchet, suchen, gesucht, sucht
Haus	NN	8	Hause, Haus
dazu	PAV	7	dazu
Person	NN	7	Person
bitten	VVFIN, VVINF, VVIMP	7	bitte, bitten, Bitte
fürchten	VVFIN	7	fürchtest, fürchtete, fürchte
desto	KON	7	desto, Desto
Art	NN	7	Art
nunmehr	ADV	7	nunmehr
böse	ADJA	7	böse, bösen, bösesten
ei	NE, FM	7	Ei, ei
ähnlich	ADJD	7	ähnlicher, ähnlich
Madmoisell	NE, NN	7	Madmoisell
gering	ADJA, ADJD	7	geringste, geringsten
meinen	VVFIN, VVINF	7	meinen, meine, meinten, meinst
Verzeichnis	NN	7	Verzeichnis, Verzeichnisse
darüber	PAV	7	darüber
Gleichheit	NN	7	Gleichheit
Mutter	NN	7	Mutter
reden	VVINF, VVFIN	7	reden, rede
arm	ADJD, ADJA	7	arm, armes, Armer, armen, arme
Gott	NN	7	Gottes, Gott
reisen	VVINF, VVFIN	7	reisen, reise
verlangen	VVFIN, VVINF	7	verlangst, verlangen, verlange, verlangt
längst	ADV	7	längst
vergleichen	VVINF, VVFIN	6	vergleichen, Vergleichen, vergliche
versprechen	VVFIN, VVINF	6	versprichst, versprechen, versprach, versprachen, verspreche
weiter	PTKVZ, ADV	6	weiter
erzählen	VVFIN, VVINF	6	erzählt, erzähle, Erzählen, erzählen, erzählte
sprechen	VVFIN, VVINF	6	spricht, sprechen, sprichst
Geschlecht	NN	6	Geschlecht, Geschlechts
weiblich	ADJA	6	weiblichen, weibliches, weiblicher, weibliche
gehören	VVFIN	6	gehörst, gehöre, gehört
schlecht	ADJA	6	schlechte, schlechten
versichern	VVPP, VVFIN, VVINF	6	versichert, versichere, versichern
geschwind	ADJD	6	geschwind, Geschwind
Jahr	NN	6	Jahren, Jahres, Jahr, Jahre
Betrachtung	NN	6	Betrachtung
am	PTKA	6	am
sondern	KON	6	sondern
Erfahrung	NN	6	Erfahrung
Ding	NN	6	Dingen, Ding, Dinge
darauf	PAV	6	darauf
Gesicht	NN	6	Gesicht, Gesichte
daraus	PAV	6	daraus
helfen	VVPP, VVFIN, VVINF	6	geholfen, helfen, Helfen, Hilft, hilft
beide	PIS	6	beide, beides
einige	PIAT	6	einige, einigen, einigem
gern	ADV	6	gern
Leichtgläubigkeit	NN	6	Leichtgläubigkeit
Glück	NN	6	Glück
leben	VVINF, VVFIN, VVPP	6	leben, Lebe, gelebt, lebt
vortrefflich	ADJD, ADJA	6	vortrefflich, vortreffliche
vergessen	VVFIN, VVPP, VVINF	5	vergißt, vergessen, Vergessen
wahrhaftig	ADJD	5	Wahrhaftig, wahrhaftig
Wasser	NN	5	Wasser
vorher	ADV	5	vorher
sicher	ADJD, ADJA	5	sicher, sichere, sicherer, sichersten
anfangen	VVFIN, VVINF, VVPP	5	anfängt, anfangen, angefangen
schämen	VVFIN, VVINF	5	schäme, schämen
Lisette	NE	5	Lisette
lange	ADV	5	lange
Torheit	NN	5	Torheit
wegen	APPO, APPR	5	wegen
dabei	PAV	5	dabei
bloß	ADJD, ADJA	5	bloß, bloße
los	PTKVZ, ADJD	5	los
Verdruss	NN	5	Verdruß
Stille	NN	5	Stille
alt	ADJA	5	alten, alte, altes
richtig	ADJD, ADJA	5	richtig, richtiges
besitzen	VVFIN, VVINF	5	besaß, besitzen
Recht	NN	5	Recht
heiraten	VVFIN, VVINF	5	heirate, heiraten, heiratete
Alter	NN	5	Alters, Alter
bedenken	VVFIN	5	bedenke, bedenken, Bedenke
Bedingung	NN	5	Bedingung
Schaden	NN	5	Schaden
besonders	ADV	5	besonders, Besonders
sonst	ADV	5	sonst, Sonst
Seele	NN	5	Seele
erklären	VVFIN, VVINF	5	erklären, Erkläre
danken	VVFIN, VVINF	5	danken, danke
Verstand	NN	5	Verstand, Verstandes
Mannsperson	NN	5	Mannsperson, Mannspersonen
kaum	ADV	5	kaum
verbinden	VVFIN, VVPP	5	verbinde, verbunden
Schmeichelei	NN	5	Schmeicheleien, Schmeichelei
grau	ADJA, ADJD	5	grauen, graue, grau
Stadt	NN	5	Stadt
Adam	NE	5	Adam
gleichwohl	ADV	5	gleichwohl, Gleichwohl
Weibsbild	NN	5	Weibsbild, Weibsbilder
zwei	CARD	5	zwei, zweien
daran	PAV	5	daran, Daran
Lust	NN	5	Lust
jemals	ADV	4	jemals
recht|rechts	ADJA	4	rechte, rechten
Miene	NN	4	Mienen, Miene
überzeugen	VVFIN, VVPP, VVINF	4	überzeugt, überzeugen
laß	ADJD	4	laß
Antwort	NN	4	Antwort
Lisettchen	NN	4	Lisettchen
abgeschmackt	ADJD	4	abgeschmackt, abgeschmackter
Vergnügen	NN	4	Vergnügen
Mamsell	NN, NE	4	Mamsell
Vernunft	NN	4	Vernunft
dafür	PAV	4	dafür
Leute	NN	4	Leuten, Leute
fangen	VVFIN, VVPP	4	fängst, fingen, fängt, gefangen
Schuld	NN	4	Schulden, Schuld
nie	ADV	4	nie
dieselb	PDAT	4	dieselben, dieselbe
niemals	ADV	4	niemals
stiften	VVINF	4	stiften
Beste	NN	4	Besten, Beste
Ende	NN	4	Ende
verdienen	VVFIN, VVINF	4	verdient, verdienen
fort	PTKVZ, ADV	4	fort
deswegen	PAV	4	deswegen
Tat	NN	4	Tat
lächerlich	ADJA, ADJD	4	lächerliche, lächerlich
Advokat	NN	4	Advokat, Advokaten
Einwilligung	NN	4	Einwilligung
st	VVFIN	4	st
entbehren	VVINF	4	entbehren
zweit	ADJA	4	zweite, zweiten
Geduld	NN	4	Geduld
solche	PIAT	4	Solche, solchen, solches
führen	VVINF, VVFIN	4	führen, Führen
ansehen	VVINF, VVPP	4	ansehen, angesehen
woher	PWAV	4	woher, Woher
darin	PAV	4	darin
närrisch	ADJA, ADJD	4	Närrisches, närrisch
hernach	ADV	4	hernach
vergeben	VVINF, VVFIN	4	vergeben, Vergeben
fragen	VVFIN, VVPP	4	Fragen, gefragt, fragen
her	PTKVZ	4	her
pfui	ITJ	4	Pfui, pfui
Ehre	NN	4	Ehre
Braut	NN	4	Braut
Körper	NN	4	Körper
St	NE	4	St
List	NN	4	List
Leanders	NE	4	Leanders
erlauben	VVFIN, VVINF	4	Erlauben, erlauben
fallen	VVINF, VVFIN	4	fallen, fallt
wagen	VVINF, VVFIN, VVPP	4	wagen, wagst, gewagt
vollkommen	ADJD	4	vollkommen
Umstand	NN	4	Umständen, Umstände
Ursache	NN	4	Ursache, Ursachen
unsinnig	ADJD, ADJA	4	Unsinnig, unsinnige, unsinnig
genießen	VVFIN, VVINF	4	Genießen, genießen
Gehorsam	NN	4	Gehorsam
Kind	NN	4	Kinder, Kind, Kindern
verlassen	VVPP, VVFIN, VVINF	4	verlassen, verlasse
erwarten	VVINF, VVPP, VVFIN	4	erwarten, erwartet, erwarte
geschehen	VVFIN, VVPP	4	geschieht, geschehen
reich	ADJA, ADJD	4	reiche, reichen, reich
gütig	ADJD, ADJA	4	gütig, gütige
indem	KOUS	4	Indem
verwickeln	VVPP, VVFIN, VVINF	4	verwickelt, verwickeln
fein	ADJD, ADJA	4	fein, feinen
gelten	VVINF, VVFIN	4	gelten, gilt
ungeduldig	ADJD	4	ungeduldig
zärtlich	ADJD, ADJA	4	zärtlich, zärtlichen, zärtliche
jemand	PIS	4	jemand, jemanden
begehen	VVINF, VVPP	4	begehen, begangen
etwa	ADV	4	etwa
seit	APPR	4	seit
Heirat|Heiraten	NN	4	Heiraten
besinnen	VVPP, VVFIN, VVINF	4	besonnen, Besinnen, besinnen
Gelegenheit	NN	4	Gelegenheit
Ohr	NN	4	Ohr
erkennen	VVINF, VVPP, VVFIN	4	erkennen, erkannt, erkennt
ha	NE	4	ha
davon	PAV	4	davon
jung	ADJA, ADJD	4	junge, jung, jungen, junger
voraus	PTKVZ, ADV	3	voraus
Recht|Rechte	NN	3	Rechte
Acht	NN	3	Acht
spät	ADJD	3	spät
hintergehen	VVINF, VVFIN	3	hintergehen, hintergeht
Hülfe	NN	3	Hülfe
tragen	VVPP, VVINF, VVFIN	3	getragen, tragen, trägt
Mädchen	NN	3	Mädchen
Gönner	NN	3	Gönner
brauchen	VVFIN, VVINF	3	brauche, brauchen, braucht
gefährlich	ADJD, ADJA	3	gefährlich, gefährlichste, gefährlichem
entschuldigen	VVFIN, VVINF	3	entschuldigt, entschuldigen
Fuß	NN	3	Fuß, Fuße, Füßen
diese	PDS	3	dieses
enthalten	VVPP, VVFIN	3	enthalten, enthielt
stellen	VVFIN, VVINF	3	stelle, stellen
wider	APPR	3	wider
Grund	NN	3	Grunde, Grund, Gründen
Sies	NN	3	Sies
legen	VVPP, VVFIN	3	gelegt, Legen
ankommen	VVPP, VVINF	3	angekommen, ankommen
schließen	VVINF, VVFIN	3	schließen, schließt
Garten	NN	3	Garten
Beweis	NN	3	Beweise, Beweis
Eigenschaft	NN	3	Eigenschaften
gönnen	VVINF, VVFIN	3	gönnen, Gönnen
schwarz	ADJA, ADJD	3	schwarze, schwarz
verschweigen	VVPP	3	verschwiegen
leiden	VVINF	3	leiden
erscheinen	VVPP, VVINF, VVFIN	3	erschienen, erscheinen, erscheine
verstehen	VVIMP, VVINF	3	versteh, verstehen
Hund	NN	3	Hundes, Hunde, Hund
selber	ADV	3	selber
ehrlich	ADJA	3	ehrlichen, ehrlicher
Unrecht	NN	3	Unrecht
versuchen	VVFIN, VVPP	3	versucht, versuchen
Weiberfeinde	NN	3	Weiberfeinde
Verdacht	NN	3	Verdacht
Gesellschaft	NN	3	Gesellschaft
schuldig	ADJD	3	schuldig
blind	ADJA, ADJD	3	blinden, blind
völlig	ADJA, ADJD	3	völligen, völlig
verheiraten	VVPP, VVINF	3	verheiratet, verheiraten
Name	NN	3	Namen
Furcht	NN	3	Furcht
Bitte	NN	3	Bitte
lernen	VVFIN, VVINF	3	lernt, lernen
bereits	ADV	3	bereits
einräumen	VVINF, VVFIN	3	einräumen, einräume
fallen|fällen	VVFIN	3	fällt
Mädel	NN	3	Mädel
Glücke	NN	3	Glücke
verdammt	ADJA	3	verdammten, verdammte
hochzuehrender	ADJA	3	hochzuehrender
sauer	ADJD	3	sauer, saurer
erschaffen	VVPP	3	erschaffen
Ankunft	NN	3	Ankunft
Falle	NN	3	Falle
erzeigen	VVINF, ADJD, VVFIN	3	erzeigen
schicken	VVINF	3	schicken
zuvor	ADV	3	zuvor
unangenehm	ADJD	3	unangenehm
nötig	ADJD, ADJA	3	nötig, nötiger
zuerst	ADV	3	zuerst
zanken	VVINF, VVFIN	3	zanken, zankt
breit	ADJD	3	breit
übel	ADJD	3	übel
alsdenn	VVFIN, VVIMP, NE	3	alsdenn
streiten	VVFIN	3	streiten
dreimal	ADV	3	dreimal
nötigen	VVINF	3	nötigen
ernsthaft	ADJD	3	ernsthaft
ersparen	VVINF, VVFIN	3	ersparen, erspare
heißen	VVFIN	3	heißt
Ei	NN	3	Ei
hassen	VVINF, VVFIN	3	hassen, hasse
zufrieden	ADJD	3	zufriedener, zufrieden
Erzählung	NN	3	Erzählung
ausgehen	VVPP, VVINF	3	ausgegangen, ausgehen
Freude	NN	3	Freude, Freuden
seh	NE, FM	3	seh
strafen	VVPP	3	gestraft
gefaßt	ADJD, ADJA	3	gefaßt, gefaßten
dadurch	PAV	3	dadurch
zusammen	ADV, PTKVZ	3	zusammen
Freundschaft	NN	3	Freundschaft
Gegenwart	NN	3	Gegenwart
Heirat	NN	3	Heirat
gehören|hören	VVPP	3	gehört
Wette	NN	3	Wette
Unglückliche	NN	3	Unglücklichen, Unglücklicher
acht	CARD	3	acht
Geheimnis	NN	3	Geheimnisse, Geheimnis
fallen|gefallen	VVPP	3	gefallen
Gewogenheit	NN	3	Gewogenheit
Nase	NN	3	Nase
mitgeben	VVINF	3	Mitgeben, mitgeben
Familie	NN	3	Familie
wetten	VVFIN	3	wette, wetten
Brief	NN	3	Briefe
Gut	NN	3	Gut
Ja	NN	3	Ja
zwischen	APPR	3	zwischen
liebenswürdig	ADJA	3	liebenswürdigen, Liebenswürdige, liebenswürdiger
Brautwerber	NN	3	Brautwerber
hoch	ADJA, ADJD	3	höchste, hohen, höher
wundern	VVFIN, VVINF	3	wundre, wunderten, wundern
Register	NN	3	Register
Hochedelgeborner	NN	3	Hochedelgeborner
eifersüchtig	ADJD	3	eifersüchtig, Eifersüchtig
liegen	VVFIN, VVPP	3	liegt, gelegen
Übel	NN	3	Übel
hinderlich	ADJD	3	hinderlich
dahin	PAV	3	dahin
aufrichtig	ADJD, ADJA	3	aufrichtig, aufrichtiges, aufrichtiger
ichs	ADJD	3	ichs
weisen	VVFIN, VVPP, VVINF	3	weisen, gewiesen
zurück	PTKVZ, ADV	3	zurück
vorstellen	VVPP, VVIZU, VVINF	3	vorgestellt, vorzustellen, vorstellen
gefallen	VVINF, VVFIN	3	gefallen, gefällt
Untreue	NN	3	Untreue
Wahrheit	NN	3	Wahrheit
scherzen	VVPP, VVFIN	3	gescherzt, scherzen, scherze
Freund	NN	3	Freunde, Freund
Kopf	NN	3	Kopf
weg	PTKVZ, ADV	3	weg
insonders	NN	3	insonders
treffen|triefen	VVPP	3	Getroffen, getroffen
geheim	ADJD, ADJA	3	geheim, geheime
hängen	VVPP, VVINF	3	gehangen, hängen
Vertrauen	NN	3	Vertrauen
Weiberfeindschaft	NN	3	Weiberfeindschaft
treten	VVFIN	3	Treten
Ihrigen	NN	3	Ihrigen
notwendig	ADJA, ADJD	3	notwendiges, notwendig
Ehe	NN	2	Ehen
nieder	PTKVZ, ADJD	2	nieder
Sprache	NN	2	Sprache
Schönheit	NN	2	Schönheit
Farbe	NN	2	Farbe
Wuchs	NN	2	Wuchs
Weibsbilde	NN	2	Weibsbilde
verfolgen	VVFIN, VVINF	2	verfolgt, verfolgen
derjenig	PDAT	2	demjenigen
ausfallen	VVINF, VVPP	2	ausfallen, ausgefallen
nichtswürdig	ADJA	2	nichtswürdigen, nichtswürdige
abtreten	VVPP, VVFIN	2	abgetreten, abtrete
wann	PWAV	2	wann
Junge	NN	2	Jungen
niemand	PIS	2	niemand, niemanden
beweisen	VVINF, VVFIN	2	beweisen, Beweisen
Scham	NN	2	Scham
wegkommen	VVPP, VVINF	2	weggekommen, wegkommen
Augenblick	NN	2	Augenblick, Augenblicke
verbindlich	ADJD	2	verbindlich
Frage	NN	2	Frage, Fragen
Weise	NN	2	Weise
Seite	NN	2	Seite
wahrscheinlich	ADJD	2	wahrscheinlicher
unterscheiden	VVINF, VVPP	2	unterscheiden, unterschieden
richten	VVFIN	2	richtete, richten
raten	VVFIN	2	raten, rate
Verkleidung	NN	2	Verkleidung
herkommen	VVINF	2	herkommen
albern	ADJD, ADJA	2	albern, albernes
Gang	NN	2	Gange
treu	ADJA	2	treuen, treuer
leugnen	VVINF	2	leugnen
Anschlag	NN	2	Anschlag
angenehm	ADJD, ADJA	2	angenehm, angenehmere
Einfall	NN	2	Einfall
gefangen	PTKVZ	2	gefangen
Macht	NN	2	Macht
daher	PAV, ADV	2	daher
weswegen	PWAV	2	weswegen
rechtschaffen	ADJA	2	rechtschaffenen
vielmehr	ADV	2	vielmehr
schwach	ADJD	2	schwach, schwächer
zuhalten	VVFIN, VVINF	2	zuhält, zuhalten
töricht	ADJD, ADJA	2	töricht, törichten
erhalten	VVINF, VVPP	2	erhalten
Handlung	NN	2	Handlung
Zweifel	NN	2	Zweifel
vergeb	VVFIN	2	vergeb
wenden	VVFIN, VVPP	2	wende, gewandt
unglücklich	ADJA, ADJD	2	unglückliches, unglücklich
Streit	NN	2	Streite, Streit
stoßen	VVFIN, VVINF	2	stieß, stoßen
Stolz	NN	2	Stolz
Zärtlichkeit	NN	2	Zärtlichkeit
Liebkosung	NN	2	Liebkosungen
Ha	NE	2	Ha
mehrere	PIS	2	mehreres
hundertmal	ADV	2	hundertmal
Grab	NN	2	Grab, Grabe
darunter	PAV	2	darunter
nochmals	ADV	2	nochmals
woran	PWAV	2	woran
vorkommen	VVINF, VVPP	2	vorkommen, vorgekommen
Bauer	NN	2	Bauer
behandeln	VVPP	2	behandelt
dritt	ADJA	2	dritten, dritte
bedienen	VVPP	2	bedient
Taler	NN	2	Taler
Uneinigkeit	NN	2	Uneinigkeit
nu	ITJ	2	Nu, nu
Aufrichtigkeit	NN	2	Aufrichtigkeit
gehorchen	VVINF	2	gehorchen
herzlich	ADJD	2	herzlich
schwerlich	ADJD	2	Schwerlich, schwerlich
Sachte	NN	2	Sachte
Gute	NN	2	Gutes, Guter
Nickel	NN	2	Nickels, Nickel
Gütigkeit	NN	2	Gütigkeit
Tölpel	NN	2	Tölpel
lesen	VVFIN, VVINF	2	lese, lesen
Sage	NN	2	Sage
stolz	ADJD	2	stolz
Verderben	NN	2	Verderbens
ungern	ADV	2	ungern
ärgern	VVINF, VVFIN	2	ärgern, ärgert
Probe	NN	2	Probe
bescheiden	ADJA, ADJD	2	bescheidenen, bescheiden
sobald	KOUS	2	Sobald
erweisen	VVINF, VVFIN	2	erweisen, erwies
aufhalten	VVIZU, VVINF	2	aufzuhalten, aufhalten
dachen	VVFIN	2	dacht
Schöne	NN	2	Schöne
Kurz	NE	2	Kurz
bemerken	VVINF, VVPP	2	bemerken, bemerkt
gehn	VVINF, VVFIN	2	gehn
erbitten	VVINF	2	erbitten
vertrauen	VVINF	2	vertrauen
Schätzbarste	NN	2	Schätzbarste
Ähnlichkeit	NN	2	Ähnlichkeit
betrachten	VVINF	2	betrachten
väterlich	ADJA	2	väterlichen, väterliche
unsre	PPOSAT	2	unsre, unsern
schreien	VVFIN, VVIMP	2	schreist, schrei
Wille	NN	2	Willen
Wert	NN	2	Wert, Werts
verzeihen	VVFIN	2	Verzeihen, verzeihen
entweder	KON	2	Entweder, entweder
Partes	NN	2	Partes
bisher	ADV	2	bisher, Bisher
sichs	NE	2	sichs
Kuppel|Kuppeln	NN	2	Kuppeln
Verbeugung	NN	2	Verbeugung
triumphierend	ADJA	2	triumphierenden
ein	PTKVZ	2	ein
Mund	NN	2	Mund
zugleich	ADV	2	zugleich
Höflichkeit	NN	2	Höflichkeit
öffentlich	ADJD, ADJA	2	öffentlich, öffentlichen
bereden	VVINF	2	bereden
begegnen	VVINF	2	begegnen
geschickt	ADJD	2	geschickt
Nebenbuhler	NN	2	Nebenbuhler
Gebieterin	NN	2	Gebieterin
Neigung	NN	2	Neigung
stark	ADJD	2	stark, stärker
Küche	NN	2	Küche
Aufwartung	NN	2	Aufwartung
erinnern	VVINF, VVPP	2	erinnern, erinnert
Schwager	NN	2	Schwager
heftig	ADJD	2	heftiger, heftig
verdrüßlichen	ADJA	2	verdrüßlichen
dienen	VVINF, VVPP	2	dienen, gedient
Äußerlichen	NN	2	Äußerlichen
empfindlich	ADJA	2	empfindliches, empfindliche
gestehen|stehen	VVPP	2	gestanden
Schlimme	NN	2	Schlimmen
laut	ADJD	2	lauter, laut
frei	ADJD	2	frei
Liebhaber	NN	2	Liebhaber
aufzuwickeln	ADJD, VVIZU	2	aufzuwickeln
zweimal	ADV	2	zweimal
Türe	NN	2	Türe
leid	ADJD	2	leid
meist	PIAT	2	meisten
wohnen	VVPP, VVINF	2	gewohnt, wohnen
Tod	NN	2	Tode
darum	PAV	2	darum
Gewissen	NN	2	Gewissen
Ebenbild	NN	2	Ebenbild, Ebenbilde
mirs	ADJD	2	mirs
edel	ADJD, ADJA	2	edel, edle
hochschätze	NN	2	hochschätze
irren	VVFIN	2	irren
Augenschein	NN	2	Augenschein
rasend	ADJD, ADJA	2	rasend, rasenden
Vorschlag	NN	2	Vorschlage, Vorschlag
versehen	VVFIN, VVPP	2	versah, versehen
abhalten	VVINF, VVPP	2	abhalten, abgehalten
insgesamt	ADV	2	insgesamt
ihrentwegen	ADV	2	ihrentwegen
verschieden	ADJD, ADJA	2	verschieden, verschiedene
vertauschen	VVPP, VVINF	2	vertauscht, vertauschen
weitläuftig	ADJD	2	weitläuftig
nimmermehr	ADV	2	nimmermehr
dann	ADV	2	dann
überall	ADV	2	überall
Vergebung	NN	2	Vergebung
schamrot	ADJD	2	schamrot
Vollkommenheiten	NN	2	Vollkommenheiten
meinig	PPOSS	2	meinigen, meinige
hitzig	ADJA, ADJD	2	hitzigen, hitzig
Achtung	NN	2	Achtung
zerreißen	VVPP, VVFIN	2	zerrissen, zerreißen
frisch	ADJA	2	frischen, frische
küssen	VVFIN	2	küßt
hin	PTKVZ	2	hin
lachen	VVINF, VVFIN	2	lachen, Lachen
arg	ADJD, ADJA	2	ärger, ärgster
Anschlage	NN	2	Anschlage
Gesichtsbildung	NN	2	Gesichtsbildung
Fehler	NN	2	Fehler
zwingen	VVINF	2	zwingen
vergehen	VVFIN, VVINF	2	vergeht, vergehen
weder	KON	2	weder
bestärken	VVPP	2	bestärkt
unschuldig	ADJA	2	unschuldigen
verdrüßlich	ADJD	2	verdrüßlich
ungehalten	ADJD	2	ungehalten
bedachen|bedenken	VVPP	2	bedacht
andermal	ADV	2	andermal
fällen	VVPP	2	gefällt
künftig	ADJA	2	künftigen
Rate	NN	2	Rate
Dienst	NN	2	Dienste, Dienst
Wiedersehen	NN	2	Wiedersehen
offenbar	ADJD, ADJA	2	offenbar, offenbare
Schicksal	NN	2	Schicksal
Anverwandte	NN	2	Anverwandten
Feind	NN	2	Feind
besorgen	VVFIN	2	besorgen, besorge
erlangen	VVPP, VVINF	2	erlangt, erlangen
verständig	ADJD, ADJA	2	verständiger
häuslich	ADJA	2	häuslichen
prozessieren	VVINF	2	prozessieren
hieher	NN	2	hieher
holen	VVPP, VVFIN	2	geholt, hole
verwirren	VVFIN, VVINF	2	verwirrt, verwirren
Leben	NN	2	Leben
zuversichtlich	ADJD	2	zuversichtlich
Komödienschreiber	NN	2	Komödienschreiber
eigensinnig	ADJD, ADJA	2	eigensinnig, eigensinnigen
Hut	NN	2	Hut
befehlen	VVFIN, VVINF	2	befehlen
verschonen	VVFIN	2	verschonen
gerecht	ADJA	2	gerechteste
schmeicheln	VVINF, VVFIN	2	schmeicheln, schmeichle
Mademoisell	ADJD, VVFIN	2	Mademoisell
Sinn	NN	2	Sinne
morgen	ADV	2	morgen, Morgen
unbekannt	ADJA	2	unbekannten
aussetzen	VVINF, VVIZU	2	aussetzen, auszusetzen
ablaufen	VVPP, VVINF	2	abgelaufen, ablaufen
Ähnliche	NN	2	Ähnliches
geraten	VVFIN	2	geriet, geraten
heraus	PTKVZ, ADV	2	heraus
vorgegeben	ADJA	2	vorgegebenen, vorgegebene
einnehmen	VVPP, VVIZU	2	eingenommen, einzunehmen
wunderlich	ADJD, ADJA	2	wunderlich, wunderlichen
verwünscht	ADJA	2	verwünschte
hässlich	ADJA, ADJD	2	häßlichen, häßlich
einbilden	VVINF	2	einbilden
Zuflucht	NN	2	Zuflucht
Schluss	NN	2	Schluß, Schlüsse
hierin	PAV	2	hierin
Kaufmann	NN	2	Kaufmann
Schelm	NN	2	Schelm
trauen	VVINF, VVFIN	2	trauen
Hatten	NN	2	Hatten
Blumenstrauße	NN	2	Blumenstrauße
Rolle	NN	2	Rolle
sträflich	ADJA, ADJD	2	sträflichen, sträflicher
heimlich	ADJD	2	heimlich
Sentenz	NN	2	Sentenz
Hoffnung	NN	2	Hoffnung
ziehen	VVPP	2	gezogen
verstellen	VVPP, VVINF	2	verstellt, verstellen
Reiz	NN	2	Reize
womit	PWAV	2	Womit, womit
wünschen	VVFIN	2	wünscht, wünschte
feurig	ADJD	2	feurig
Maul	NN	2	Maul, Maule
hiervon	PAV	2	hiervon
eins	CARD	2	eins
Bildung	NN	2	Bildung
Lebhaftigkeit	NN	2	Lebhaftigkeit
Amt	NN	2	Amt, Amte
melden	VVINF	2	melden
aussterben	VVINF	2	aussterben
Gehülfin	NN	2	Gehülfin
Unsinnigkeit	NN	2	Unsinnigkeit
Respekt	NN	1	Respekt
Einkauf	NN	1	Einkauf
derb	ADJA	1	derbe
gehaben	VVFIN	1	gehabt
Kleid	NN	1	Kleider
euerm	ADJA	1	euerm
kömmts	VVFIN	1	kömmts
dasselb	PDAT	1	dasselbe
Klient	NN	1	Klienten
Platz	NN	1	Platz
mäßig	ADJA	1	mäßigen
schönern	NN	1	schönern
Jungfergesichtchen	NN	1	Jungfergesichtchen
gerade	ADV	1	gerade
vertraut	ADJA	1	vertraute
pflegen	VVFIN	1	pflegen
Denkungsart	NN	1	Denkungsart
Gasse	NN	1	Gassen
zweideutig	ADJD	1	zweideutig
Fortspielen	NN	1	Fortspielen
Handelsmann	NN	1	Handelsmann
desperat	ADJA	1	desperaten
Unzeit	NN	1	Unzeit
angefangen	ADJA	1	angefangene
fleißig	ADJD	1	fleißig
Flattergeist	NN	1	Flattergeist
Kindheit	NN	1	Kindheit
nachdenken	VVFIN	1	nachdenke
Krähe	NN	1	Krähe
toll	ADJD	1	toll
annehmen	VVINF	1	annehmen
neu	ADJA	1	neue
begucken	VVFIN	1	begucken
allzuwohl	ADJD	1	allzuwohl
speien	VVFIN	1	speit
Vorteil	NN	1	Vorteil
übermäßig	ADJA	1	übermäßiger
anstatt	KOUI	1	Anstatt
Mangel	NN	1	Mangel
gesinnt	ADJD	1	gesinnt
putzen	VVPP	1	geputzt
erfreuen	VVPP	1	erfreut
Frist	NN	1	Frist
Gefälligkeit	NN	1	Gefälligkeit
zutun	VVPP	1	zugetan
einigen	VVFIN	1	einige
Plaudern	NN	1	Plaudern
Stutzerchen	NN	1	Stutzerchen
warm	ADJD	1	warm
Stube	NN	1	Stube
Geschäft	NN	1	Geschäften
untreu	ADJD	1	untreu
Habit	NN	1	Habit
trotz	APPR	1	Trotz
springen	VVFIN	1	springe
Vorbereitung	NN	1	Vorbereitungen
sterben	VVFIN	1	starb
satt	ADJD	1	satt
Maskerade	NN	1	Maskerade
Ungewisse	NN	1	Ungewisses
überhaupt	ADV	1	überhaupt
standhaft	ADJD	1	standhaft
billig	ADJD	1	billig
außerordentlich	ADJD	1	außerordentlich
antreffen	VVINF	1	antreffen
hoffnungslos	ADJA	1	hoffnungslose
Monat	NN	1	Monat
Trost	NN	1	Trost
Glückliche	NN	1	Glücklichen
Allzuglücklicher	NN	1	Allzuglücklicher
Gestalt	NN	1	Gestalt
mitnehmen	VVINF	1	mitnehmen
Haushaltung	NN	1	Haushaltung
falsch	ADJA	1	falschen
europäisch	ADJA	1	Europäische
Antrag	NN	1	Antrag
Maske	NN	1	Maske
demütig	ADJA	1	demütigste
erschrecklich	ADJD	1	erschrecklich
befreiet	ADJD	1	befreiet
Klotz	NN	1	Klotz
verabscheuen	VVINF	1	verabscheuen
erwidern	VVFIN	1	erwidert
Gehn	VVFIN	1	Gehn
Stirne	NN	1	Stirne
abziehen	VVPP	1	abgezogen
behutsamsten	ADJA	1	behutsamsten
voraussetzen	VVFIN	1	voraussetzt
Beitrag	NN	1	Beitrag
Schulter|Schultern	NN	1	Schultern
Mühle	NN	1	Mühle
Anpreisung	NN	1	Anpreisung
Köpfchen	NN	1	Köpfchen
Hure	NN	1	Hure
unterstehst	VVFIN	1	unterstehst
Ehekriepel	NN	1	Ehekriepel
geliebt	ADJA	1	geliebte
weniger	ADV	1	weniger
ange	ADJD	1	ange
vorbereiten	VVINF	1	vorbereiten
betauerten	ADJD	1	betauerten
Mannskleidern	NN	1	Mannskleidern
kömmst	VVFIN	1	kömmst
Ernste	NN	1	Ernste
glaßierten	ADJA	1	glaßierten
mürrisch	ADJA	1	mürrischen
einen	ADJA	1	einen
tot	ADJD	1	tot
innerlich	ADJA	1	innerlichen
Vexieren	VVFIN	1	Vexieren
leichtsinnig	ADJD	1	leichtsinnig
nahe	APPR	1	nahe
formell	ADJA	1	formellen
galant	ADJD	1	galant
Sternchen	NN	1	Sternchen
Nichtswürdiges	NN	1	Nichtswürdiges
bedanken	VVFIN	1	bedanke
Gleichgültigkeit	NN	1	Gleichgültigkeit
Nichtswürdigen	NN	1	Nichtswürdigen
See	NN	1	See
vorziehen	VVFIN	1	vorziehe
bestrafen	VVPP	1	bestraft
Mitleid	NN	1	Mitleid
Unmöglichkeit	NN	1	Unmöglichkeit
Einfalt	NN	1	Einfalt
lästern	VVINF	1	lästern
genennt	VVFIN	1	genennt
besuchen	VVINF	1	besuchen
Grille|Grillen	NN	1	Grillen
Kanzeleistile	NN	1	Kanzeleistile
vorbauen	VVINF	1	vorbauen
auslernen	VVPP	1	ausgelernt
menschlich	ADJD	1	menschlicher
unbeantwortet	ADJD	1	unbeantwortet
Räuber	NN	1	Räuber
nämlich	ADV	1	nämlich
komplimentieren	VVPP	1	komplimentiert
Ihrentwegen	NN	1	Ihrentwegen
Verbindung	NN	1	Verbindung
mengen	VVFIN	1	mengt
Verführung	NN	1	Verführungen
getreu	ADJA	1	getreue
Königin	NN	1	Königin
verwelkt	ADJA	1	verwelkten
Reputation	NN	1	Reputation
deponiert	ADJA	1	deponierten
jede	PIAT	1	Jeder
schimpflich	ADJD	1	schimpflich
wachsen	VVPP	1	gewachsen
Hippia	NN	1	Hippia
ausführen	VVINF	1	ausführen
heraussagen	VVINF	1	heraussagen
Biß	NN	1	Bissen
rufen	VVFIN	1	ruft
schadlos	ADJD	1	schadlos
Entschuldigung	NN	1	Entschuldigungen
Sprüchelchen	NN	1	Sprüchelchen
trocknen	VVFIN	1	trocknen
geraten|raten	VVPP	1	geraten
Konzept	NN	1	Konzepte
Tollhaus	NN	1	Tollhaus
Wendung	NN	1	Wendung
Vergleichung	NN	1	Vergleichung
Vertraute	NN	1	Vertrauten
aufbinden	VVINF	1	aufbinden
selig	ADJA	1	selige
Geschöpf	NN	1	Geschöpf
fest	ADJD	1	fest
zänkisch	ADJD	1	zänkisch
Hälfte	NN	1	Hälfte
verflucht	ADJA	1	verfluchte
geschweige	ADV	1	geschweige
Valerens	NE	1	Valerens
Eroberung	NN	1	Eroberung
wenig	ADV	1	wenig
beklag	VVFIN	1	beklag
frostig	ADJD	1	frostig
vernünftig	ADJD	1	vernünftig
Trunkenheit	NN	1	Trunkenheit
manche	PIAT	1	manchen
worein	PWAV	1	worein
jetzo	ADJA	1	jetzo
eheste	ADJA	1	eheste
ohngefähr	ADJD	1	ohngefähr
Flamme	NN	1	Flamme
Gratulationsrede	NN	1	Gratulationsrede
billiget	VVFIN	1	billiget
Tugend	NN	1	Tugend
Dieserwegen	ADJD	1	Dieserwegen
Leidenschaft	NN	1	Leidenschaft
einstecken	VVINF	1	einstecken
beschweren	VVFIN	1	beschweren
hierher	PAV	1	hierher
Geier	NN	1	Geier
begehren	VVINF	1	begehren
Kinderlehren	NN	1	Kinderlehren
mannbaren	ADJA	1	mannbaren
widerfahren	VVINF	1	widerfahren
beneiden	VVINF	1	beneiden
entbrechen	ADJD	1	entbrechen
Dixi	NE	1	Dixi
Punkt	NN	1	Punkt
Hu	NE	1	Hu
Glied	NN	1	Glieder
zeihen	VVFIN	1	Zieh
Befürchten	NN	1	Befürchten
vertraulich	ADJD	1	vertraulich
Allerschlimmste	NN	1	Allerschlimmste
Bräutigam	NN	1	Bräutigams
Nachsicht	NN	1	Nachsicht
stecken	VVINF	1	stecken
plaudre	VVFIN	1	plaudre
denken|gedenken	VVPP	1	gedacht
Komödie	NN	1	Komödie
Geschichte	NN	1	Geschichte
Billigkeit	NN	1	Billigkeit
unbillig	ADJD	1	unbillig
sechst	ADJA	1	sechsten
Verbindlichkeit	NN	1	Verbindlichkeiten
ausgezischt	VVPP	1	ausgezischt
Sirene	NN	1	Sirene
vorstehen	VVIZU	1	vorzustehen
mitbringen	VVPP	1	mitgebracht
Saufeja	NN	1	Saufeja
deinig	PPOSS	1	Deinige
beschwerlich	ADJA	1	beschwerlichen
aufnehmen	VVPP	1	aufgenommen
verantworten	VVINF	1	verantworten
Schelmerei	NN	1	Schelmereien
Stück	NN	1	Stücke
Eheleute	NN	1	Eheleute
Schwachheit	NN	1	Schwachheit
Bißchen	NN	1	Bißchen
Dorfschaft	NN	1	Dorfschaft
Ehemann	NN	1	Ehemann
törichste	ADJA	1	törichste
bekehren	VVPP	1	bekehrt
erholen	VVFIN	1	erhole
Freundin	NN	1	Freundin
Verstellung	NN	1	Verstellung
stutzen	VVFIN	1	stutzen
Erstaunen	NN	1	Erstaunen
unbesonnen	ADJA	1	unbesonnene
Frieden	NN	1	Frieden
ruhmredig	ADJD	1	ruhmredig
scharf	ADJD	1	scharf
Pferd	NN	1	Pferd
Stimme|Stimmen	NN	1	Stimmen
verwünschtes	ADJA	1	verwünschtes
Vaterstadt	NN	1	Vaterstadt
rot	ADJA	1	roten
geheiligt	ADJA	1	geheiligten
Verstellen	NN	1	Verstellen
quälen	VVINF	1	quälen
uneben	ADJA	1	unebene
Ansatz	NN	1	Ansatz
Hang|Hängen	NN	1	Hängen
Juvenals	NN	1	Juvenals
verliebt	ADJA	1	verliebtes
Referenz	NN	1	Referenz
applizieren	VVINF	1	applizieren
mehrern	ADJA	1	mehrern
sinnreichste	ADJA	1	sinnreichste
Testimoniis	NN	1	Testimoniis
entzücken	VVFIN	1	entzücken
Nachahmung	NN	1	Nachahmung
Wen	NE	1	Wen
dienstfertig	ADJA	1	dienstfertige
schmerzlich	ADJA	1	schmerzliche
bezeugen	VVFIN	1	bezeuge
Rand	NN	1	Rande
Wahn	NN	1	Wahne
zuvorkommen	VVINF	1	zuvorkommen
Narrenspossen	NN	1	Narrenspossen
Groll	NN	1	Groll
Vermögen	NN	1	Vermögen
dreimalig	ADJA	1	dreimaligen
Gesperre	NN	1	Gesperre
Vernehmen	NN	1	Vernehmen
platterdings	ADJD	1	platterdings
Ehestand	NN	1	Ehestand
Lebenslauf	NN	1	Lebenslauf
Tugendsame	ADJA	1	Tugendsame
beherrschen	VVPP	1	beherrscht
Weiberfeinds	NN	1	Weiberfeinds
verwundern	VVINF	1	verwundern
Herrchen	NN	1	Herrchen
kanns	NN	1	kanns
Dach	NN	1	Dache
Lidio	NE	1	Lidio
verlieben	VVPP	1	verliebt
Handschuh	NN	1	Handschuh
Posse	NN	1	Possen
worüber	PWAV	1	worüber
Eva	NE	1	Eva
würdigen	VVINF	1	würdigen
Wirkung	NN	1	Wirkungen
Weibsstück	NN	1	Weibsstück
anstehen	VVINF	1	anstehen
Schreiber	NN	1	Schreiber
Höflichkeitsbezeigungen	NN	1	Höflichkeitsbezeigungen
beantworten	VVINF	1	beantworten
Narrn	NN	1	Narrn
durchdringend	ADJD	1	durchdringend
zusammenfährst	VVFIN	1	zusammenfährst
eintreiben	VVPP	1	eingetrieben
Contentis	NN	1	Contentis
unwidersprechlich	ADJD	1	unwidersprechlich
Schuh	NN	1	Schuhen
schlimm	ADJA	1	Schlimmste
Wurzel	NN	1	Wurzeln
aufgeworfen	ADJA	1	aufgeworfene
Namenstag	NN	1	Namenstag
Vormittag	NN	1	Vormittags
betrügen	VVPP	1	betrogen
ungehudelt	ADJD	1	ungehudelt
Zoll	NN	1	Zoll
meiste	PIS	1	meisten
Geck	NN	1	Geck
kehren	VVFIN	1	kehren
gewürdiget	VVPP	1	gewürdiget
ruhen	VVINF	1	ruhen
irre	ADJD	1	irre
Weibsvolk	NN	1	Weibsvolk
spielen	VVPP	1	gespielt
erwerben	VVINF	1	erwerben
Strick|Stricken	NN	1	Stricken
drücken	VVINF	1	drücken
Gerechtigkeit	NN	1	Gerechtigkeit
kosen|kosten	VVFIN	1	koste
Gleichnis	NN	1	Gleichnis
abzulocken	VVIZU	1	abzulocken
auftragen	VVPP	1	aufgetragen
bekömmt	VVFIN	1	bekömmt
ernstlich	ADJD	1	ernstlich
rechtswegen	ADJA	1	rechtswegen
Prozent	NN	1	Prozent
Verräter	NN	1	Verräter
betriegen	ADJA	1	betriegen
Wesen	NN	1	Wesen
Dummkopf	NN	1	Dummkopf
Felsenherz	NN	1	Felsenherz
Stand	NN	1	Stande
ihrige	PPOSAT	1	Ihrige
Geschichtbücher	NN	1	Geschichtbücher
zukehren	VVIZU	1	zuzukehren
wirds	VVFIN	1	wirds
bessern	VVPP	1	gebessert
scheinend	ADJA	1	scheinenden
doppelt	ADJA	1	doppelte
aufheben	VVINF	1	aufheben
Schattenspiel	NN	1	Schattenspiel
befinden	VVPP	1	befunden
schlagen	VVPP	1	geschlagen
ausgeredt	ADJD	1	ausgeredt
vermengen	VVINF	1	vermengen
ewig	ADJD	1	ewig
ungetreu	ADJA	1	ungetreuen
Feuer	NN	1	Feuer
unterlassen	VVPP	1	unterlassen
erzahlt	VVPP	1	erzahlt
verraten	VVPP	1	verraten
wert	ADJD	1	wert
freuen	VVINF	1	freuen
sechs	CARD	1	sechs
beschämen	VVPP	1	beschämt
Hiobs	NN	1	Hiobs
Schrecken	NN	1	Schrecken
abfassen	VVINF	1	abfassen
werdend	ADJA	1	werdenden
pro	APPR	1	pro
Hohn	NN	1	Hohn
weibbaren	ADJA	1	weibbaren
Hals	NN	1	Hals
unbedachtsam	ADJD	1	unbedachtsam
fertig	ADJD	1	fertig
Wunderwerk	NN	1	Wunderwerke
Verehrer	NN	1	Verehrer
Angst	NN	1	Angst
Mitleiden	NN	1	Mitleiden
ohnedem	ADJD	1	ohnedem
erbärmlich	ADJD	1	erbärmlich
nachsehen	VVINF	1	nachsehen
jedermann	PIS	1	jedermann
einsehen	VVINF	1	einsehen
Weg	NN	1	Wege
Kömmt	NN	1	Kömmt
ernähren	VVINF	1	ernähren
fasset	VVFIN	1	fasset
eigen	ADJA	1	eignen
erstlich	ADJD	1	erstlich
dick	ADJA	1	dicke
unerbrochen	ADJD	1	unerbrochen
Lektion	NN	1	Lektion
Gelehrte	NN	1	Gelehrten
bekümmern	VVINF	1	bekümmern
großmütig	ADJD	1	großmütig
Beistand	NN	1	Beistandes
vorzüglich	ADJA	1	vorzüglicher
Jesabel	NE	1	Jesabel
gleichgültiger	ADJD	1	gleichgültiger
verdienest	VVFIN	1	verdienest
ungebetne	ADJA	1	ungebetne
schwer	ADJD	1	schwer
ungeziemenden	ADJA	1	ungeziemenden
Ornate	NN	1	Ornate
erkundigen	VVINF	1	erkundigen
Babylon	NE	1	Babylon
Kröte	NN	1	Kröten
barbarisch	ADJA	1	Barbarische
Huldigung	NN	1	Huldigung
anbelangen	VVPP	1	anbelangt
zugegen	ADJD	1	zugegen
Zwang	NN	1	Zwang
herschicken	VVINF	1	herschicken
messen	VVPP	1	gemessen
teuer	ADJA	1	teuerste
Verblendung	NN	1	Verblendung
gedulden	VVFIN	1	gedulden
Werk	NN	1	Werke
Ehekontrakt	NN	1	Ehekontrakt
Grimasse	NN	1	Grimassen
entschließen	VVPP	1	entschlossen
auspreßte	VVFIN	1	auspreßte
herum	PTKVZ	1	herum
Ungehorsam	NN	1	Ungehorsam
leiten	VVFIN	1	leitete
Contenta	NN	1	Contenta
schwächen	VVINF	1	schwächen
Plane	NN	1	Plane
Akt|Akte	NN	1	Akten
herausreißen	VVINF	1	herausreißen
leer	ADJA	1	leeren
steuern	VVFIN	1	steure
vergaffte	VVFIN	1	vergaffte
Unbekannte	NN	1	Unbekannten
Busen	NN	1	Busen
nah	ADJA	1	nähere
Verfahren	NN	1	Verfahren
bieten	VVINF	1	bieten
entstehen	VVINF	1	entstehen
aussehen	VVINF	1	aussehen
Ort|Orten	NN	1	Orten
Ruf|Rufen	NN	1	Rufen
verstehn	VVFIN	1	verstehn
schonen	VVINF	1	schonen
Bravo	NN	1	Bravo
vergelten	VVFIN	1	Vergilt
Eigennützigen	NN	1	Eigennützigen
durchs	APPRART	1	durchs
anständig	ADJD	1	anständig
bemühen	VVINF	1	bemühen
Sorge|Sorgen	NN	1	Sorgen
erstaunlich	ADJA	1	erstaunliche
orationis	NE	1	orationis
bereuet	VVFIN	1	bereuet
artig	ADJA	1	artige
steuren	ADJD	1	steuren
nochmalig	ADJA	1	nochmaligen
Rednergesellschaft	NN	1	Rednergesellschaft
widerspenstig	ADJD	1	widerspenstig
Leutchen	NN	1	Leutchen
ach	ITJ	1	Ach
verzehren	VVINF	1	verzehren
Medullina	NE	1	Medullina
ausreden	VVINF	1	ausreden
verüben	VVINF	1	verüben
diejenigen	PDS	1	diejenigen
Meinung	NN	1	Meinung
rühmen	VVINF	1	rühmen
anstellen	VVINF	1	anstellen
wegschneiden	VVPP	1	weggeschnitten
empfinden	VVINF	1	empfinden
Nu	NN	1	Nu
ehe	KOUS	1	ehe
Zweck	NN	1	Zwecke
Hochzeitkarmen	NN	1	Hochzeitkarmen
euer	PPOSAT	1	euren
täglich	ADJD	1	täglich
überzeugt	ADJD	1	überzeugt
Zuneigung	NN	1	Zuneigung
Zeichen	NN	1	Zeichen
hochöchst	ADJD	1	höchst
gesellschaftlich	ADJA	1	gesellschaftliche
Schulter	NN	1	Schulter
eingehen	VVINF	1	eingehen
Vorbeigehen	NN	1	Vorbeigehen
vertrackt	ADJD	1	vertrackt
Tropfen	NN	1	Tropfen
Hof	NN	1	Hof
erlangt	ADJA	1	erlangten
Gelichters	NN	1	Gelichters
ah	ITJ	1	Ah
allzugleichgültig	ADJD	1	allzugleichgültig
worauf	PWAV	1	worauf
vorsagen	VVPP	1	vorgesagt
eigentlich	ADV	1	eigentlich
schätzen	VVINF	1	schätzen
gesetzt	ADJD	1	gesetzt
etwan	NE	1	etwan
Entzückung	NN	1	Entzückung
müde	ADJD	1	müde
Schwindsucht	NN	1	Schwindsucht
Aufzug	NN	1	Aufzug
Fama	NN	1	Fama
Ehr-	TRUNC	1	Ehr-
Eltern	NN	1	Eltern
Schuppe|Schuppen	NN	1	Schuppen
Bitte|Bitten	NN	1	Bitten
schmächtig	ADJD	1	schmächtiger
überflüssig	ADJA	1	überflüssige
Kuppelpelz	NN	1	Kuppelpelz
wohin	PWAV	1	wohin
Kommen	NN	1	Kommen
hinein	ADV	1	hinein
Sturm	NN	1	Sturm
niedergehen	VVFIN	1	niedergehen
Koller	NN	1	Koller
Ehescheidungsprozessen	NN	1	Ehescheidungsprozessen
Rücken	NN	1	Rücken
Kleinigkeit	NN	1	Kleinigkeit
immerhin	ADV	1	Immerhin
Daumen	NN	1	Daumen
Strafe	NN	1	Strafe
unterstehen	VVPP	1	unterstanden
unerträglich	ADJD	1	unerträglich
allzutiefe	ADJA	1	allzutiefe
Verzeihung	NN	1	Verzeihung
hinaus	PTKVZ	1	hinaus
hauen	VVFIN	1	haue
Lehre	NN	1	Lehre
grausam	ADJA	1	Grausame
einigermaßen	ADV	1	einigermaßen
verzweifelt	ADJA	1	verzweifelten
andeuten	VVIZU	1	anzudeuten
Auktionatorstimme	NN	1	Auktionatorstimme
Wirds	NN	1	Wirds
Verdienst	NN	1	Verdienste
eilen	VVINF	1	eilen
Unternehmen	NN	1	Unternehmens
wahrnehmen	VVINF	1	wahrnehmen
übern	APPRART	1	übern
belangen	VVINF	1	belangen
nachkommen	VVINF	1	nachkommen
Schminke	NN	1	Schminke
aufs	APPRART	1	aufs
rächen	VVFIN	1	rächt
Tobias	NE	1	Tobias
abbringen	VVINF	1	abbringen
äußer	ADJA	1	äußerstes
Schrei|Schreien	NN	1	Schreien
Ins	NE	1	Ins
weißen	VVFIN	1	weißt
gesucht	ADJA	1	gesuchte
ohngeachtet	NN	1	ohngeachtet
Wade	NN	1	Waden
bedeutend	ADJA	1	bedeutenden
zumal	KOUS	1	zumal
anbringen	VVINF	1	anbringen
aushacken	VVINF	1	aushacken
widersprechen	VVINF	1	widersprechen
Fleisch	NN	1	Fleisch
Meisterstück	NN	1	Meisterstück
werfen	VVPP	1	geworfen
Männerfeindin	NN	1	Männerfeindin
unzählig	ADJA	1	unzählige
deutlich	ADJD	1	deutlicher
zehnmal	ADV	1	zehnmal
Biss	NN	1	Bisse
kaufen	VVFIN	1	kaufe
Zacharias	NE	1	Zacharias
listig	ADJA	1	listigste
Realität	NN	1	Realitäten
Weibsperson	NN	1	Weibsperson
gleichsam	ADJD	1	gleichsam
behüten	VVFIN	1	Behüte
Wischiwaschi	NN	1	Wischiwaschi
Hass	NN	1	Hasse
Fuchs	NN	1	Fuchs
Absatz	NN	1	Absätze
Rat	NN	1	Rat
diejenig	PDAT	1	diejenige
Lippe	NN	1	Lippe
Schiffbruch	NN	1	Schiffbruchs
dazukömmt	VVFIN	1	dazukömmt
hart	ADJD	1	hart
unbewusst	ADJA	1	unbewußte
zugestehen	VVINF	1	zugestehen
Zeugnis	NN	1	Zeugnis
leichtfertig	ADJA	1	leichtfertige
hoffentlich	ADV	1	hoffentlich
Messalina	NN	1	Messalina
Muster	NN	1	Muster
heuen	VVFIN	1	heut
ahnden	VVFIN	1	ahndet
Witwe	NN	1	Witwe
sonnenklar	ADJD	1	sonnenklar
Muße	NN	1	Muße
Schatz	NN	1	Schatz
Schritt	NN	1	Schritt
unruhig	ADJD	1	unruhig
hinsehen	VVFIN	1	hinsah
Knoten	NN	1	Knoten
Henker	NN	1	Henker
aufgehen	VVFIN	1	aufgingen
Handel	NN	1	Handel
wofür	PWAV	1	wofür
Märchen	NN	1	Märchen
betagt	ADJA	1	betagten
nennen	VVINF	1	nennen
jen	PDS	1	jenes
Cäsonia	NE	1	Cäsonia
Aufführung	NN	1	Aufführung
schlank	ADJD	1	schlanker
unverschämt	ADJD	1	unverschämt
Haustüre	NN	1	Haustüre
Närrin	NN	1	Närrin
Sprüchworte	NN	1	Sprüchworte
wenigmale	NN	1	wenigmale
äußern	VVINF	1	äußern
Schranke	NN	1	Schranken
mangeln	VVINF	1	mangeln
Seine	NE	1	Seine
begierig	ADJD	1	begierig
unterdrücken	VVINF	1	unterdrücken
überlassen	VVINF	1	überlassen
Peruque	NE	1	Peruque
verschulden	VVPP	1	verschuldet
Zuschauer	NN	1	Zuschauer
nachlesen	VVPP	1	nachgelesen
seufzet	VVFIN	1	seufzet
ehrfurchtsvollen	ADJA	1	ehrfurchtsvollen
Freiheit	NN	1	Freiheit
miteinander	ADV	1	miteinander
reuet	VVFIN	1	reuet
irgend	ADV	1	irgend
Großmut	NN	1	Großmut
Gleis	NN	1	Gleise
Narrheit	NN	1	Narrheit
vergnügt	ADJD	1	vergnügt
Sekretär	NN	1	Sekretär
verschlagenste	NN	1	verschlagenste
Notwendigkeit	NN	1	Notwendigkeit
gelb	ADJA	1	gelben
Schwägerin	NN	1	Schwägerin
treiben	VVFIN	1	treiben
Sorge	NN	1	Sorge
allerlieb	ADJA	1	allerliebster
sechstausend	CARD	1	sechstausend
exklamieren	VVINF	1	exklamieren
schwimmen	VVFIN	1	schwamm
manchmal	ADV	1	manchmal
muten	VVFIN	1	mute
abschläglichen	ADJA	1	abschläglichen
Spitzenkrause	NN	1	Spitzenkrause
Ausspruch	NN	1	Ausspruch
aufschlagen	VVINF	1	aufschlagen
Orator	NN	1	Orator
vorhersagen	VVPP	1	vorhergesagt
Kinn	NN	1	Kinn
gebietrischer	ADJA	1	gebietrischer
wohlgeraten	ADJA	1	wohlgeratene
Ansuchen	NN	1	Ansuchen
Suche|Suchen	NN	1	Suchen
Zank	NN	1	Zank
weislich	ADJD	1	weislich
Leibt	ADJD	1	Leibt
mühselig	ADJA	1	mühseligen
Zusammenkunft	NN	1	Zusammenkunft
unange	ADJD	1	unange
Schlimmste	NN	1	Schlimmste
Natur	NN	1	Natur
beleidigen	VVINF	1	beleidigen
Gickelgackel	NN	1	Gickelgackel
hegen	VVFIN	1	hege
trügen	VVFIN	1	trügt
bewegen	VVINF	1	bewegen
Ruin	NN	1	Ruin
herein	ADV	1	herein
Raserei	NN	1	Raserei
Rückzuge	NN	1	Rückzuge
künftger	ADJA	1	künftger
Ehrerbietigkeit	NN	1	Ehrerbietigkeit
fliegend	ADJA	1	fliegender
scheinet	VVFIN	1	scheinet
scheinen	VVFIN	1	scheinen
auszahlen	VVPP	1	ausgezahlt
ungewiss	ADJA	1	Ungewissen
Ufer	NN	1	Ufer
Kummer	NE	1	Kummer
gehts	VVFIN	1	gehts
hochschätzen	VVPP	1	hochgeschätzt
Vornehmste	NN	1	Vornehmste
Staat	NN	1	Staat
verändert	ADJD	1	verändert
Last	NN	1	Last
abweisen	VVPP	1	abgewiesen
steif	ADJD	1	steif
Gutdünken	NN	1	Gutdünken
Zufall	NN	1	Zufälle
männlich	ADJA	1	männliche
Versparen	VVFIN	1	Versparen
Finger	NN	1	Fingers
sorgen	VVINF	1	sorgen
Zerstreuung	NN	1	Zerstreuung
hinter	APPR	1	hinter
bestricken	VVPP	1	bestrickt
Unerlaubte	NN	1	Unerlaubtes
verstatten	VVINF	1	verstatten
Junggeselle	NN	1	Junggesellen
Pack	NN	1	Pack
respektieren	VVFIN	1	respektieren
Sicherheit	NN	1	Sicherheit
schaffen	VVINF	1	schaffen
verderben	VVPP	1	verdorben
meinetwegen	ADV	1	meinetwegen
verursachen	VVPP	1	verursacht
ciceronianisches	ADJA	1	ciceronianisches
arglistig	ADJA	1	Arglistigen
gehorsam	ADJD	1	gehorsam
Genehmhaltung	NN	1	Genehmhaltung
besiegen	VVINF	1	besiegen
fast	ADV	1	fast
verräterisch	ADJA	1	verräterischen
vorbringen	VVINF	1	vorbringen
Plappermaul	NN	1	Plappermaul
zehnfach	ADJD	1	zehnfach
einfädeln	VVIZU	1	einzufädeln
sowohl	KON	1	sowohl
Überdrusse	NN	1	Überdrusse
Begierde	NN	1	Begierde
Knicks	NN	1	Knickse
unterbringen	VVIZU	1	unterzubringen
Gehör	NN	1	Gehör
Einsicht	NN	1	Einsicht
Erscheinung	NN	1	Erscheinungen
erteilen	VVPP	1	erteilt
ausgeartete	ADJA	1	ausgeartete
Schurke	NN	1	Schurken
Versicherung	NN	1	Versicherungen
Hilarien	NE	1	Hilarien
Nacht	NN	1	Nacht
versprochen	ADJA	1	versprochenen
betreibsamer	ADJA	1	betreibsamer
eheleiblichen	ADJA	1	eheleiblichen
Lobrede	NN	1	Lobrede
Ausnahme	NN	1	Ausnahme
Merkmal	NN	1	Merkmale
letzt	ADJA	1	letzte
lenken	VVFIN	1	lenken
hochschätzte	VVFIN	1	hochschätzte
übrigens	ADV	1	übrigens
Ruhe	NN	1	Ruhe
Ihrentwillen	NN	1	Ihrentwillen
verrichten	VVINF	1	verrichten
anhören	VVIZU	1	anzuhören
entfernen	VVINF	1	entfernen
allzuähnlich	ADJD	1	allzuähnlich
Widersprechen	NN	1	Widersprechen
begnügen	VVINF	1	begnügen
gestehen	VVFIN	1	Gestehen
Ort	NN	1	Orte
Geburtstag	NN	1	Geburtstag
Bedenken	NN	1	Bedenken
prahlen	VVINF	1	prahlen
Augenmaß	NN	1	Augenmaß
bezaubernd	ADJA	1	bezaubernden
Befehl	NN	1	Befehl
abgeben	VVFIN	1	abgebe
Wunsch	NN	1	Wunsch
Gartenhaus	NN	1	Gartenhaus
Stolze	NN	1	Stolze
Unterschied	NN	1	Unterschied
feindselig	ADJA	1	feindseliger
Seufzer	NN	1	Seufzern
Verschwiegene	NN	1	Verschwiegenen
eingewurzelter	ADJA	1	eingewurzelter
Schiedsrichter	NE	1	Schiedsrichter
undankbar	ADJA	1	undankbaren
Fliege	NN	1	Fliege
anhalten	VVPP	1	angehalten
Beiläufig	NE	1	Beiläufig
Schlachtopfer	NN	1	Schlachtopfer
Kredit	NN	1	Kredit
ertappen	VVFIN	1	ertappten
Hui	NE	1	Hui
sachte	ADV	1	Sachte
größerm	NN	1	größerm
Hexe|Hexen	NN	1	Hexen
Nachkommenschaft	NN	1	Nachkommenschaft
Angriff	NN	1	Angriffe
stechen	VVINF	1	stechen
Weiberfeind	NN	1	Weiberfeind
mannigfaltig	ADJA	1	mannigfaltigsten
links	ADJA	1	linke
gründlich	ADJD	1	gründlich
Veränderung	NN	1	Veränderung
ausspielen	VVIZU	1	auszuspielen
fortpflanzen	VVINF	1	fortpflanzen
empfehlen	VVFIN	1	empfehle
ziemlich	ADV	1	ziemlich
klar	ADJD	1	klar
rechtschaffnen	ADJA	1	rechtschaffnen
Schnadern	NN	1	Schnadern
gereuet	VVFIN	1	gereuet
Kleidung	NN	1	Kleidung
zweierlei	PIAT	1	Zweierlei
gereuen	ADJD	1	gereuen
Folge	NN	1	Folge
Aussteuer	NN	1	Aussteuer
horchen	VVINF	1	horchen
umgehen	VVFIN	1	umgeht
spöttisch	ADJA	1	Spöttischer
bestreiten	VVINF	1	bestreiten
verteidigen	VVINF	1	verteidigen
Gunstbezeugung	NN	1	Gunstbezeugungen
gesund	ADJA	1	gesunden
Zunge	NN	1	Zunge
gleichgültig	ADJD	1	gleichgültig
Häßliche	NN	1	Häßliche
Garn	NN	1	Garne
Alsdenn	NE	1	Alsdenn
warnen	VVFIN	1	warne
Schlechteste	NN	1	Schlechteste
dazumal	ADV	1	dazumal
umarmen	VVINF	1	umarmen
Gehirn	NN	1	Gehirne
warten	VVPP	1	gewartet
Materie	NN	1	Materie
bewandern	VVPP	1	bewandert
Beispiel	NN	1	Beispiele
matt	ADJD	1	matt
ausnehmen	VVPP	1	ausgenommen
bitte	PTKANT	1	bitte
reißen	VVINF	1	reißen
verdrießen	VVFIN	1	verdrießt
Blick|Blicken	NN	1	Blicken
bekennen	VVINF	1	bekennen
Habichtsnase	NN	1	Habichtsnase
Selbstbetrug	NN	1	Selbstbetrug
Strenge	NN	1	Strenge
bestätigen	VVFIN	1	bestätigen
Anfang	NN	1	Anfangs
quo	NN	1	quo
zugehen	VVINF	1	zugehen
wovon	PWAV	1	wovon
Mütterchen	NN	1	Mütterchen
umständlich	ADJD	1	umständlich
Wumshätern	NN	1	Wumshätern
Narr	NN	1	Narren
einerlei	ADV	1	einerlei
gedenken	VVINF	1	gedenken
Parenthesi	NE	1	Parenthesi
wodurch	PWAV	1	wodurch
klopfen	VVINF	1	klopfen
Spaß	NN	1	Spaß
Aufwand	NN	1	Aufwand
Paar	NN	1	Paar
Proportion	NN	1	Proportion
dünken	VVFIN	1	dünkt
erdenken	VVINF	1	erdenken
Mutwille	NN	1	Mutwillen
Ewigkeit	NN	1	Ewigkeit
nasenweise	ADJA	1	nasenweise
Umgange	NN	1	Umgange
Zipfel	NN	1	Zipfeln
berufen	VVINF	1	berufen
einleiten	VVINF	1	einleiten
Schwiegertochter	NN	1	Schwiegertochter
Umschreibung	NN	1	Umschreibung
Kompliment	NN	1	Kompliment
solls	VVFIN	1	solls
weglassen	VVINF	1	weglassen
schimärisch	ADJA	1	schimärischen
Schnierbrust	NN	1	Schnierbrust
unvermerkt	ADJD	1	unvermerkt
Mode	NN	1	Mode
Ernst	NN	1	Ernst
plaudern	VVINF	1	plaudern
munter	ADJD	1	munter
kuriös	ADJD	1	kuriös
geschwindesten	ADJD	1	geschwindesten
unerbittlich	ADJD	1	unerbittlich
verkleinern	VVPP	1	verkleinert
beimessen	VVINF	1	beimessen
Törichters	NN	1	Törichters
Heuchlerin	NN	1	Heuchlerin
scherzest	VVFIN	1	scherzest
abbinden	VVINF	1	abbinden
vergreifen	VVFIN	1	vergreift
rechnen	VVINF	1	rechnen
erwecken	VVINF	1	erwecken
Mühlrad	NN	1	Mühlräder
Gast	NN	1	Gast
beleidiget	VVFIN	1	beleidiget
dawider	ADV	1	dawider
zeigen	VVFIN	1	Zeigen
schlau	ADJA	1	schlauer
Anhalten	NN	1	Anhalten
Danksagung	NN	1	Danksagung
angehender	ADJA	1	angehender
spotten	VVFIN	1	spotten
Entschluss	NN	1	Entschlüsse
fremd	ADJA	1	fremden
Schatten	NN	1	Schatten
aufhören	VVFIN	1	aufhören
verhindern	VVPP	1	verhindert
mags	NN	1	mags
Frauensperson	NN	1	Frauensperson
Stoff	NN	1	Stoff
sparen	VVFIN	1	Spare
Ohrfeige	NN	1	Ohrfeige
überlegen	VVINF	1	überlegen
allezeit	ADV	1	allezeit
zumuten	VVINF	1	zumuten
vergebens	ADV	1	vergebens
Augenzeuge	NN	1	Augenzeuge
Eigensinne	NN	1	Eigensinne
anfechten	VVINF	1	anfechten
Anteil	NN	1	Anteil
Lob	NN	1	Lobe
Ausspielen	NN	1	Ausspielen
Achsel	NN	1	Achsel
Geringfügigkeit	NN	1	Geringfügigkeit
Abscheulichkeit	NN	1	Abscheulichkeit
vielmal	ADV	1	vielmal
Rechnung	NN	1	Rechnung
Gespräch	NN	1	Gespräch
allmählig	ADJD	1	allmählig
Injuriarum	NN	1	Injuriarum
selten	ADJD	1	selten
unstreitiges	ADJA	1	unstreitiges
abwerfen	VVINF	1	abwerfen
hierauf	PAV	1	hierauf
ändern	VVINF	1	ändern
umkleide	VVFIN	1	umkleide
entdecken	VVFIN	1	entdecken
kränken	VVFIN	1	Kränke
Erhaltung	NN	1	Erhaltung
Ausrufungen	NN	1	Ausrufungen
beschreiben	VVPP	1	beschrieben
Hochachtung	NN	1	Hochachtung
Plage	NN	1	Plage
Verzweiflung	NN	1	Verzweiflung
Kaufmanne	NN	1	Kaufmanne
Unsinn	NN	1	Unsinn
bewundern	VVFIN	1	bewundere
Wohltat	NN	1	Wohltat
Einbildung	NN	1	Einbildung
untersuchen	VVINF	1	untersuchen
gedacht	ADJA	1	gedachte
versichre	VVFIN	1	versichre
mitkommen	VVINF	1	mitkommen
auskommen	VVFIN	1	auskäme
martern	VVFIN	1	martern
vorschlagen	VVPP	1	vorgeschlagen
weh	ADJD	1	weh
Kraft	NN	1	Kräften
Unterredung	NN	1	Unterredung
Gesichtchen	NN	1	Gesichtchen
besehen	VVPP	1	besehen
ersuchen	VVINF	1	ersuchen
Gabe	NN	1	Gaben
schade	ADJD	1	Schade
Verheiratung	NN	1	Verheiratung
Spötterei	NN	1	Spötterei
erschrecklicher	ADJD	1	erschrecklicher
Rechtskonsulent	NN	1	Rechtskonsulent
genau	ADJD	1	genau
beschließen	VVFIN	1	beschloß
Quid	NN	1	Quid
unbeschadet	ADV	1	unbeschadet
durchbringen	VVFIN	1	durchbringt
vermissen	VVINF	1	vermissen
gleichfalls	ADV	1	gleichfalls
äußerlich	ADJA	1	äußerlichen
fahren	VVFIN	1	Fahren
Schweig	NE	1	Schweig
Jugend	NN	1	Jugend
spitziges	ADJA	1	spitziges
neidisch	ADJD	1	neidisch
anmerken	VVPP	1	angemerkt
einig	ADJD	1	einig
Berufsverrichtungen	NN	1	Berufsverrichtungen
Gewölbe	NN	1	Gewölbe
überheben	VVINF	1	überheben
Vergleich|Vergleichen	NN	1	Vergleichen
winken	VVFIN	1	winkte
anwünscht	VVFIN	1	anwünscht
derselb	PDAT	1	denselben
inner	ADJA	1	innere
Ehesachen	NN	1	Ehesachen
Anfall	NN	1	Anfall
bestens	ADV	1	bestens
Blick	NN	1	Blick
wär	ADJD	1	wär
zweifeln	VVINF	1	zweifeln
ärgerlich	ADJD	1	ärgerlich
natürlich	ADJA	1	natürliche
versteinern	VVPP	1	versteinert
beisammen	ADV	1	beisammen
stumpf	ADJA	1	stumpfe
Nachricht	NN	1	Nachricht
Hispulla	NE	1	Hispulla
einbringen	VVINF	1	einbringen
Geschmack	NN	1	Geschmack
Welle	NN	1	Wellen
versagen	VVPP	1	versagt
Kuppler	NN	1	Kuppler
lächlende	ADJA	1	lächlende
Maria	NE	1	Maria
barmherzig	ADJA	1	Barmherziger
Ogulina	NE	1	Ogulina
Backe|Backen	NN	1	Backen
ungeachtet	APPO	1	ungeachtet
auskratzen	VVPP	1	ausgekratzt
Reihe	NN	1	Reihe
schminken	VVINF	1	schminken
