Title: Die alte Jungfer
Number of all lemmas: 9266
Nummber of different lemmas: 1455

Lemma	POS	Frequency	Tokens
die	ART, PDS, PRELS, PRELAT	522	dem, die, Das, das, der, des, Die, den, Des, Der, denen, dessen, Den
ich	PPER, PRF	467	ich, mich, mir, Ich, Mir, Mich
sein	VAFIN, VAINF, PPOSAT, VAPP	357	sind, ist, sein, Bin, bin, war, seine, seinen, sei, wäre, gewesen, bist, waren, seiner, Sein, wärst, Wärst, wären, Sei, seinem, Ist, Bist, Sind, wärest, Seine, War, Wäre, Seid, Waren, Seiner
Sie	PPER	307	Sie, Ihnen
eine	ART, PIS	203	eine, ein, einer, einen, einem, Einer, eines, Ein, Einen
nicht	PTKNEG	187	nicht, Nicht
haben	VAFIN, VAINF, VAPP	154	habe, haben, hätte, hat, hatte, hättest, hast, Hast, Hatte, hätten, Hat, Haben, habt, gehabt
er	PPER	144	er, Er, ihm, ihn, Ihn
und	KON	137	und, Und
es	PPER	137	es, Es
mein	PPOSAT	136	mein, meinem, meine, Mein, meinen, Meines, Meine, meiner, Meinen, meines
zu	PTKA, ADV, APPR, PTKZU, APPRART, PTKVZ	135	zu, zum, Zu, zur, Zum
du	PPER, PRF	134	Du, dich, du, dir
so	ADV	127	so, So
was	PWS, PIS, PRELS, PIAT	111	was, Was
wollen	VMFIN, VMINF	104	wollen, Wollen, willst, will, wollte, Will, Willst, wolltest, wollten
werden	VAFIN, VAINF, VAPP	102	wird, werden, Würde, wirst, wurde, geworden, würde, werde, Wirst, würdest, würden
in	APPR, APPRART	100	in, im, In, ins
von	APPRART, APPR, NE	87	vom, von, Vom, Von
Herr	NN	84	Herr, Herren, Herrn
dass	KOUS	82	daß, Daß
ihr	PPOSAT, PPER, PRF	81	Ihren, ihre, Ihrem, Ihr, ihren, ihr, Ihres, ihrem, Ihre, euch, ihrer, Ihrer, Euch
wenn	KOUS	70	Wenn, wenn
können	VMFIN, VMINF, VVFIN	70	Kannst, kannst, kann, können, Kann, könnte, könntest, Könntest, Können
sich	PRF	62	sich
doch	ADV, KON	56	doch, Doch
noch	ADV, KON	54	noch, Noch
ja	ADV, PTKANT	54	Ja, ja
machen	VVPP, VVFIN, VVINF	52	gemacht, macht, machen, Machen, Mache, machst, mache, machte
sie	PPER	52	sie, ihnen, Ihr
mit	APPR, PTKVZ	52	Mit, mit
sollen	VMFIN	50	Soll, sollen, soll, sollten, sollst, Sollte, sollte, Sollten
wie	KOKOM, KOUS	50	wie, Wie
wir	PPER, PRF	50	wir, uns, Wir
schon	ADV	49	schon, Schon
aber	ADV, KON	48	aber, Aber
auch	ADV	46	auch, Auch
auf	APPR	45	auf, Auf
lassen	VVIMP, VVINF, VVFIN	41	Laß, lassen, läßt, ließe, Lassen, lasse, laßt, laß
Capitaine	NN	41	Capitaine
nur	ADV	40	nur, Nur
als	KOUS, KOKOM, KON	40	als, Als
O	NN	39	O
sagen	VVFIN, VVINF, VVPP	39	sagt, Sage, sagen, sagst, gesagt, sagte, Sagen, sage, sagten
für	APPR	38	für, Für
gut	ADJD, ADJA	37	gut, besten, beste, Gut, besser, guten, gute, guter
Schlag	NN	36	Schlag, Schlage
ach	ITJ	36	Ach
an	PTKVZ, APPR	35	an
man	PIS	34	man, Man
Mann	NN	33	Mann, Männer, Manne, Männern, Mannes
wohl	ADV	33	wohl, Wohl
denn	ADV, KON	33	denn, Denn
Jahr	NN	32	Jahr, Jahren, Jahrs, Jahre
müssen	VMFIN, VMINF	32	muß, mußt, müssen, Müssen, müßte
nichts	PIS, PIAT	31	nichts, Nichts
wissen	VVFIN, VVINF	30	weiß, wissen, wüßtest, wüßte, Weiß
nein	PTKANT	29	Nein, nein
kommen	VVFIN, VVINF, VVPP, VVIMP	28	komme, kommen, gekommen, Kommt, Komm, Kommen, käme
hier	ADV	28	hier, Hier
Jungfer	NN	27	Jungfer, Jungfern
alt	ADJD, ADJA	26	alt, ältesten, altes, alten, alte, altem, Alte
bei	APPR	26	bei, Bei
nehmen	VVFIN, VVINF, VVIMP, VVPP	25	nimmt, Nehmen, nehme, nähme, nehmen, nimm, genommen
nun	ADV	23	nun, Nun
lieb	ADJA, ADJD	23	lieber, liebe, lieb, lieben
alle	PIS, PIAT	23	alle, aller, allen, alles
tun	VVINF, VVFIN, VVPP	23	tun, getan, tu, tust, Tu
heiraten	VVINF, VVFIN, VVPP	23	heiraten, Heirate, heirate, geheiratet
gar	ADV	23	gar, Gar
gehen	VVFIN, VVIMP, VVINF, VVPP	23	gehen, geht, gehe, ginge, Geh, geh, gegangen, Geht
wer	PWS	22	wer, wem, Wer, wen, Wen, Wem
nu	ITJ	21	nu, Nu
sehen	VVFIN, VVINF, VVPP	20	sehe, sehen, sieht, gesehen, siehst, Sieht, sahen, sähe
dein	PPOSAT	20	dein, deine, Dein, deinen, deinem, deiner
Lelio	NE	19	Lelio
denken	VVFIN, VVINF	19	denke, denkt, denken, dächte, dächten, dachte, Denken
wieder	ADV	19	wieder, Wieder
vor	PTKVZ, APPR	19	vor, Vor
ganz	ADV, ADJA	19	ganz, ganze, ganzen, Ganz
glauben	VVINF, VVFIN, VVPP	19	glauben, glaube, glaubst, Glauben, Glaubst, geglaubt
gewiss	ADJD	18	gewiß, Gewiß
geben	VVFIN, VVPP, VVINF	18	gibt, gegeben, geben, gab, gebe
wahr	ADJD	18	wahr
Gott	NN	18	Gott, Gottes
mögen	VMFIN	18	mag, möchte, möchten, mögen
sehr	ADV	18	sehr
ha	NE	17	ha
Lisette	NE	16	Lisette
heißen	VVFIN, VVINF	16	hieße, heißt, heißen
Muhme	NN, NE	16	Muhme
oder	KON	16	Oder, oder
über	APPR	16	über, Über
wenige	PIS, PIAT	16	wenig, weniger
Kind	NN	16	Kinder, Kind
schuldig	ADJD	15	schuldig
andere	PIS, PIAT	15	andre, andern, anderm, andere, anderer
Mademoiselle	NN	15	Mademoiselle
recht	ADJD, ADJA	15	recht, rechter
sonst	ADV	15	sonst, Sonst
aus	APPR, PTKVZ	14	aus
hören	VVFIN, VVINF	14	hört, hören, höre, Hören, hörte, Hört
nach	APPR, ADV, PTKVZ	14	nach, Nach
bis	KON, APPR, KOUS	14	bis
gleich	ADJD, PTKVZ, APPR	14	gleich, Gleich
wo	PWAV	13	Wo, wo
erst	ADV, ADJA	13	erst, ersten, erste
Bräutigam	NN	13	Bräutigam, Bräutigams
einmal	ADV	13	einmal
mehr	ADV, PIAT	13	mehr
reden	VVFIN, VVINF, VVPP	13	reden, Reden, geredet, rede, redet, redest
weil	KOUS	13	weil, Weil
Ohldin	NE, NN	13	Ohldin
da	ADV, KOUS, PTKVZ	12	da, Da
je	ADV, APPR	12	je, Je
Sache	NN	12	Sachen, Sache
keine	PIAT	12	keine, keinem, kein, keinen
Frau	NN	12	Frau
Peter	NE	12	Peter
versprechen	VVFIN	11	versprach, verspreche, verspricht, Versprechen, versprechen
Ha	NE	11	Ha
itzo	ADJD, VVFIN, VVIMP, NN	11	itzo
Hand	NN	11	Händen, Hand, Hände
bringen	VVPP, VVINF, VVFIN	11	gebracht, bringen, bringst, bringe, Bringst
Braut	NN	11	Braut
Teufel	NN	11	Teufels, Teufel
also	ADV	11	Also, also
bald	ADV	11	bald
Poete	NN	10	Poete
dies	PDAT	10	diese, dieses, Diesen, diesen
Vetter	NN, NE	10	Vetters, Vetter
Kerl	NN	10	Kerl, Kerlen
viele	PIAT, PIS	10	viel, viele, vielem
selbst	ADV	10	Selbst, selbst
Schneider	NE	10	Schneider
Henker	NN	10	Henker
Heirat	NN	10	Heirat
um	APPR, KOUI, PTKVZ	10	um, Um
Geld	NN	10	Geld, Gelde, Gelder
dazu	PAV	9	dazu
bezahlen	VVINF, VVFIN, VVPP	9	bezahlen, bezahlt, bezahle
Poet	NN	9	Poeten
Wort	NN	9	Wort, Worte, Wörter
Zeit	NN	9	Zeit, Zeiten
sprechen	VVFIN, VVINF	9	Sprechen, spräche, spricht, sprechen, sprach
lange	ADV	9	lange
Name	NN	9	Namen, Name, Namens
ohne	KOUI, APPR	9	ohne, Ohne
bekommen	VVFIN, VVINF	9	bekomme, bekommen, Bekomme, bekäme
kömmt	VVFIN, ADJD	9	kömmt
ab	PTKVZ	9	ab
etwan	NE, NN	9	etwan
Augenblick	NN	8	Augenblick
unter	APPR	8	unter
vielleicht	ADV	8	Vielleicht, vielleicht
fort	PTKVZ, ADV	8	fort
ob	KOUS	8	Ob, ob
durch	APPR	8	durch
Ei	NN	8	Ei
närrisch	ADJA, ADJD	8	närrische, närrisch
sehnen	VVIMP	8	sehn
heute	ADV	8	heute
Weib	NN	8	Weib, Weiber
@card@	CARD	8	1724, 1748, 34
Oronte	VVFIN, VVINF, ADJD	8	Oronte
Freund	NN	8	Freund, Freunden, Freunde
Kopf	NN	8	Kopf, Kopfe, Köpfe
er|es	PPER	7	Ihm
bitten	VVINF, VVFIN	7	bitten, bitte
klein	ADJA	7	kleine, kleinen, kleinste, kleiner
Art	NN	7	Art
ehrlich	ADJA	7	ehrlichen, ehrliches, ehrliche, ehrlicher
verstehen	VVFIN, VVIMP, VVPP	7	verstehen, versteh, verstanden
unsre	PPOSAT	7	unsre, unsern
artig	ADJA, ADJD	7	artige, artigen, artiger, artig, artigsten
eben	ADV	7	eben, Eben
Narr	NN	7	Narr, Narren
viel	ADV	7	viel
genug	ADV	7	genug
Haus	NN	7	Hause, Haus
vortrefflich	ADJD, ADJA	7	vortrefflich, vortrefflichen, vortreffliche
Stand	NN	6	Standes, Stande
Erbschaft	NN	6	Erbschaft
Geschlecht	NN	6	Geschlecht, Geschlechte
Hochzeit	NN	6	Hochzeit
Tat	NN	6	Tat
Tag	NN	6	Tage, Tag, Tagen, Tags
groß	ADJA, ADJD	6	großer, großen, groß
verzeihen	VVFIN	6	verzeihe, verzeihen, Verzeihen
kennen	VVPP, VVFIN, VVINF	6	gekannt, kennst, kennen, kennt
schicken	VVPP, VVINF, VVFIN	6	geschickt, schicken, schickt
Nu	NN	6	Nu
richtig	ADJD	6	richtig
übel	ADJD	6	übel
Unglück	NN	6	Unglück, Unglücke
kaufen	VVFIN, VVPP	6	kauft, Kaufen, kaufte, kaufe, gekauft
warum	PWAV	6	Warum, warum
zwar	ADV	6	zwar
weit	ADJD	6	weit
Korb	NN	6	Korb
Frauenzimmer	NN	6	Frauenzimmer, Frauenzimmern
lang	ADJA, ADJD	6	lange, lang, länger
bleiben	VVPP, VVFIN	6	geblieben, bleibt, bleiben
Narre	NN	6	Narre
sachte	ADV	6	sachte, Sachte
halten	VVINF, VVFIN	6	halten, hält, Halten
eher	ADV	6	eher
warten	VVFIN, VVINF, VVPP	6	Warte, warten, Warten, gewartet
stehen	VVFIN	6	stünde, steht, Steht, stehe
Glück	NN	6	Glück
weg	ADV, PTKVZ	6	weg
Mensch	NN	6	Mensch, Menschen
Neue	NN	5	Neues
Seite	NN	5	Seite
brauchen	VVFIN	5	brauche, brauchst, brauchen, braucht
Fuß	NN	5	Füßen, Fuß, Füße
Schuld	NN	5	Schuld, Schulden
Sies	NN	5	Sies
desto	KON	5	desto, Desto
unglücklich	ADJD, ADJA	5	unglücklich, unglückliche
anders	ADV	5	anders
stecken	VVINF, VVFIN	5	stecken, steckt, steckten
sondern	KON	5	Sondern, sondern
Taler	NN	5	Taler
Hund	NN	5	Hund
Vermögen	NN	5	Vermögen
kurz	ADJD	5	kurz, Kurz
gehn	VVFIN	5	gehn
solche	PIAT	5	solchen, solche, solcher
ansehen	VVFIN, VVINF	5	ansieht, ansehen
verdammt	ADJA	5	verdammte, verdammter
dergleichen	PIS	5	dergleichen
einzig	ADJA, ADJD	5	einziges, einzige, einzigen, einziger, einzig
24	CARD	5	24
lachen	VVFIN, VVINF	5	lachst, lachen, lacht
allerlieb	ADJA	5	allerliebstes, allerliebste, allerliebster
dumm	ADJA, ADJD	5	dumme, dumm, dümmer
Gesicht	NN	5	Gesichte, Gesicht
Leute	NN	5	Leuten, Leute
Ja	NN	5	Ja
paar	PIS, PIAT	5	Paar
hoch	PTKVZ, ADJA, ADJD	5	hoch, höchste
zehn	CARD	5	zehn
liegen	VVFIN, VVPP	5	liegt, gelegen
damit	KOUS, PAV	5	damit
zwei	CARD	5	zwei
drei	CARD	4	drei
Person	NN	4	Person, Personen
Stube	NN	4	Stube
niemand	PIS	4	niemand
kehren	VVFIN	4	Kehren, kehren
Gedanke	NN	4	Gedanken
fürchten	VVINF, VVFIN	4	fürchten, fürchte
Gedicht	NN	4	Gedicht, Gedichte
dürfen	VMFIN, VMINF	4	Darfst, dürfen, darf, Darf
borgen	VVINF, VVPP	4	borgen, Geborgt, geborgt
Wechsel	NN	4	Wechsel
erbaulich	ADJA, ADJD	4	erbaulichem, Erbaulich, erbaulich, erbauliche
zählen	VVFIN, VVINF	4	Zähle, zählen
glücklich	ADJA, ADJD	4	glücklichen, glücklich, glückliche
immer	ADV	4	immer, Immer
leben	VVFIN, VVINF	4	Leben, lebe, leben
böse	ADJA	4	böses, böse
spielen	VVINF, VVPP	4	spielen, gespielt
schmecken	VVPP, VVFIN	4	geschmeckt, schmeckt, schmeckte
wert	ADJD	4	wert
Heirat|Heiraten	NN	4	Heiraten
fertig	ADJD, PTKVZ	4	fertig
behüten	VVFIN	4	behüte, Behüte
ein	PTKVZ	4	ein
möglich	ADJA, ADJD	4	möglichen, möglich
zwanzig	CARD	4	zwanzig
meinen	VVFIN	4	meine, meint, meinen
einander	PRF	4	einander
Ehre	NN	4	Ehre
etwas	ADV, PIAT	4	etwas
Stadt	NN	4	Stadt
breit	ADJA, ADJD	4	breiten, breit, breite
900	CARD	4	900
deutlich	ADJD, ADJA	4	deutlich, deutlichen, deutlichsten
Hölle	NN	4	Hölle
Schritt	NN	4	Schritte, Schritt
bürgerlich	ADJA	4	bürgerlichen
Neuigkeit	NN	4	Neuigkeit, Neuigkeiten
genießen	VVINF, VVPP, VVFIN	4	genießen, genossen
Je	KOUS	4	Je
Makrone	NN	4	Makronen
Dank	NN	4	Dank
Fehler	NN	4	Fehler
allzu	PTKA	4	allzu
daraus	PAV	4	daraus
wohnen	VVFIN, VVPP	4	wohnt, gewohnt
gütig	ADJA, ADJD	4	gütige, gütig
Seele	NN	4	Seele, Seelen
gern	ADV	4	gern
schön	ADJA, ADJD	4	schönes, schöne, schön
@ord@	ADV, ADJA	4	1724., 45.
entschließen	VVINF, VVFIN, VVPP	4	entschließen, entschlossen
gegen	APPR	4	gegen
adieu	ADV	4	Adieu
Vertrauen	NN	4	Vertrauen
Stelle	NN	4	Stelle
vier	CARD	4	Vier, vier, vieren
setzen	VVFIN, VVPP	4	setzt, Gesetzt
besinnen	VVFIN, VVINF	4	besinne, besinnen
welche	PRELS, PWAT	4	welche, welcher, Welchen
Carmen	NE	4	Carmen
wünschen	VVINF	4	wünschen
daran	PAV	4	Daran, daran
et	FM	4	et
jung	ADJD, ADJA	4	jung, jünger, jungen
recht|rechts	ADJA	3	rechte, rechten
Krafttörtchen	NN	3	Krafttörtchen
neu	ADJA	3	neue
gottlos	ADJA, ADJD	3	gottloses, gottlos, gottlose
Recht|Rechte	NN	3	Rechte, Rechten
heraus	ADV, PTKVZ	3	heraus
anstehen	VVFIN	3	ansteht, anstehe
wirklich	ADJD	3	wirklich
hundert	CARD	3	hundert
erstemal	ADV	3	erstemal
schade	ADJD	3	Schade
Gassenlied	NN	3	Gassenlied
Frage	NN	3	Fragen, Frage
laufen	VVFIN	3	laufen, läuft
Vergnügen	NN	3	Vergnügen
Runzel|Runzeln	NN	3	Runzeln
Hundsfott	NN	3	Hundsfott
Streich	NN	3	Streich, Streiche
Einfall	NN	3	Einfall
Spritzkuchen	NN	3	Spritzkuchen
schreiben	VVPP, VVFIN	3	geschrieben, schreibst
adlichen	ADJA	3	adlichen
wenig	ADV	3	wenig
Zweifel	NN	3	Zweifel
erzählen	VVINF, VVFIN	3	erzählen, Erzähle, erzähle
legen	VVFIN, VVPP	3	legen, gelegt, lege
ankommen	VVINF, VVPP	3	ankommen, angekommen
stoßen	VVFIN, VVINF, VVPP	3	stößt, stoßen, gestoßen
darzu	VVIZU, ADV	3	darzu
kosten	VVINF	3	kosten
Ohr	NN	3	Ohre, Ohren
unbesonnen	ADJA, ADJD	3	unbesonnene, unbesonnen
Meister	NN	3	Meister
Clitander	NE	3	Clitander
gestern	ADV	3	gestern, Gestern
sterben	VVFIN, VVINF	3	stirbt, sterben
halt	ADV	3	halt, Halt
wirds	VVFIN, ADJD	3	wirds
behalten	VVFIN, VVINF	3	behalte, behalten, Behalten
Münze	NN	3	Münzen
schlecht	ADJD	3	schlecht
Hals	NN	3	Hals, Halse
antworten	VVINF, VVFIN	3	antworten, Antworte
Weg	NN	3	Weg, Wege
herum	APZR, PTKVZ	3	herum
pap	NE	3	pap
gering	ADJA	3	geringste, geringe
Rock	NN	3	Rock
euer	PPOSAT	3	eure, eurer, Eure
nachlaufen	VVINF	3	nachlaufen
aufs	APPRART	3	Aufs, aufs
Tod	NN	3	Tode, Todes, Tod
mirs	ADJD	3	mirs
weißen	VVFIN	3	Weißt, weißt
25	CARD	3	25
Rat	NN	3	Rat
nimmermehr	ADV	3	nimmermehr
Haar	NN	3	Haare, Haar
irren	VVFIN, VVPP	3	irrst, irren, geirrt
Straße	NN	3	Straße
stehn	ADJD, VVPP, NN	3	stehn
arg	ADJD	3	arg
etliche	PIAT	3	etliche
Hochwohlgeborne	ADJA	3	Hochwohlgeborne
Zimmer	NN	3	Zimmer
stellen	VVFIN	3	Stelle, stelle
finden	VVINF, VVFIN, VVPP	3	finden, finde, gefunden
per	APPR	3	per
Treppe	NN	3	Treppen, Treppe
darauf	PAV	3	darauf, Darauf
helfen	VVFIN, VVINF	3	hilft, helfen
Himmel	NN	3	Himmel
Nacht	NN	3	Nächte, Nacht
holen	VVINF, VVFIN	3	holen, holte
wenigstens	ADV	3	Wenigstens, wenigstens
einige	PIAT	3	einige, einigen
Freier	NN	3	Freier, Freiers
erklären	VVPP	3	erklärt
befehlen	VVFIN, VVPP, VVINF	3	befehlen, befohlen
danken	VVINF, VVFIN	3	danken, Danken
entsprießen	VVPP	3	entsprossen
verlangen	VVFIN	3	verlangen
Höh	NN	3	Höh
Kompliment	NN	3	Kompliment
hinderlich	ADJD	3	hinderlich
Dukaten	NN	3	Dukaten
Pas	NN	3	Pas
vorhin	ADV	3	vorhin
fremd	ADJA	3	fremden
suchen	VVFIN, VVINF	3	suchen, suche
Rechnung	NN	3	Rechnung
46.	ADJA	3	46.
Gelegenheit	NN	3	Gelegenheiten, Gelegenheit
hintertreiben	VVINF	3	hintertreiben
Zuckerbretzeln	NN	3	Zuckerbretzeln
weder	KON	3	weder
übrig	ADJA, ADJD	3	übriges, übrige, übrig
beisammen	ADV, PTKVZ	3	beisammen
48	CARD	3	48
44	CARD	3	44
uralt	ADJA	3	uralten
47.	ADJA	3	47.
Ehe	NN	2	Ehe
Galgenschwengel	NN	2	Galgenschwengel
gesteh	NE	2	gesteh
voraus	PTKVZ, ADV	2	voraus
träumen	VVINF	2	träumen
deutsch	ADJD, ADJA	2	deutsch, deutschen
toll	ADJD, ADJA	2	toll, tollen
vorher	ADV	2	vorher, Vorher
Quodlibet	NN	2	Quodlibet
trotzen	VVINF	2	trotzen
sicher	ADJA, ADJD	2	sichern, sicherer
spät	ADJD	2	spät
Posse	NN	2	Possen
Ehestands	NN	2	Ehestands
Stunde	NN	2	Stunde
Weise	NN	2	Weisen, Weise
wollens	VVFIN	2	wollens
plötzlich	ADJD	2	plötzlich
Corinna	NE	2	Corinna
beißen	VVINF, VVFIN	2	beißen, beißt
versöhnen	VVPP, VVINF	2	versöhnt, versöhnen
Rede|Reden	NN	2	Reden
Gebackensherumträger	NN	2	Gebackensherumträger
Gang	NN	2	Gange, Gang
abgeschmackt	ADJD	2	abgeschmackt
künftig	ADJD, ADJA	2	künftig, künftigen
Gemahlin	NN	2	Gemahlin
dafür	PAV	2	Dafür, dafür
rechtschaffen	ADJA	2	rechtschaffene
Dienst	NN	2	Diensten, Dienst
bekannt	ADJD	2	bekannt
Behüts	NN	2	Behüts
Abscheu	NN	2	Abscheu
wider	APPR	2	wider
gescheit	ADJA	2	gescheiten, gescheite
fest	ADJD, ADJA	2	fest, feste
verflucht	ADJA	2	verfluchte
vernünftig	ADJA	2	vernünftigen
manche	PIAT	2	manchem, manchen
ohngefähr	ADJD	2	ohngefähr
gewinnen	VVFIN, VVPP	2	gewinnt, gewonnen
Spiegel	NN	2	Spiegel
Mägdgen	NN	2	Mägdgen
54	CARD	2	54
50	CARD	2	50
Verhaft	NN	2	Verhaft
Punkt	NN	2	Punkte
schalkhaftem	ADJA	2	schalkhaftem
Ho	NE	2	Ho
hundertmal	ADV	2	hundertmal
Grab	NN	2	Grabe, Grab
missbrauchen	VVINF	2	mißbrauchen
Fenster	NN	2	Fenster, Fenstern
Stück	NN	2	Stück
Freundin	NN	2	Freundin, Freundinnen
verdenken	VVINF	2	verdenken
gehören	VVFIN	2	gehört, gehöre
alleweile	ADV	2	alleweile
nachsagen	VVIZU	2	nachzusagen
wählen	VVFIN	2	Wählen
zeihen|ziehen	VVFIN	2	zieht
schwerlich	ADJD	2	schwerlich
unterschieden	ADJA	2	unterschiedene
anmutig	ADJD	2	anmutig
lesen	VVFIN, VVPP	2	liest, gelesen
beantworten	VVINF	2	beantworten
erdroßle	VVFIN	2	erdroßle
anzusehn	VVIZU	2	anzusehn
mal	ADV	2	mal
Gesellschaft	NN	2	Gesellschaft
ärgern	VVINF	2	ärgern
Stärke	NN	2	Stärke
Torheit	NN	2	Torheit
halb	ADJA	2	halbe, halben
versichre	VVFIN	2	versichre
ei	FM, NE	2	Ei
Rede	NN	2	Rede
stets	ADV	2	stets
befinden	VVFIN	2	befinde, befindest
12	CARD	2	12
Bein	NN	2	Bein
Rtlr	NN	2	Rtlr
Gedult	NN	2	Gedult
lernen	VVINF, VVFIN	2	lernen, Lernen
fassen	VVFIN	2	faßte, fassen
erstlich	ADJD	2	erstlich
willigen	VVINF, VVFIN	2	willigen, willige
schwer	ADJD	2	schwer
dachts	VVFIN	2	dachts
gedulden	VVFIN	2	Gedulden, Gedulde
sichs	NE	2	sichs
sauer	ADJD, ADJA	2	sauer, sauren
unvernünftig	ADJA	2	unvernünftiger, unvernünftiges
dabei	PAV	2	dabei
lehren	VVINF	2	lehren
Ort|Orten	NN	2	Orten
Ausdrückungen	NN	2	Ausdrückungen
begegnen	VVFIN	2	begegnete, Begegnet
verstehn	ADJD, VVFIN	2	verstehn
Thesin	NN	2	Thesin
entgegen	PTKVZ	2	entgegen
fein	ADJA, ADJD	2	feinen, fein
abfinden	VVINF	2	abfinden
ehe	KOUS	2	ehe
vorsagen	VVFIN	2	vorsagt, vorsagte
Pfennig	NN	2	Pfennig
Exempel	NN	2	Exempel
unser	PPOSAT	2	unserer, unsrer
notwendig	ADJD	2	notwendig
dienen	VVINF, VVPP	2	dienen, gedient
antragen	VVINF	2	antragen
laut	ADJD, ADJA	2	lauter, lautem
leid	ADJD	2	leid
verzweifelt	ADJA	2	verzweifelten, verzweifelte
treffen	VVFIN	2	treffe, treffen
Gnade	NN	2	Gnaden
Bezahlung	NN	2	Bezahlung
alsdann	ADJD	2	alsdann
geschehen	VVINF, VVFIN	2	geschehen, geschieht
verlieren	VVFIN, VVPP	2	verlöre, verloren
Habseligkeit	NN	2	Habseligkeit
widersprechen	VVINF	2	widersprechen
fünfzig	CARD	2	fünfzig
Leib	NN	2	Leib
26	CARD	2	26
Aber	NN	2	Aber
dirs	NN	2	dirs
kriegen	VVINF, VVFIN	2	kriegen
Schatz	NN	2	Schatzes, Schatz
anwenden	VVFIN, VVPP	2	anwende, angewandt
wagen	VVINF	2	wagen
Dienerin	NN	2	Dienerin
nennen	VVINF, VVFIN	2	nennen, nenne
jen	PDAT, PDS	2	jenem, jener
Mittel	NN	2	Mittel
werter	ADJA	2	werter
beständig	ADJD, ADJA	2	beständig, beständige
Freiheit	NN	2	Freiheit
Freude	NN	2	Freuden
hin	ADV, APZR	2	hin
List	NN	2	List
Sorge	NN	2	Sorge
Inhalt	NN	2	Inhalte
arm	ADJA	2	armes, arme
Irrtum	NN	2	Irrtum
unschuldig	ADJA	2	unschuldiges
Beistand	NN	2	Beistand
tanzen	VVINF	2	tanzen
reizend	ADJA	2	reizende
weiß	ADJD	2	weiß
sorgen	VVFIN	2	Sorgen
acht	CARD, ADJA	2	acht
funfzig	NN, CARD	2	funfzig
Bart	NN	2	Bart
schaffen	VVFIN, VVINF	2	schafft, schaffen
Schicksal	NN	2	Schicksal
besondern	VVFIN	2	besondre
besonders	ADV	2	Besonders
Feind	NN	2	Feinden, Feindes
besorgen	VVFIN	2	besorge
verfluchter	ADJA	2	Verfluchter
fallen|gefallen	VVPP	2	gefallen
beide	PIAT, PIS	2	beide
Nachdenken	NN	2	Nachdenken
Wein	NN	2	Wein
Familie	NN	2	Familien, Familie
Stelzfuß	NN	2	Stelzfuß
hintenraus	VVFIN	2	hintenraus
unvergleichlich	ADJA	2	Unvergleichlicher, unvergleichlicher
dreißig	CARD	2	dreißig
verstehens	VVFIN	2	verstehens
Nase	NN	2	Nase
Beschreibung	NN	2	Beschreibung
Verstand	NN	2	Verstand
tief	ADJD	2	tief, tiefer
ausdrücken	VVINF	2	ausdrücken
christlich	ADJD, ADJA	2	christlich, christlichen
dreifach	ADJA	2	dreifachen
bins	VVFIN	2	bins
umgehen	VVIZU, VVFIN	2	umzugehen, umgeht
Billard	NN	2	Billard
Hypothesin	NN	2	Hypothesin
Cabinet	ADJA	2	Cabinet
fahren|führen	VVFIN	2	führe
Vers	NN	2	Vers
Übel	NN	2	Übels, Übel
Schmause	NN	2	Schmause
gelten	VVFIN, VVINF	2	gilt, gelten
ists	VVFIN	2	ists
Gebackens	NN	2	Gebackens
jemand	PIS	2	jemanden, jemand
zeigen	VVINF	2	zeigen
wichtig	ADJA	2	wichtigen, wichtigsten
packen	VVIMP, VVINF	2	Pack, packen
überlegen	VVINF, VVPP	2	überlegen, überlegt
Überlegung	NN	2	Überlegung
Tanzen	NN	2	Tanzen
abhelfen	VVIZU, VVINF	2	abzuhelfen, abhelfen
zanken	VVINF	2	zanken
alleine	ADV	2	alleine
oft	ADV	2	oft
Auge	NN	2	Augen
Gabe	NN	2	Gabe
Spötterei	NN	2	Spötterei
höflich	ADJD	2	höflicher, höflich
feurig	ADJA	2	feurigen, feurige
fahren	VVFIN, VVPP	2	fahren, gefahren
Maul	NN	2	Maul, Maule
Jugend	NN	2	Jugend
freilich	ADV	2	freilich
davon	PAV	2	davon, Davon
treten	VVFIN	2	treten
natürlich	ADJA	2	natürliche, natürlichen
Schimpf	NN	2	Schimpf
allein	ADV	2	allein
hats	NN	1	hats
Kleid	NN	1	Kleider
drauf	PAV	1	drauf
draus	PAV	1	draus
Platz	NN	1	Platz
vergessen	VVPP	1	vergessen
jemals	ADV	1	jemals
vertraut	ADJD	1	vertraut
pflegen	VVFIN	1	pflegt
Wörtchen	NN	1	Wörtchen
desperat	ADJD	1	desperat
Figur	NN	1	Figur
Wasser	NN	1	Wasser
annehmen	VVINF	1	annehmen
Überfluss	NN	1	Überflusse
vorig	ADJA	1	vorige
vollens	ADV	1	vollens
allzuwohl	ADJD	1	allzuwohl
wahrlich	ADV	1	Wahrlich
anstatt	KOUI	1	Anstatt
Erzürne	VVFIN	1	Erzürne
Gefälligkeit	NN	1	Gefälligkeit
wertesten	ADJA	1	wertesten
hartnäckig	ADJD	1	hartnäckig
niederträchtig	ADJA	1	niederträchtige
wertester	ADJA	1	wertester
Eheleute	NN	1	Eheleute
Hauptpunkt	NN	1	Hauptpunkten
Kriegsmann	NN	1	Kriegsmann
90	CARD	1	90
gewaltig	ADJD	1	gewaltig
Text	NN	1	Text
erschlagen	VVFIN	1	erschlage
trotz	APPR	1	trotz
laß	ADJD	1	Laß
anstehet	VVFIN	1	anstehet
zielen	VVFIN	1	ziele
Zuckerlecken	NN	1	Zuckerlecken
verfertiget	VVFIN	1	verfertiget
Kätz	NN	1	Kätz
wegkommen	VVFIN	1	wegkomme
antreffen	VVINF	1	antreffen
Lächerliche	NN	1	Lächerliches
Monat	NN	1	Monaten
Nachbarschaft	NN	1	Nachbarschaft
Trost	NN	1	Trost
Blut	NN	1	Blut
Gutheit	NN	1	Gutheit
Wille	NN	1	Wille
Nichtswitz	NN	1	Nichtswitz
Antwort	NN	1	Antwort
Anstalt	NN	1	Anstalt
beklagen	VVINF	1	beklagen
tragen	VVINF	1	tragen
Herz	NN	1	Herzen
Motion	NN	1	Motion
Ernsthafte	NN	1	Ernsthaften
Gerichtsherr	NN	1	Gerichtsherr
erzeugen	VVFIN	1	erzeugt
Tändelei	NN	1	Tändelei
Dero	NE	1	Dero
Dutzend	NN	1	Dutzend
Spitzenmanne	NN	1	Spitzenmanne
Schande	NN	1	Schande
Arm|Arme	NN	1	Arme
Hahn	NN	1	Hahn
hochadliches	ADJA	1	hochadliches
Madame	NN	1	Madame
Köpfchen	NN	1	Köpfchen
Verzeihen	NN	1	Verzeihen
frei	PTKVZ	1	frei
Bauch	NN	1	Bauch
24.	ADJA	1	24.
verruckt	ADJD	1	verruckt
kömmst	VVFIN	1	kömmst
angehen	VVFIN	1	angeht
darnach	ADV	1	darnach
einen	ADJA	1	einen
vorgehen	VVFIN	1	vorgeht
allenfalls	ADV	1	allenfalls
Freigeist	NN	1	Freigeister
herkommen	VVINF	1	herkommen
Närrin	NN	1	Närrin
lüderlichen	ADJA	1	lüderlichen
Prügel	NN	1	Prügel
nahe	PTKVZ	1	nahe
nutzen	VVINF	1	nutzen
galant	ADJA	1	galante
Nichtswürdiger	NN	1	Nichtswürdiger
verraten	VVPP	1	verraten
Holla	NE	1	Holla
Käse	NN	1	Käse
herrschen	VVFIN	1	herrscht
leugnen	VVINF	1	leugnen
Müßiggänger	NN	1	Müßiggänger
hingehen	VVINF	1	hingehen
drittens	ADV	1	Drittens
Grille|Grillen	NN	1	Grillen
Miseriam	NE	1	Miseriam
Tochter	NN	1	Tochter
zerplatzen	VVINF	1	zerplatzen
zieren	VVFIN	1	ziert
singen	VVPP	1	gesungen
Säkulum	NN	1	Säkulum
Verbindung	NN	1	Verbindung
sollens	VVFIN	1	sollens
schenken	VVPP	1	geschenkt
Wenns	ADJD	1	Wenns
Intressen	NN	1	Intressen
17	CARD	1	17
mitteilen	VVIZU	1	mitzuteilen
anfangen	VVIZU	1	anzufangen
schämen	VVFIN	1	Schämen
aufsuchen	VVPP	1	aufgesucht
jede	PIAT	1	jedem
Betrieb	NN	1	Betrieb
kaiserlich	ADJA	1	kaiserliche
ausführen	VVINF	1	ausführen
Capitains	NN	1	Capitains
Naschmaul	NN	1	Naschmaul
fangen	VVFIN	1	fängst
entkommen	VVINF	1	entkommen
Gewohnheit	NN	1	Gewohnheit
Geschicklichkeit	NN	1	Geschicklichkeit
Lassen	NN	1	Lassen
achtzig	CARD	1	achtzig
zerfallen	VVPP	1	zerfallen
diese	PDS	1	dieses
untüchtig	ADJD	1	untüchtig
ungemein	ADJD	1	ungemein
Stoß	NN	1	Stoß
Consequens	NE	1	Consequens
fürstlich	ADJA	1	fürstliche
Unwille	NN	1	Unwillen
einbilden	VVINF	1	einbilden
Österreicher	NN	1	Österreichern
Schweig	NE	1	Schweig
abkaufen	VVPP	1	abgekauft
belieben	VVINF	1	belieben
neulich	ADV	1	neulich
Feldzuge	NN	1	Feldzuge
Fromme	NN	1	Frommen
Nebenzimmer	NN	1	Nebenzimmer
Erlaubnis	NN	1	Erlaubnis
Willkommen	NN	1	Willkommen
lärmen	VVFIN	1	lärmen
gewöhnen	VVPP	1	gewöhnt
überhören	VVINF	1	überhören
Nam	NE	1	Nam
Krankheit	NN	1	Krankheit
wievielste	ADJA	1	wievielste
wenden	VVFIN	1	Wenden
verzeihen|verziehen	VVFIN	1	Verziehen
zehnt	ADJA	1	zehnte
schalten	VVINF	1	schalten
anhängen	VVINF	1	anhängen
Reichtum	NN	1	Reichtum
ehrliebender	ADJA	1	ehrliebender
nie	ADV	1	nie
jetzo	ADJD	1	jetzo
Clarice	NE	1	Clarice
Garten	NN	1	Garten
Leutgen	VVFIN	1	Leutgen
Darinne	NN	1	Darinne
just	ADV	1	just
Streit	NN	1	Streit
Herausgehen	NN	1	Herausgehen
sitzen	VVFIN	1	sitzen
sechzehn	CARD	1	sechzehn
faul	ADJA	1	faulen
beschweren	VVINF	1	beschweren
unten	ADV	1	unten
Kohle	NN	1	Kohlen
wobei	PWAV	1	wobei
drucken	VVINF	1	drucken
Vogel	NN	1	Vogel
blühend	ADJA	1	blühenden
gönnen	VVFIN	1	gönne
schwarz	ADJA	1	schwarzer
Ton	NN	1	Ton
mannbares	ADJA	1	mannbares
erlösen	VVINF	1	erlösen
Ewr	NE	1	Ewr
Quark	NN	1	Quark
stiften	VVPP	1	gestiftet
Schuh	NN	1	Schuh
Komödie	NN	1	Komödie
Topp	NN	1	Topp
hübsch	ADJD	1	hübsch
Topf	NN	1	Töpfen
ohnedem	ADJD	1	ohnedem
leiden	VVINF	1	leiden
schweigen	VVIMP	1	Schweig
Bauer	NE	1	Bauer
stürmisch	ADJD	1	stürmisch
Traktat	NN	1	Traktaten
dringend	ADJD	1	dringend
Ehemann	NN	1	Ehemänner
wesentlich	ADJA	1	wesentliche
mannhaft	ADJD	1	mannhafter
Partie	NN	1	Partie
gelegnerer	ADJA	1	gelegnerer
Fleischerhund	NN	1	Fleischerhund
beiseite	PTKVZ	1	beiseite
Lehn-	TRUNC	1	Lehn-
ekeln	VVIMP	1	ekel
geschehn	VVFIN	1	geschehn
abgesetzt	ADJA	1	abgesetzte
mild	ADJA	1	milde
Ostern	NN	1	Ostern
herzlich	ADJD	1	herzlich
deswegen	PAV	1	deswegen
Hochzeitabend	NN	1	Hochzeitabend
hurtig	ADJA	1	hurtiger
verliebt	ADJA	1	verliebte
schalkhaft	ADJD	1	schalkhaft
zukünftig	ADJA	1	zukünftigen
Wahl	NN	1	Wahl
selber	ADV	1	selber
aufsetzen	VVPP	1	aufgesetzt
viertens	ADV	1	Viertens
Stoßen	NN	1	Stoßen
Narrenspossen	NN	1	Narrenspossen
fehlen	VVFIN	1	fehlt
Vorstellen	NN	1	Vorstellen
aufbringen	VVINF	1	aufbringen
benennen	VVINF	1	benennen
Sachte	NN	1	Sachte
Appetit	NN	1	Appetit
Gute	NN	1	Gutes
Unrecht	NN	1	Unrecht
Ehestand	NN	1	Ehestand
Franzose	NN	1	Franzosen
zuziehen	VVFIN	1	zuzieht
verschwendrischen	ADJA	1	verschwendrischen
Benennung	NN	1	Benennung
fliehen	VVFIN	1	floh
unbekümmert	ADJD	1	unbekümmert
michs	NE	1	michs
bange	ADJD	1	bange
Verlangen	NN	1	Verlangen
mythologisch	ADJA	1	mythologischem
stören	VVINF	1	stören
verlieben	VVPP	1	verliebt
Vorsehung	NN	1	Vorsehung
schaden	VVFIN	1	schadet
lächerlich	ADJD	1	lächerlich
bezeigen	VVINF	1	bezeigen
Feld	NN	1	Felde
Sara	NE	1	Sara
worüber	PWAV	1	worüber
Hörest	VVFIN	1	Hörest
folgen	VVFIN	1	folgen
Lied	NN	1	Lieder
hinterlassen	VVFIN	1	hinterläßt
unmöglich	ADJD	1	Unmöglich
Männersucht	NN	1	Männersucht
Sapienti	NN	1	Sapienti
Krame	NN	1	Krame
tummeln	VVINF	1	tummeln
Korbe	NN	1	Korbe
hoffen	VVFIN	1	hoffe
wässrig	ADJD	1	wäßrig
grob	ADJA	1	grobes
Bettler	NN	1	Bettler
Tanz	NN	1	Tänze
vorenthalten	VVPP	1	vorenthalten
Unwissenheit	NN	1	Unwissenheit
Probe	NN	1	Probe
abgedankt	ADJA	1	abgedankten
ausgäbst	VVFIN	1	ausgäbst
Täubchen	NN	1	Täubchen
bescheiden	ADJD	1	bescheidener
Kräusel	NN	1	Kräusel
entbehren	VVINF	1	entbehren
bunt	ADJD	1	bunt
Grube	NN	1	Grube
Flegel	NN	1	Flegel
not	PTKVZ	1	not
irre	PTKVZ	1	irre
erwerben	VVPP	1	erworben
Schmaus	NN	1	Schmaus
Aufsetzerin	NN	1	Aufsetzerin
appetitlich	ADJA	1	Appetitliche
eh	ADV	1	Eh
eingeständig	ADJD	1	eingeständig
Affengesichte	NN	1	Affengesichte
Ordnung	NN	1	Ordnung
außer	APPR	1	außer
Prozent	NN	1	Prozent
betriegen	VVFIN	1	betriegen
Kapitel	NN	1	Kapitel
Theater	NN	1	Theater
Lauf	NN	1	Lauf
Geschmacke	NN	1	Geschmacke
umhängen	VVINF	1	umhängen
Licht	NN	1	Licht
zittre	ADJD	1	zittre
darinne	NN	1	darinne
Post	NN	1	Post
Wette|Wetten	NN	1	Wetten
Omen	NN	1	Omen
ansehnlich	ADJA	1	ansehnlichen
unterlassen	VVINF	1	unterlassen
Laster	NN	1	Laster
16	CARD	1	16
19	CARD	1	19
freuen	VVFIN	1	Freuen
sechs	CARD	1	sechs
unterdessen	ADV	1	unterdessen
Kennzeichen	NN	1	Kennzeichen
bestehen	VVFIN	1	besteht
Närrchen	NN	1	Närrchen
Bürger	NN	1	Bürger
sat	VVFIN	1	sat
Rechthaberin	NN	1	Rechthaberin
Reifrock	NN	1	Reifrock
Cabinetstückchen	VVFIN	1	Cabinetstückchen
verdienen	VVPP	1	verdient
Brunette	NN	1	Brunette
Erinnern	NN	1	Erinnern
wacker	ADJD	1	wacker
wunderbar	ADJD	1	wunderbar
führen	VVINF	1	führen
Dichter	NN	1	Dichter
unverständiger	ADJA	1	unverständiger
König	NN	1	König
fallen|fällen	VVFIN	1	fällt
otia	NE	1	otia
Ärgste	NN	1	Ärgste
bekümmern	VVFIN	1	bekümmern
merken	VVFIN	1	merkt
fressen	VVFIN	1	frißt
Tochtermann	NE	1	Tochtermann
Schwanz	NN	1	Schwanze
erkundigen	VVINF	1	erkundigen
lebhaft	ADJA	1	lebhafte
schreien	VVFIN	1	schreit
einst	ADV	1	einst
Ecke	NN	1	Ecke
Wache	NN	1	Wache
einräumen	VVINF	1	einräumen
kriegerisch	ADJA	1	kriegerische
Kellertür	NN	1	Kellertür
versichern	VVFIN	1	versichere
Hitze	NN	1	Hitze
Anspruch	NN	1	Anspruch
mans	ADJD	1	mans
Glücke	NN	1	Glücke
gehörig	ADJA	1	gehörige
zerlappte	ADJA	1	zerlappte
stinken	VVFIN	1	stinken
einfallen	VVINF	1	einfallen
teuer	ADJD	1	teuer
beiderseits	APPR	1	beiderseits
Werk	NN	1	Werk
Grobheit	NN	1	Grobheit
Stich	NN	1	Stich
500	CARD	1	500
Verbeugung	NN	1	Verbeugung
Schuldhausen	NN	1	Schuldhausen
Engländer	NN	1	Engländern
Vorhaben	NN	1	Vorhaben
Menuet	NN	1	Menuet
krank	ADJD	1	krank
Anstiften	NN	1	Anstiften
ausschlafen	VVPP	1	ausgeschlafen
Erwägung	NN	1	Erwägung
Mund	NN	1	Mund
eigennützig	ADJD	1	eigennützig
zuzählen	VVPP	1	zugezählt
goldnes	ADJA	1	goldnes
erschaffen	VVPP	1	erschaffen
anderwärts	ADV	1	anderwärts
Erzeigen	VVFIN	1	Erzeigen
seufzet	VVFIN	1	seufzet
bieten	VVFIN	1	biete
poetisch	ADJD	1	poetisch
Zeile	NN	1	Zeile
vertrösten	VVINF	1	vertrösten
Anderns	ADV	1	Anderns
parat	ADJD	1	parat
beneidenswert	ADJD	1	beneidenswert
erkenntlich	ADJD	1	erkenntlich
beißend	ADJA	1	beißenden
geschickt	ADJD	1	geschickt
mannbar	ADJA	1	mannbare
Montierung	NN	1	Montierung
Gulden	NN	1	Gulden
bloß	ADJD	1	Bloß
hinbegeben	VVINF	1	hinbegeben
bemühen	VVINF	1	bemühen
hierinnen	NN	1	hierinnen
schamhaft	ADJD	1	schamhaft
englisch	ADJA	1	englisches
fragen	VVINF	1	fragen
übertreffen	VVPP	1	übertroffen
nötig	ADJD	1	nötig
nötigen	VVFIN	1	nötigen
Schlesien	NE	1	Schlesien
gebrauchen	VVINF	1	gebrauchen
Allusion	NN	1	Allusion
Leutchen	NN	1	Leutchen
verfließen	VVPP	1	verflossen
eitel	ADJD	1	eitel
diejenigen	PDAT	1	diejenigen
aussinnen	VVPP	1	ausgesonnen
her	PTKVZ	1	her
stark	ADJD	1	stark
gesagt	ADJD	1	gesagt
los	ADJA	1	Loser
Raserei	NN	1	Raserei
Zweck	NN	1	Zweck
Schuldmann	NN	1	Schuldmann
hochöchst	ADJD	1	höchst
eingehen	VVINF	1	eingehen
widerstehen	VVFIN	1	Widerstehen
erinnern	VVINF	1	erinnern
vors	APPRART	1	vors
Valer	NE	1	Valer
am	PTKA	1	am
kleiden	VVPP	1	gekleidet
Freiersmann	NN	1	Freiersmann
Judas	NE	1	Judas
satyrischem	ADJA	1	satyrischem
pfui	ITJ	1	Pfui
gelinde	ADJD	1	gelinder
eigentlich	ADV	1	eigentlich
Edelmannen	NN	1	Edelmannen
hölzern	ADJA	1	hölzerne
gestrig	ADJA	1	gestrige
Entzückung	NN	1	Entzückung
leisten	VVINF	1	leisten
einfinden	VVINF	1	einfinden
Musae	NN	1	Musae
gibts	NN	1	gibts
leichtsinniger	ADJA	1	leichtsinniger
Traum	NN	1	Traum
Annehmlichkeit	NN	1	Annehmlichkeiten
Ware	NN	1	Ware
Rücken	NN	1	Rücken
Feinheit	NN	1	Feinheit
unterstehen	VVINF	1	unterstehen
Liebhaber	NN	1	Liebhaber
Plunder	NN	1	Plunder
Türe	NN	1	Türe
Lehre	NN	1	Lehre
Körper	NN	1	Körper
heben	VVFIN	1	hebt
Schafbock	NN	1	Schafbock
besitzen	VVFIN	1	besitze
übern	APPRART	1	übern
Mühe	NN	1	Mühe
nachkommen	VVINF	1	nachkommen
fernern	ADJA	1	fernern
Tatze	NN	1	Tatzen
darum	PAV	1	darum
Offizier	NN	1	Offizier
Apfel	NN	1	Apfel
Universalerbe	NN	1	Universalerbe
hingehn	ADJD	1	hingehn
bedauren	NN	1	bedauren
Adel	NN	1	Adel
anderswo	ADV	1	anderswo
beitragen	VVPP	1	beigetragen
Recht	NN	1	Recht
Injurie	NN	1	Injurie
theologisch-polemisch-poetischen	ADJA	1	theologisch-polemisch-poetischen
zumal	KOUS	1	Zumal
währen	VVINF	1	währen
gekrönt	ADJA	1	gekrönten
rasend	ADJD	1	rasend
Meisterstück	NN	1	Meisterstück
willens	ADJD	1	willens
Schlingel	NN	1	Schlingel
vorläufig	ADJD	1	vorläufig
Laus	NN	1	Laus
dreimal	ADV	1	dreimal
Vorschlag	NN	1	Vorschläge
Jawort	NN	1	Jawort
Alter	NN	1	Alter
22	CARD	1	22
abgewinnen	VVPP	1	abgewonnen
rechtschaffner	ADJA	1	rechtschaffner
Neidische	NN	1	Neidische
Ermunterung	NN	1	Ermunterung
Bessers	NN	1	Bessers
Lumpenhund	NN	1	Lumpenhund
erlauben	VVINF	1	erlauben
Mut	NN	1	Mut
Henne	NN	1	Henne
schimpfen	VVINF	1	schimpfen
bedeuten	VVINF	1	bedeuten
Holländer	NN	1	Holländern
Reden	NN	1	Redens
unerträglich	ADJD	1	unerträglich
Muster	NN	1	Muster
bißgen	NN	1	bißgen
auslesen	VVPP	1	ausgelesen
lachend	ADJA	1	lachende
ertragen	VVINF	1	ertragen
Brot	NN	1	Brote
zufrieden	ADJD	1	zufrieden
fallen	VVFIN	1	falle
Schalkhaften	NN	1	Schalkhaften
beschlagen	VVPP	1	beschlagen
Verkleidung	NN	1	Verkleidung
vorteilhaft	ADJA	1	vorteilhafte
Geplaudre	NN	1	Geplaudre
Ehekrüpel	NN	1	Ehekrüpel
Zettel	NN	1	Zettel
bedenken	VVFIN	1	bedenkst
nackigte	ADJA	1	nackigte
darüber	PAV	1	darüber
jetzig	ADJA	1	jetziger
Eheteufel	NN	1	Eheteufel
Verrichtung	NN	1	Verrichtungen
Falsche	NN	1	Falsche
Bedingung	NN	1	Bedingungen
Umstand	NN	1	Umstände
Ursache	NN	1	Ursache
Poesie	NN	1	Poesie
schamrot	ADJD	1	schamrot
Bediente	NN	1	Bedienten
Mutter	NN	1	Mutter
nah	ADJA	1	nächste
unrecht	ADJD	1	unrecht
Adlicher	NN	1	Adlicher
hitzig	ADJD	1	hitzig
Adlichen	NN	1	Adlichen
Verächter	NN	1	Verächter
Geldborgern	NN	1	Geldborgern
Klügste	NN	1	Klügste
unsinnig	ADJA	1	unsinniges
Hören	NN	1	Hören
frisch	ADJD	1	Frisch
abend	ADV	1	Abend
Großmut	NN	1	Großmut
Taufschein	NN	1	Taufschein
hervortun	VVFIN	1	hervortut
Titel	NN	1	Titel
Held	NN	1	Helden
gelb	ADJA	1	gelber
redst	ADJD	1	redst
treiben	VVINF	1	treiben
manchmal	ADV	1	manchmal
seh	XY	1	seh
aufschlagen	VVPP	1	aufgeschlagen
klug	ADJD	1	klug
nützlich	ADJA	1	nützlicher
Katze	NN	1	Katze
Entschließung	NN	1	Entschließungen
Quere	NN	1	Quere
Nein	NN	1	Nein
Dokument	NN	1	Dokumente
darbieten	VVFIN	1	darbiete
Schaden	NN	1	Schaden
Zank	NN	1	Zank
zusammen	PTKVZ	1	zusammen
Gesellschaftliche	NN	1	Gesellschaftliche
walten	VVINF	1	walten
überheben	VVFIN	1	überheben
Sprung	NN	1	Sprünge
hinters	APPRART	1	hinters
scribentis	NN	1	scribentis
Ding	NN	1	Ding
abfertigen	VVINF	1	abfertigen
verewiget	VVFIN	1	verewiget
ziehn	VVFIN	1	ziehn
gehören|hören	VVPP	1	gehört
Arbeit	NN	1	Arbeit
jungüngst	ADJD	1	jüngst
Besuch	NN	1	Besuch
Hausrat	NN	1	Hausrat
beweisen	VVINF	1	beweisen
verhasst	ADJD	1	verhaßt
Rekommendation	NN	1	Rekommendation
andermal	ADV	1	andermal
Gehn	VVFIN	1	Gehn
herumspringen	VVINF	1	herumspringen
gebührend	ADJA	1	gebührende
dreien	CARD	1	dreien
beschäftiget	VVFIN	1	beschäftiget
Schätzchen	NN	1	Schätzchen
wohlgetroffenen	ADJA	1	wohlgetroffenen
Hindernis	NN	1	Hindernis
Erb-	TRUNC	1	Erb-
glühend	ADJA	1	glühende
Vater	NN	1	Vaters
erschrecken	VVFIN	1	Erschrak
Weibchen	NN	1	Weibchen
probieren	VVPP	1	probiert
Schamröte	NN	1	Schamröte
Schämen	NN	1	Schämen
Beredsamkeit	NN	1	Beredsamkeit
Zufall	NN	1	Zufall
Armingen	NN	1	Armingen
Finger	NN	1	Finger
Bemühen	NN	1	Bemühen
hinter	APPR	1	hinter
verderbst	VVFIN	1	verderbst
zwölft	ADJA	1	zwölfte
verziehen	VVINF	1	verziehen
Gefallen	NN	1	Gefallen
dulden	VVINF	1	dulden
stückweise	ADJD	1	stückweise
allerdings	ADV	1	allerdings
Menge	NN	1	Menge
verfahren	VVPP	1	verfahren
vorbringen	VVFIN	1	vorbringt
göttlich	ADJA	1	göttlichen
handeln	VVINF	1	handeln
Machts	NN	1	Machts
Plappermaul	NN	1	Plappermaul
Gemütsart	NN	1	Gemütsart
erlangen	VVPP	1	erlangt
Betragen	NN	1	Betragen
gesehn	VVFIN	1	gesehn
leicht	ADJA	1	leichte
Frauenzimmers	NN	1	Frauenzimmers
willen	APPO	1	willen
unterbringen	VVFIN	1	unterbringe
erteilen	VVPP	1	erteilt
Gewissers	NN	1	Gewissers
hierbei	PAV	1	hierbei
Anlass	NN	1	Anlaß
strafbar	ADJD	1	strafbar
Ausnahme	NN	1	Ausnahme
Cabinettüre	NN	1	Cabinettüre
Gut	NN	1	Gut
letzt	ADJA	1	letzten
Stückgen	NN	1	Stückgen
anakreontische	ADJA	1	anakreontische
zuhören	VVIZU	1	zuzuhören
Leben	NN	1	Leben
Anno	NE	1	Anno
Kunst	NN	1	Kunst
Widersprechen	NN	1	Widersprechen
einziehen	VVPP	1	eingezogen
Hexe	NN	1	Hexe
Arrest	NN	1	Arrest
eigensinnig	ADJD	1	eigensinnig
gestehen	VVINF	1	gestehen
Bruder	NN	1	Bruder
Ort	NN	1	Orte
Dingergen	NN	1	Dingergen
Einwilligung	NN	1	Einwilligung
ergeben	ADJA	1	Ergebene
30	CARD	1	30
Hochzeitcarmen	NN	1	Hochzeitcarmen
voll	ADJD	1	voll
Hut	NN	1	Hut
Land	NN	1	Länder
verschonen	VVPP	1	verschont
Angriff	NN	1	Angriff
Erbe|Erben	NN	1	Erben
Madam	NN	1	Madam
begreifen	VVFIN	1	begreife
vergraben	VVPP	1	vergraben
Sachse	NN	1	Sachsen
Worinne	NN	1	Worinne
lammen	ADJD	1	lammen
Zahn	NN	1	Zähne
geschieden	ADJA	1	geschiedene
widerrufst	VVFIN	1	widerrufst
fortpflanzen	VVINF	1	fortpflanzen
majestätisch	ADJA	1	majestätischer
ziemlich	ADV	1	ziemlich
Erklärung	NN	1	Erklärung
heiß	ADJD	1	heiß
Übergang	NN	1	Übergänge
Betteldorf	NN	1	Betteldorf
verzählen	VVPP	1	verzählt
ältern	VVINF	1	ältern
secessum	ADJA	1	secessum
Rekompenz	NN	1	Rekompenz
gesund	ADJD	1	gesund
Sinn	NN	1	Sinne
Vaterland	NN	1	Vaterland
Brücke	NN	1	Brücke
neumodisch	ADJA	1	neumodische
Anweisung	NN	1	Anweisung
Woche	NN	1	Woche
unbekannt	ADJA	1	unbekannter
ablaufen	VVINF	1	ablaufen
Gefahr	NN	1	Gefahr
kommend	ADJA	1	kommende
Beispiel	NN	1	Beispiele
fluchen	VVFIN	1	flucht
reißen	VVFIN	1	reißt
bekennen	VVFIN	1	bekennen
Mus|Muse	NN	1	Musen
kaum	ADV	1	kaum
Wesentliche	NN	1	Wesentliche
Abschied	NN	1	Abschied
Vorrecht	NN	1	Vorrecht
einerlei	ADV	1	einerlei
gedenken	VVFIN	1	gedenke
sonderlich	ADJD	1	Sonderlich
dahin	PAV	1	dahin
verwünscht	ADJA	1	verwünschte
irrest	VVFIN	1	irrest
dünken	VVFIN	1	dünkt
umsonst	ADV	1	umsonst
adliches	ADJA	1	adliches
adlichem	ADJA	1	adlichem
Vortreffliches	NN	1	Vortreffliches
lebendig	ADJD	1	lebendig
überraschen	VVPP	1	überrascht
Belieben	NN	1	Belieben
ichs	ADJA	1	ichs
Zorn	NN	1	Zorn
weisen	VVFIN	1	Weise
unhöflich	ADJD	1	unhöflich
zärtlich	ADJA	1	zärtliche
wegnehmen	VVINF	1	wegnehmen
Geschwister	NN	1	Geschwister
Genug	NN	1	Genug
Ernst	NN	1	Ernst
überirdisch	ADJA	1	überirdische
betrügen	VVINF	1	betrügen
munter	ADJA	1	muntern
Bene	NE	1	Bene
Anfall	NN	1	Anfällen
uneben	ADJD	1	uneben
Schluss	NN	1	Schlusse
herankriechen	VVFIN	1	herankriechen
Äußere	NN	1	Äußere
Blick	NN	1	Blicke
vorstellen	VVPP	1	vorgestellt
Betrügerei	NN	1	Betrügerei
unzähligmal	ADV	1	unzähligmal
Schelm	NN	1	Schelm
obgleich	KOUS	1	Obgleich
ausweisen	VVINF	1	ausweisen
gefallen	VVFIN	1	Gefiel
bessern	VVINF	1	bessern
fünfhundert	CARD	1	fünfhundert
allzusehr	VVFIN	1	allzusehr
aushelfen	VVPP	1	ausgeholfen
Stoff	NN	1	Stoff
Ohrfeige	NN	1	Ohrfeige
allezeit	ADV	1	allezeit
Rolle	NN	1	Rolle
vergebens	ADV	1	vergebens
Anteil	NN	1	Anteil
beschwerst	VVFIN	1	beschwerst
Achsel	NN	1	Achsel
Wahrheit	NN	1	Wahrheit
widersetzen	VVINF	1	widersetzen
scherzen	VVINF	1	scherzen
Antecedens	NN	1	Antecedens
quaerunt	VVFIN	1	quaerunt
scherzhaftem	ADJA	1	scherzhaftem
beteuren	NN	1	beteuren
einfließen	VVINF	1	einfließen
Gefangen	NN	1	Gefangen
Creditoren	NN	1	Creditoren
wild	ADJA	1	wilder
Creditores	NN	1	Creditores
Hoffnung	NN	1	Hoffnung
nütze	ADV	1	nütze
längst	ADV	1	längst
ändern	VVINF	1	ändern
spitzbübisch	ADJD	1	spitzbübisch
Christi	NE	1	Christi
Forderung	NN	1	Forderungen
beschreiben	VVINF	1	beschreiben
Ehrfurcht	NN	1	Ehrfurcht
Schwäger	NN	1	Schwäger
allzuviel	PIS	1	allzuviel
verstellen	VVPP	1	verstellt
anmelden	VVPP	1	angemeldet
Knebelbart	NN	1	Knebelbart
Kaffeehause	NN	1	Kaffeehause
Tasche	NN	1	Tasche
Moral	NN	1	Moral
verfluchen	VVPP	1	verflucht
süß	ADJA	1	süße
Oronten	VVFIN	1	Oronten
Männchen	NN	1	Männchen
Naturlehre	NN	1	Naturlehre
Profession	NN	1	Profession
leidig	ADJA	1	leidige
ehlichen	ADJA	1	ehlichen
bemächtige	VVFIN	1	bemächtige
eindringen	VVINF	1	eindringen
Satire	NN	1	Satiren
denken|gedenken	VVPP	1	gedacht
drücken	VVFIN	1	drückt
Böhmen	NE	1	Böhmen
Drolligtes	NN	1	Drolligtes
naschen	VVFIN	1	nascht
wetten	VVFIN	1	wetten
Maus	NN	1	Maus
dahinter	PAV	1	Dahinter
gegenen	ADJA	1	gegenen
Beschimpfung	NN	1	Beschimpfung
Ratschlag	NN	1	Ratschlägen
oben	ADV	1	oben
drollichter	ADJD	1	drollichter
Beschwerlichkeiten	NN	1	Beschwerlichkeiten
dahinten	ADV	1	dahinten
einig	ADJD	1	einig
anschreiben	VVPP	1	angeschrieben
eins	CARD	1	eins
Bildung	NN	1	Bildung
Erstlich	ADJD	1	Erstlich
geheim	ADJD	1	geheim
derselb	PDAT	1	desselben
neutral	ADJD	1	neutral
Welt	NN	1	Welt
Kundmann	NN	1	Kundmann
davor	PAV	1	davor
Gold	NN	1	Golde
seit	APPR	1	seit
Diener	NN	1	Diener
zweifeln	VVFIN	1	Zweifelst
wohlgewachsenen	ADJA	1	wohlgewachsenen
verführst	VVFIN	1	verführst
historisch	ADJA	1	historischem
einbringen	VVFIN	1	einbringt
Untüchtig	ADJD	1	Untüchtig
Reihe	NN	1	Reihen
Versehn	NN	1	Versehn
Lust	NN	1	Lust
zugreifen	VVINF	1	zugreifen
