Number of all words 2687
Nummber of different lemmas 1236

Lemma	POS	Frequency	Tokens
versteh	RB, CD, VBN, PRP, NNS, VB, NN, DT, WP, IN, JJ, PRP$, MD, WDT	49	nicht, nur, halb, übrig, Er, Umstände, vorher, niemals, Schon, sagen, gottlose, 12000, nun, Wasser, sei, Denkt, heiraten, Der, sehn, ich, Was, Zum, niederträchtig, zu, meine, sie, sein, prächtig, fünf, verboten, muß, Nicht, könnte, handeln, nichts, Ihn, will, Klugheit, schon, geschrieben, eine, Vetter, was, ist, ihr, ihn
Leander	NN, VB, CC, JJ, DT, IN, MD, RB, PRP, RP	47	Leander, ist, und, ich, Sollte, den, erklärte, da, gedulden, unschuldig, wollen, Ja, bereden, O, will, zu, Aber, erstaunet, erkundigen, ungeschickt, auch, blieb, Er, weiß, Leandern, kämpfen, Behüte, diesen, Goldes, fest, Sie, verblendet, kommen, verzeihen, bin, wenigstens
Freund	NNS, NN, IN, PRP, PRP$, DT, RP, VB, WP, RB, JJ, CC, MD	47	Freunde, Freund, von, Art, mit, uns, für, auf, Ihr, an, der, besorge, gewiß, ein, einmal, beleidigen, Was, aber, wird, Ei, ist, möglich, zu, nur, und, brechen, das, als, Einfall, heißt, ich, ja, sie, schänden, sollte, Mein, kenne, auch, setzten, sich, da, nicht
Damon	NN, VB, MD, RB, IN, DT, JJ, PRP, CC, PRP$	42	Damon, erklären, kömmt, Dienerin, So, sehr, vorkommen, Unglück, der, seinetwegen, Sie, daß, und, den, sagten, St, Drum, haben, dieses, Er, mich, ha, glücklichste, Ja, zu, ich, hintergehen, keinen, Wohl, anfangen, reden, kennen, lernen
wohl	RB, RP, PRP, VB, NN, DT, MD, JJ, IN, PRP$, WDT	35	wohl, Sie, werde, sie, sein, Mannspersonen, es, der, beide, Hartnäckigkeit, wird, den, ein, ich, Könnte, wollen, würde, irre, Ob, Leb, eben, Verdacht, mein, Freund, mir, Leben
Versteh	PRP, NN, JJ, IN, NNP, RB, DT, VB, WP	30	Er, Häusern, jungen, unglücklich, mit, Ers, gescheute, Vetter, Närrin, genug, geholfen, Ehre, ein, besessen, gestohlen, Was, werden, umsonst, Testamente, Wer, mich, drauf, Nase, alles, nütze, ganz, ihr, schamhaft
Freundschaft	NN, IN, NNS, PRP, VB, RB	27	Freundschaft, von, Lobe, in, sie, Begriffen, er, Damon, zürnen, bemühen, ob, daß, bin, Ja, so, uns, da, Pflichten, habe
sagen	VB, MD, PRP, RB, PRP$, NN, IN, WP, WDT	24	sagen, trennen, wollen, Ihnen, nicht, will, meinem, liebster, seinem, noch, auch, Was, Ihm, doch, was, mich, mir, ja, Euch, Vetter
Herr	NN, JJ, RB, PRP$, PRP, VB, IN, MD	20	Herr, Hier, Ihre, Sie, widerlegen, wenig, wohl, folgen, wollen, sich, St, denn, mich, anzufangen, Höre
Frau	VB, CC, WDT, JJ, PRP, NNS, IN, DT, RB	20	darf, beurteilt, und, was, es, sich, Neigungen, wenn, andern, bei, kann, auf, doch, zu, etwa, mich, nach, von
Vetter	PRP, NN, CD, JJ, VB, WP	19	Er, hieher, tausend, er, Ja, mich, Denkt, Nein, Höre, sein, Ihrem, ersetzen, Sie, Was
weeissen	VB, MD, WRB, WDT, NN, CC, JJ, VBN, PRP$	19	weiß, wollten, vorkommen, aber, was, bereden, habe, denken, Und, Aber, naseweis, sein, ha, gewesen, mein, Mein
Liebe	NN, VB, IN, RB, JJ, DT	18	Liebe, beleidigen, von, nicht, Wesentlichen, Sie, so, Freund, die, wird
gut	JJ, PRP, CD, IN, VB, NN	16	gut, mir, es, zwei, für, wird, Rat, ist, allezeit, unter, mich, itzo, weiß
gewiss	NN, DT, PRP$, VB, IN, PRP, CC	14	gewiß, Euch, der, ihre, weiß, von, sehen, Er, Ihr, ich, aber
soen	VBN, VB, NN, RB, DT, PRP, TO	14	so, vorkommen, bißgen, Grausamer, Herr, Vermögen, Handel, die, gewuchert, getan, sein, uns, wegen
andern	JJ, DT, IN, CC, WDT, NN, RB	14	andern, Mährgen, oder, auf, einer, über, gegen, welche, Freundes, auch
ha	NN, VB, DT, RP	14	ha, Welt, Ha, verlassen, beistehen, auch, Absichten, andermal
Himmel	NN, IN, PRP, VB, JJ	14	Himmel, zu, mich, sei, auf, wir, Gott, wird, sorgen, Winter, wäre, gewisseste, erklären, wiederholen
mussen	VB, RB, JJ, NN, TO, PRP	13	muß, nehmen, genug, es, hat, Scham, angenehm, tun, zu, Sie
Schiff	DT, IN, PRP, VB, VBN, NN	13	ein, die, daß, Er, dazu, gewesen, Leanders, Ja, mit, dem
Ehre	NN, RB, PRP, UH, IN	13	Ehre, nicht, Güter, Sie, Reichtum, Ach, ach, Um, bei, ihn, oder, trotz
Unglück	VB, NN, PRP, JJ, IN	12	ist, Leander, Glück, Unglück, mir, Ihnen, recht, ihm, für
Ach	NN, DT, VB, JJ, IN, CD, PRP	12	Ach, der, können, verdrießlich, wie, halb, wenn, Er, wenig, hat, so
Vermögen	PRP, NN, DT, IN, JJ, PRP$	11	ihr, Herz, mir, man, er, mit, ich, mein, verliere
Herz	NN, IN, RP, PRP, JJ, VB	11	Herz, von, Anhalten, angebracht, auf, sie, er, ich, fragen, als
Gott	NN, CC, VB, VBN, MD, JJ, PRP, DT	11	Gott, Aber, können, gesprochen, Wollte, wollte, Geld, verschwenderische, ihr, der, Untreue
wenig	RB, DT, PRP, NN	11	wenig, eben, ein, ihm, beiden, gehabt, mich, erworbener
eben	WRB, RB, DT, VB, IN, NN, PRP$	10	eben, nur, selber, sind, einer, aus, höret, solle, mein, Freund
glauben	VB, PRP, NN, TO	10	glauben, glaube, Ihnen, Leben, es, ausschlagen, zu, mir, ich
wahr	RP, JJ, DT, PRP, MD	10	wahr, ja, edel, das, mich, sollte, es
genug	RB, PRP, DT, NN	10	genug, es, einem, ihn, uns, mir, nicht, schon, Unglücke
lieb	NN, JJ, MD, IN, PRP, RB, VB	10	lieben, lieber, wollen, daß, Ihnen, eher, würden, ihr, mir
Lisette	NN, IN, VB, PRP, DT	10	Lisette, blindlings, He, gehen, fehlt, Ja, mir, betrübt, Dem
Recht	NN, RB, PRP, DT, CC, VB	9	Recht, so, Sie, denn, ein, und, hat
kömmen	MD, RB, UH, NN, IN, PRP$	9	kömmt, bald, Nur, Nun, Hui, von, Herr, ihrem, aufs
itzo	NN, PRP	9	itzo, Ich, Leander, er, Er, es
bekommen	NN, PRP, JJ, NNS, IN, VB	9	Herr, Wort, Kapital, es, Geldes, falsche, Tonnen, nun, hatten
erst	PRP, PRP$, RB, DT, IN	9	mir, unsere, darauf, das, Zu, ihm, mich, schon, sie
alsdenn	IN, CC, PRP, JJ, VB	8	wenn, und, sie, ich, er, Sie, werde
erklären	IN, PRP, NN, VB	8	am, für, ihr, Ihren, uns, ist, glücklichsten
Leandern	NN, CC, PRP, VB	8	Damon, oder, und, mich, sich, geben, Er, erzürnet
reden	DT, IN, PRP, RB, NN	8	die, mit, einander, ihm, mir, von, nun, entzücket
dazuen	NN, JJ, PRP$, IN, VB	8	Paar, scheinbare, unsre, wenig, hätten, Ihre, nunmehr, zu
Nachricht	RP, PRP, DT	8	wieder, ich, mich, diese, die, Sie
sehen	VBN, PRP, NN, MD, DT, VB	8	sehen, ihn, Sie, Nein, Händen, will, das, tun
setzen	TO, PRP$, DT, VB, NN, RB	8	zu, Ihr, den, bestehen, Probe, Gunst, die, viel
Zeit	PRP, IN, NN, VB	8	Ihnen, mit, Lust, ihr, Damon, ich, zu, wird
bald	WRB, IN, VB, NN	8	bald, daß, merke, Wenn, kommen, Kommen
Ihrem	NNS, PRP, IN, NN	7	Gedanken, Sie, als, Verräterei, sie, Nachricht, Ihnen
glücklich	IN, DT, PRP, NN, VB	7	wenn, ein, ich, Schiff, ist, Sie
gern	PRP, NN, JJ, VB, RB, PRP$	7	Sie, Vorschlag, sie, wissen, eben, seinen, war
Neigung	PRP$, NN, VB, CC, PRP	7	unsrer, Zeit, wird, Mannspersonen, und, sucht, uns
Reden	NN, VB, IN, PRP	7	Reden, Eure, nennen, Ach, daß, Ihnen, sind
Witwe	JJ, RB, DT, IN	7	jungen, nun, der, die, zu
Vergnügen	NN, JJ, PRP	7	Vergnügen, selbst, Ehre, ich, mir
liebster	NN, VB, DT, RB	7	Nein, glauben, setzen, habe, wäre, Der, wohl
verzeihen	VB, NN, PRP, DT	7	verzeihen, wertester, Ich, andern, solchen, mir, Ihnen
suchen	NN, PRP, IN, JJ, CD, VB	7	jemanden, sie, an, mögliche, zehn, würden, Zeit
gar	RB, DT, VB	7	gar, aber, einem, zweifeln, das
unglücklich	NN, PRP, NNS, PRP$, RB	7	Himmel, Schiff, Ich, Kapitale, Ihre, wenn
zwei	CD, JJ, IN, VB, PRP	7	zwei, munter, wenn, können, Sie, habe
Ha	NN, DT, RB, JJ, PRP	7	Ha, der, nun, redlich, ich, guten, Ein
verlieren	PRP$, NN, CC	6	sein, Reichtümer, mein, und, Freund
Freundes	NN	6	Freundes, Unkosten, Pflicht, Gegenwart, Falschheit
hören	VB, NNS, PRP, NN	6	hören, Freunde, ich, Frau, mir, Himmel
Gedanke	CC, VB, DT, IN	6	und, hat, die, befinde, in, ganz
Handel	IN, DT	6	bei, dem
klein	RB, VB	6	nur, ist, auch, noch, wohl
Absichten	DT, RB, PRP$	6	dem, die, also, wohl, seine
Art	NN, DT, IN	6	Art, eine, auf, alle, mit
vielleicht	RB, WDT, PRP, JJ, VB	6	vielleicht, das, es, harten, ich, wird
fein	NN, RB, WRB, JJ, PRP	6	Fein, nicht, wo, lustig, ich, uns
verstehen	VB, WRB, PRP	6	verstehen, verstehe, so, Sie
Leben	NN, DT, JJ, PRP	5	Leben, einem, selbst, uns, Sie
Madam	PRP, NN	5	sich, ich, Sie, er, Freund
denken	VB, PRP, NN, WDT	5	denkt, Er, Leander, der, mich
heiraten	VB, MD, DT, NN, RB	5	heiraten, will, einen, Witwe, nun
glücklichsten	NN, WP, IN, VB	5	Ostindien, wer, für, gegeben
Wort	NN, PRP, VB	5	Wort, Ihnen, niemanden, mich, habe
bitten	IN, NN, RB, PRP	5	Wenn, O, nicht, mich
nehmen	VB, NN	5	nahm, nehmen, Liebe, Vermögen, sein
Ursache	PRP, RB, DT	5	ich, so, eine, solchen
selb	IN, NN, PRP	5	für, itzo, mit, es
finden	JJ, WRB, DT, NN	5	einige, wo, alle, Sie, Freund
verlor	JJ, NNP, RB, VB, IN	5	verloren, Leander, nicht, sein, als
Glück	PRP, NN, WDT, PRP$	5	Ich, Glück, was, Freund, Ihr
rechen	VB, PRP, IN, NN	5	recht, er, auf, schäme, mich
sonst	RB, VB, NN	5	sonst, schweigt, ist, Ihn
beleidigen	PRP, IN, RB	5	ihn, mich, von, habe
beleidiget	PRP, DT	5	Sie, dessen, mich, sich
kennen	NN, JJ, IN	5	Ehre, Euch, O, Madam, von
meines	IN, DT	5	auf, einen, die
helfen	CC, VB, DT, JJ, PRP	5	Aber, wird, alles, ich, ihm
Welt	IN, DT	5	auf, die, für, der, von
leicht	NN, VB, IN	5	Freund, können, werden, könnte, daß
jung	JJ, NN, IN, CC	5	jungen, Hause, bei, Aber, Ihn
niederträchtig	WDT, IN, VB	4	die, Wie, nennt, bin
Pflicht	VB, DT, WDT, NN	4	ist, des, was, Recht
Freier	NN, VB	4	Freier, steht
aufs	IN, NN, VBN, DT	4	um, Frau, gegeben, die
grösst	JJ, PRP	4	größte, größten, Sie, ich
Person	RB, NN, DT, VB	4	nun, gereuen, der, sind
mirs	WP, VB, PRP, NN	4	was, sieht, Sie, Hätte
Beleidigungen	JJ, VB, RB	4	angenehm, wird, auch, noch
niemand	DT, NN, VB	4	niemand, Beleidigungen, hat
Leanders	NN, PRP, RP, IN	4	Leanders, es, so, doch
zeigen	VB, PRP, NN	4	wären, wird, ich, Art
danken	NN, VB	4	Vermögens, Ursache, Banqueroute, werden
andermal	PRP, NN, RP	4	er, entzogen, mich, andermal
warten	VB, NN, PRP	4	haben, Henker, Sie, mich
grossmütig	VB, NN, JJ, RB	4	verlöre, Rache, edel, vielleicht
gehabt	NN, IN	4	gehabt, für, zu, Recht
untergehen	PRP$, NN, DT, VB	4	mein, Schiff, einem, ist
angenehm	NN, RB, WDT	4	hergekommen, billig, die, Leben
zärtlich	JJ, VB, PRP$, RB	4	zärtlichen, meiner, Ihrer, schon
verdriesslich	JJ, RB, DT	4	verdrießlich, einmal, andern, ein
antworen	VB, JJ	4	antworten, gleichem
einander	PRP, NN	4	einander, Herr, wir
sehe	PRP$, UH, IN	4	sehe, Nun, weil
schwach	RB, PRP, JJ	4	viel, mich, ich
sehn	NN, IN, PRP, MD	4	Leander, daß, Er, soll
Tonne	IN, PRP, CD, VB	4	mit, mich, zwei, hat
verlassen	JJ, NN, PRP	4	ganzen, Welt, sich, Fehlers
Schande	NN, JJ, IN	4	Schande, gleich, Pöbel, für
Reichtum	RB, MD, DT, JJ	4	daß, wollen, ein, schlimm
nie	WRB, VB, DT, PRP$	4	wirst, hat, den, Ihre
dächte	NN, CC, VB	4	dächte, Und, Summe, haben
verziehen	TO, VB, NN, RB	4	zu, verziehen, Augenblick, schon
Nebenbuhler	NN	4	Nebenbuhler
Geld	NN, RB, IN	4	Gut, doch, um, schade
ach	RB, JJ, NN	4	so, ich, neidisch, Ehre
lieben	VB, NN	4	lieben, liebe, Witwe, Person
Hand	MD, VB, DT, PRP	4	will, würde, beiden, ich
hübsch	JJ, VB	4	fein, ist, kann, weiß
Goldes	DT, CD	4	einer, Zwei, zwei, eine
Herrn	JJ, IN, NN	4	sie, gegen, versuchten, von
andre	NN, IN	3	andre, wenn, als
Hälfte	MD, JJ, RB	3	soll, gleich, Nicht
deswegen	PRP, JJ	3	Sie, ich
glücklichste	WDT, VB, NN	3	der, halten, Handel
übel	PRP, VB	3	es, sind
ichs	RB, UH, VB	3	denn, Nun, leugnen
Augen	DT, IN	3	die, aus
gestehen	VB, IN, RB	3	gestehen, mit, umsonst
Liebhaber	NN	3	Liebhaber
verliere	NN, WRB, CC	3	Nachricht, aber, und
Verzeihung	NN, DT	3	Verzeihung, einer, dieser
neu	JJ, NN	3	neue, Handlung
Unglücke	IN, DT	3	von, allem, an
Ihres	JJ, IN, DT	3	kostbare, in, die
Seele	DT, RP, PRP$	3	eine, wohl, Ihre
Wohl	PRP, TO, NN	3	Sie, zu, gerühret
Hui	NNS, VB, DT	3	Kohlen, sein, nichts
zuwider	PRP, RB, VB	3	mir, so, ist
entreissen	DT, JJ, RB	3	ein, zärtlichen, noch
Vorschlag	IN, PRP	3	über, ihm, er
Probe	RB, NN, IN	3	so, Freundschaft, auf
Augenblick	RB, PRP	3	doch, ihn, noch
verlangen	PRP$, TO, DT	3	meine, zu, eines
Frage	NN	3	Frage
bloss	PRP, VBN	3	es, bekommen
halb	JJ, DT	3	halbe, die, gut
Verstehn	RB, NN, VB	3	so, Goldes, untergegangen
Sachen	JJ, DT, NN	3	gleich, man, vermuteten
unterscheiden	VBN, VB, DT	3	unterschieden, unterscheiden, ein
Himmels	IN, NN	3	um, Geschenk, trotz
Scham	NN, DT, VB	3	Leander, man, sterbe
vollkomm	PRP$, VB	3	mein, geht, meine
behalten	VBN, RB, VB	3	behalten, wohl, muß
einerlei	IN, JJ, NN	3	einerlei, wir, wohlgemachte
heuen	RB, PRP, WRB	3	denn, mir, aber
Paar	NN, JJ, RB	3	Paar, noch
Aufführung	NN, VB, RB	3	Aufführung, wäre, nicht
dasjenig	VB, NN, PRP	3	ist, Vergnügen, Ihnen
umsonst	NN, PRP, RB	3	sollten, ich, also
ihrem	PRP$, WDT, NN	3	ihrem, was, Witwe
verbinden	RB, NN	3	genau, noch, großmütigen
Rede	NN	3	Rede, Aufrichtigkeit
aufrichtig	JJ	3	aufrichtig
Überlegen	NN, DT	3	Überlegen, Umständen, die
Vielleicht	IN, RB, PRP	3	wieder, andermal, es
süsse	RB, WDT, VB	3	einmal, dem, sein
anfangen	NN, PRP, IN	3	klüger, Er, von
ganzes	WRB, NN, PRP	3	beinahe, Vermögens, mich
empfindlichen	WRB, DT, NN	3	wo, andern, Neugierigkeit
Gesetzt	NN, VB	3	Gesetzt, empfinden, Entschlusse
Dank	IN, NN	3	Dank, Gott
zweifeln	RB, NN	3	nicht, stehet, Entschlusses
allezeit	PRP, NN	3	Ich, Vermögen, sie
Glücke	PRP, IN	3	es, mit, in
Untreue	DT, VB, IN	3	eine, haben, für
dadurch	VB	3	macht, zeigen, werden
wider	DT, JJ, PRP	3	der, Er, mir
gleichviel	JJ, VB	3	meiner, es, meinen
Madame	NN, RB	3	Madame, ja
Erbe	VB, IN, MD	3	wird, wenn, sollen
Zweifeln	RB, JJ, DT	3	so, meiner, ein
fällen	PRP, IN	3	Sie, an, mich
weg	RB, VB, NNS	3	weg, bekommen, Gedanken
auszuüben	JJ, IN, DT	3	schuldig, an, der
bereden	PRP, RB	3	er, dazu, mich
wissen	RP, VB, NN	3	ein, glauben, Art
Gelegenheit	RB, DT, IN	3	so, einer, daß
verstehn	IN, NN, PRP$	3	für, Tonne, ihrer
Entschluss	DT, JJ, NN	3	diesen, wir, Augen
allzu	PRP$, DT	3	Ihre, einer, meinen
wünschen	PRP	3	Ich, mir
schicken	VB, PRP	3	geschickt, sich
endlich	RB, PRP, VB	3	doch, Sie, gedenken
vorkommen	RB	3	nicht, alsdenn, nur
erhalten	NN, VB, CC	3	Abends, hätte, und
Vermögens	NN	3	Teil, Hälfte
gross	VB, NN	3	verlieren, Verbrechen, haben
etwan	VB, PRP, CC	3	ist, Sie, und
St	JJ, RB, NN	3	glücklich, Vielleicht, Handel
Verdruss	JJ, RB, PRP	3	es, aber, Sie
notwendig	VB, PRP	3	müssen, mich, werde
unsrer	PRP	2	Sie, ihn
Traum	PRP$, DT	2	seine, solche
dienen	VB	2	dienen, dient
gesteh	VB, NN	2	sein, Voll
empfindlich	PRP$, RB	2	mein, so
Sprache	NN	2	Sprache
reizender	NN	2	reizender
Eure	IN, VB	2	noch, folgen
voraus	RB, JJ	2	schon, ich
vergessen	PRP$, IN	2	meinem, wider
betrübt	CC, VB	2	und, habe
vertraue	PRP, DT	2	ich, dem
Weder	NN, RB	2	Ihrem, man
wohin	RB, NN	2	dahin, liebster
billig	RP, VB	2	mehr, ist
Wahl	IN	2	in
erfahren	RB, MD	2	alsdenn, soll
Eidschwur	DT, IN	2	den, ohne
fehlen	VB, PRP	2	schenken, Ihnen
schenken	NN, CC	2	Leben, und
möglichstes	MD, PRP	2	will, Er
versuchen	VB, NN	2	versuchen, Grams
annehmen	JJ, DT	2	ich, den
daraufen	NN, JJ	2	Herr, größten
Gesichte	NN, JJ	2	Ach, ziemlich
Irrung	IN, DT	2	als, eine
Gütigkeit	IN, VB	2	aus, haben
lustig	JJ, PRP	2	munter, es
banqueroute	IN, CD	2	wenn, fünf
besitzen	PRP, WP	2	ich, was
Fünfmalten	PRP, VB	2	Er, müssen
gewissenhaft	JJ	2	gewissenhaft, ich
Lebens	PRP, DT	2	sie, man
liebte	RB, NN	2	nicht, bereden
grossmütigen	JJ, RB	2	ich, so
Grillenfänger	RB	2	so, nicht
Soen	NN	2	standhafte, Herr
sachte	RB, PRP$	2	nun, sachte
wertester	VB, RB	2	geben, viel
Pflichten	VB	2	können, sei
Gut	IN, NN	2	durch, Hab
zweifle	CC, NN	2	Aber, gehabt
edel	NN, VB	2	Seele, scheinen
bestreben	VB	2	bestrebte, hätten
wussten	NN, CC	2	wußten, ehe
unbekannen	DT, JJ	2	der, unersetzlichen
Ausschlag	VB, NN	2	überlassen, Schale
Güter	PRP, VB	2	Ihnen, sein
unmöglich	NN, PRP	2	Erfüllung, Es
zugleich	PRP	2	ich
anstehen	VB, PRP	2	ansteht, Ihnen
Würde	NN, PRP	2	Freundschaft, mir
schmeicheln	PRP, RB	2	mir, durchaus
Gegenstand	RB, VB	2	noch, kommen
deutlich	JJ, VB	2	deutlich, haben
teils	NN	2	teils
Verdacht	RB, VB	2	einmal, ist
nochen	NN	2	traurige, Herrn
betrügen	VB	2	betrügen, habe
Sturme	IN	2	in
eigen	JJ	2	eigenen
munt	JJ, NN	2	munter, Pfui
hoffen	NN, MD	2	ha, sollte
vergelte	CC, VB	2	Aber, sage
schändlich	DT, NN	2	einer, Ihren
versichre	VB, RP	2	sein, vernommen
geweissen	DT, RB	2	das, viel
Rat	DT, NN	2	ein, beizustehen
nötigen	VB	2	nötigen, niemals
befürchte	NN	2	Damon, befürchte
schimpfen	VB, RB	2	schimpfen, nicht
hart	DT	2	eine, einen
Verstand	PRP, NN	2	er, Geiz
entschloss	PRP$, DT	2	deine, die
zürnen	VB, IN	2	mag, auf
manch	PRP, NN	2	Es, Ja
weniger	RB	2	weniger
Ei	VB, IN	2	darf, zu
Henker	IN, VB	2	Je, macht
blind	RB, NN	2	schon, ungesund
wagen	VB, JJ	2	wagt, billig
gedenken	DT, RP	2	jenen, mehr
Eur	PRP$, RB	2	Ihr, nicht
Banqueroute	NN, IN	2	Vermögen, durch
raten	NN, DT	2	Worinne, den
nennen	NN, PRP	2	Augenblick, mich
jen	DT	2	der, dem
Närrin	VB, NN	2	müßte, stolze
Ihrige	PRP, IN	2	ihm, als
bewussten	IN	2	bei, mit
wenigstens	PRP	2	ihn, Sie
angetroffen	PRP	2	einander, Sie
tue	CC, NN	2	Und, Mache
empfinde	RB	2	So, so
fünf	PRP, JJ	2	ich
einbilden	RB, PRP	2	auch, sich
alles	MD, PRP	2	sollen, Sie
aufrichtige	VB, PRP	2	bestreben, ihr
Erklären	DT, JJ	2	das, inständig
derohalben	PRP, MD	2	Sie, will
desgleich	VB, CC	2	desgleichen, und
Denkt	RB, PRP	2	nicht, Er
anzufangen	IN, NN	2	mit, aufs
überlassen	DT, JJ	2	dem, blinden
Mode	NN, VB	2	Mode, hätte
verdienen	RB, NN	2	so, verdammte
Liebsten	IN	2	mit, bei
Weg	DT, IN	2	den, so
Hören	NN, VB	2	Hören, besinnen
Mache	PRP	2	ich, Er
ungegründeten	JJ, NN	2	schwach, Zeit
bekümmert	WDT, NN	2	das, bestürzt
vorstellen	VB, VBN	2	vorstellen, vorgestellt
begehen	IN, DT	2	an, der
weswegen	NN, PRP	2	Unglücke, mir
Händen	NN, IN	2	Händen, in
Sanftmut	DT, IN	2	einer, allzu
leugnen	NNP	2	Kann
vergnügt	VB, NN	2	würde, O
etwa	RB, PRP$	2	nur, Ihr
Zweifel	MD, PRP	2	kömmt, sie
ersen	VB, PRP	2	irren, ihn
gefallen	VB, PRP	2	gefallen, mir
trauen	VB, IN	2	zweifeln, Wie
bessern	PRP, NN	2	es, Sachen
Pöbel	JJ, VB	2	verdrießlich, wird
unsre	JJ, WRB	2	wir, auch
schreiben	JJ, VB	2	gleich, ist
stumm	JJ	2	stumme
best	JJ, VB	2	besten, ersten
seh	NN, PRP	2	Leander, mich
niemanden	DT, VB	2	man, hätte
Reichtümer	DT, PRP	2	der, Sie
Geschenk	DT	2	das
Tausch	NN, IN	2	derohalben, an
bestürzt	PRP, JJ	2	Ich, ich
Schaden	PRP$, IN	2	seinem, wenn
Höre	PRP, NN	2	Er, Wort
Wahrheit	PRP$, IN	2	Ihr, an
Tage	NN, VB	2	Tage, warten
Testamente	IN	2	aus, in
einzig	NN, RB	2	Reichtum, auch
abern	VBN, NN	2	aber, größtes
Heirat	NNS, DT	2	Heiraten, eine
eitle	NN, JJ	2	eitle, es
verlasse	JJ, UH	2	ich, Nun
scheinbar	JJ, NN	2	leicht, scheinet
Handlung	DT, PRP	2	die, mich
redlich	DT, PRP$	2	allem, Ihrer
denjenig	RB	2	alsdenn, daß
erzählen	JJ, DT	2	entschlossen, dem
Ihrigen	PRP, IN	2	sich, als
schwören	PRP, RB	2	ich, also
zittere	JJ, VB	2	unmöglich, können
alleine	IN, NN	2	mit, Freund
stellen	VB, RB	2	stellt, schon
besorge	CC, NNP	2	Aber, Vetter
angekommen	VB, RB	2	ist, ja
sprechen	VB, NNS	2	spricht, Freunde
just	VB, NN	2	habe, Reichtümer
Wollte	NN	2	Wollte, aushalten
Mutter	NN	2	Maus, Vater
lese	PRP$, RP	2	seh, untergegangen
Einfall	IN, DT	2	auf, ein
hab	IN, RB	2	von, So
gerühret	IN, NN	2	ob, Reue
Schimpf	DT, NN	2	der, etwan
meinigen	IN, NN	2	als, Sollten
Drum	PRP, VB	2	mich, werden
Umständen	IN	2	bei
läng	JJ, RB	2	länger, aber
anwenden	MD, NN	2	will, Verlassenschaft
erwarten	PRP, IN	2	mich, von
Spöttereien	VB	2	haben, können
bös	DT	2	niemand, andern
meinig	VB	2	würde, kann
handeln	IN, CC	2	nach, und
Grossmut	IN	2	ob, über
besser	RB, MD	2	besser, wollt
Klugheit	NN	2	Verstand
Eurer	NN	2	Aufführung, Hoffnung
hieher	PRP	2	Sie
redet	VB, IN	2	bitte, als
besondre	IN	2	für, auf
itzt	DT	2	itzt
fragen	VB, DT	2	fragen, einer
Mannspersonen	JJ, PRP$	2	alle, Ihr
verunglückt	IN, PRP$	2	daß, Ihr
gestünde	NN, PRP	2	gestünde, ich
Seines	PRP	2	Er, mich
Ostindien	WDT, NN	2	welche, Handel
empfinden	RB, NN	2	nie, Freund
Wasser	DT, WP	2	das, Was
ehe	DT, NN	2	beide, Nein
Kapital	PRP, IN	2	Sie, mit
liesse	NN	2	ließe, gewiß
besorgen	RP	2	wieder, immer
schweigen	VB, DT	2	bitten, solchen
Mensch	NN, VB	2	Damon, hat
wär	NN, RP	2	Rückkunft, verbunden
Wissen	WDT, PRP	2	was, uns
edler	NN	2	liebt, Philosophin
Haus	NN	2	Haus
Schade	JJ, IN	2	Frisch, nur
lang	RB, DT	2	schon, eine
ausschlagen	NN	2	Person, Zeit
Ers	PRP, VB	2	mich, habe
Exempel	NN, VB	2	Exempel, hätte
Lust	JJ, DT	2	just, einige
unser	PRP$	2	unser
trennen	VB, JJ	2	neue, Sie
Leichtsinnigkeit	VB, DT	2	verliert, o
werfen	IN	1	auf
wären	VB	1	wären
verhungern	PRP	1	er
Nase	IN	1	auf
edl	JJ	1	bewaffnet
Ehe	NN	1	Ehe
alt	JJ	1	alten
Falschheit	VB	1	bekommen
Winter	NN	1	Sperlinge
verstehst	NN	1	verstehst
eigennützig	PRP	1	uns
aufhelfen	VB	1	sind
Habt	VB	1	erwarten
gescheute	DT	1	Das
gescheiter	RB	1	noch
bissgen	DT	1	Ein
übrigens	PRP	1	Ich
verliebt	PRP	1	ich
brächten	CC	1	und
spielte	NN	1	spielte
Übereilung	CC	1	Und
philosophisch	JJ	1	philosophisch
Fein	UH	1	Nun
Glauben	CC	1	und
schwerlich	PRP	1	sie
untreu	IN	1	an
schade	PRP	1	mich
gemein	IN	1	unter
Not	IN	1	in
Gewinst	NN	1	Schaden
gestern	JJ	1	ich
verrichten	RB	1	vorher
Rang	NN	1	Rang
gröblich	DT	1	der
vernünftigsten	NN	1	vernünftigsten
beliebt	NN	1	Person
gewahr	NN	1	gewahr
Kreaturen	NN	1	Kreaturen
Angelegenheiten	NN	1	Angelegenheiten
weien	RB	1	wenigstens
verbieten	VB	1	wäre
täte	IN	1	Wenn
ungegründet	PRP$	1	meine
selben	VBN	1	selbst
erhabenen	IN	1	von
He	PRP	1	Sie
reichlich	NNP	1	andermal
mächtiger	NN	1	mächtiger
Frisch	IN	1	als
Kleinigkeit	WDT	1	dieser
belebt	JJ	1	belebter
gottesvergessen	JJ	1	albern
stünde	IN	1	auf
vereinigen	RB	1	wieder
würde	NN	1	Gesetzt
Brief	IN	1	gestern
gütig	RB	1	umsonst
Gegenwart	PRP	1	Sie
rate	DT	1	nichts
schuldig	PRP$	1	unsers
süssen	JJ	1	gleich
Leb	PRP	1	Er
übermorgen	RB	1	übermorgen
sieht	NNP	1	Vetter
Grams	NN	1	Hälfte
wiederholen	NN	1	Ihres
Unrecht	RB	1	So
seinig	DT	1	meinige
warteten	RB	1	auch
verleumden	VB	1	verleumden
Rückkunft	IN	1	auf
trotzt	WDT	1	was
erdulden	NN	1	Vorwürfe
vollends	VB	1	mag
hegen	JJ	1	böse
edlere	PRP	1	Sie
übereinstimmte	NN	1	übereinstimmte
törichten	IN	1	auf
Summe	IN	1	von
Reichtume	NN	1	Weg
Liebeserklärung	DT	1	eine
schänden	RB	1	damit
liebenswürdigsten	NN	1	Hand
überzeugen	VB	1	überzeugt
Stolze	JJ	1	ich
Angst	IN	1	Bei
Seeln	VB	1	Seelen
treffen	VBN	1	gegeben
herbestellet	PRP	1	ihn
ergeben	IN	1	von
heeissen	NN	1	Probe
Verdienst	NN	1	Neigung
liebenswürdige	RB	1	zugleich
Darnach	PRP	1	Er
unglücklichste	JJ	1	notwendig
mengest	NN	1	mengest
schadet	RP	1	gesetzt
Hoffnung	RB	1	zugleich
Pfui	RB	1	gar
vorplaudern	DT	1	der
Mühe	NN	1	Mühe
zuging	JJ	1	fein
Lügen	JJ	1	sind
Ton	NN	1	Ton
Kräften	TO	1	in
bleibe	NNP	1	bleibe
untereinander	NN	1	Geschlechts
mache	NN	1	Umständen
Schimpfe	DT	1	dem
banquerout	NN	1	mache
liebern	VB	1	lieber
hieren	VBN	1	hier
widerlegen	NNP	1	Reden
bezeigen	VBN	1	bezeigte
Begriffen	DT	1	den
verfahren	NN	1	Damon
uneinig	JJ	1	uneinig
unsers	RP	1	alsdenn
stünden	PRP$	1	seine
worüber	NN	1	bekümmert
würdigen	DT	1	dieser
besässe	RB	1	auch
vorschlagen	RB	1	wohl
liebst	NN	1	Damon
Verziehen	RP	1	fort
unsere	DT	1	der
Lasst	MD	1	kömmt
Schwierigkeit	RB	1	nun
unserm	NN	1	Gewinst
taub	JJ	1	blind
halte	WRB	1	Doch
blieb	NN	1	törichten
Sage	NN	1	Sage
würdig	VBN	1	zeigen
Rache	DT	1	die
hintergehen	VB	1	haben
gegründet	PRP	1	Ihnen
Glücksgüter	RB	1	auch
Zuwurf	DT	1	ein
Unsre	NN	1	Grillenfänger
neidisch	PRP	1	ich
widerführe	JJ	1	größte
Unterschied	NN	1	Unterschied
Worinne	JJ	1	Madam
zwölf	PRP	1	mich
beitragen	VB	1	beitragen
eigennützige	NNP	1	eigennützige
Schwärmereien	NN	1	Schwärmereien
Euer	NN	1	Notwendigkeit
Gasthof	NN	1	Gasthof
zärtlichen	NN	1	Damon
Bezeigen	NN	1	Bezeigen
Beinahe	NN	1	Beinahe
liebenswürdig	PRP	1	sie
anbringen	RB	1	sehr
Gunst	IN	1	aus
satt	PRP	1	es
Notwendig	PRP	1	Sie
höre	VB	1	höre
verschwenderisch	DT	1	eine
Womit	PRP	1	Ihnen
Legen	PRP	1	mich
beruhen	RB	1	nun
zugegriffen	RB	1	Nur
getröste	NN	1	Himmel
seltsam	VB	1	gar
Fall	NN	1	Knall
unterdrückt	JJ	1	unterdrückt
möge	NN	1	Verzeihung
verschwiegen	PRP	1	mir
entdecken	PRP	1	mir
Verlassenschaft	NN	1	Tode
jemals	PRP	1	mir
verliebten	JJ	1	verliebten
zehnmal	VB	1	hätte
Taten	TO	1	mit
schwärmst	NN	1	schwärmst
Gasthofe	NN	1	Gasthofe
genau	VB	1	hat
zärtlicher	NN	1	zärtlicher
unterstehen	PRP	1	sich
wählen	NN	1	Verdienst
verliebter	NN	1	verliebter
Vorwürfe	PRP$	1	seine
versehen	PRP	1	mir
Gesellschaft	NN	1	Gesellschaft
gedient	NN	1	Verzeihungen
unzähligen	NN	1	unzähligen
Empfindlichkeit	IN	1	durch
Wände	RB	1	ja
beschliessen	VB	1	meine
nachlässiger	NNP	1	nachlässiger
bösen	IN	1	durch
kurz	JJ	1	kurzem
Seiner	NN	1	Unglück
Armen	IN	1	als
Aufrichtigkeit	IN	1	an
ferner	IN	1	ferner
bestimmen	NN	1	gewiß
gereuen	PRP	1	es
Erfüllung	RB	1	wahr
ausfündig	NN	1	Ursache
horchen	NN	1	ungegründet
erwählen	PRP	1	Ihnen
ungestümes	PRP	1	mir
vernünftig	PRP$	1	Ihre
schallen	IN	1	hier
Freierei	VB	1	war
getreust	VB	1	ist
gescheh	DT	1	Diese
Misstrauen	NN	1	Verschwiegenheit
unersetzlich	IN	1	zu
Jener	NN	1	Liebe
Notlügen	DT	1	ein
wundern	RP	1	gewundert
ohngeachtet	VB	1	gegründet
Hase	NNS	1	Hasen
aufrichtiger	RB	1	ist
tragen	NN	1	Unglück
Verzeihungen	TO	1	mit
närrisch	MD	1	will
tauschen	VB	1	Kapitalen
höret	VB	1	weiß
aufrichtigen	NN	1	aufrichtigen
quält	DT	1	die
flüchtig	JJ	1	flüchtig
ungetreuer	NN	1	Nachwelt
morgen	RB	1	morgen
Gelder	PRP	1	Sie
Begreifen	IN	1	sehr
traurige	VB	1	habe
Nötiges	VB	1	habe
Erschrecken	NN	1	Augen
übereinstimmen	PRP$	1	meinen
Alles	PRP	1	Er
Könntet	RB	1	gern
Widern	VB	1	Wider
aufzuhelfen	PRP	1	ihm
tausend	IN	1	Auf
empfindlichern	VB	1	empfindlicher
Rechts	JJ	1	ihm
Seite	NN	1	Seite
verborgen	PRP	1	Ihnen
verblendenden	WDT	1	welches
stolze	VB	1	war
erwählt	PRP$	1	seinem
inständig	VB	1	bitte
Unwürdigen	NN	1	Unwürdigen
nachteilige	PRP	1	mir
versuchten	NN	1	dächte
tot	NN	1	Ihn
drauf	PRP$	1	Seines
naseweis	RB	1	nicht
rasend	DT	1	die
Erleichterung	NN	1	Vertrauen
kützeln	DT	1	ein
Findet	JJ	1	beliebt
genennet	NN	1	ungetreuer
bekömmt	RB	1	oder
zuschreiben	VB	1	zuschreiben
zugestehen	PRP	1	mir
erstaunet	NN	1	niederträchtigen
schämen	DT	1	alles
Verräterei	PRP	1	Ihnen
Galgenschwengeln	IN	1	von
Mühle	IN	1	auf
werde	PRP$	1	meinem
Erfahrung	DT	1	diese
Verzeihen	NN	1	Freund
tadeln	PRP	1	ihn
liebenswürdigen	DT	1	einer
frei	NN	1	Euch
meinern	DT	1	den
unerträglich	VB	1	muß
Niederträchtig	WP	1	Was
suchte	NN	1	suchte
Vielleichen	WDT	1	was
Teil	RB	1	alsdenn
geliebt	NN	1	geliebt
begleiten	NN	1	Tonne
zukommen	PRP$	1	zukommen
lässen	CC	1	Und
hinlänglich	NN	1	etwan
Licht	PRP	1	Sie
Geschicklichkeit	IN	1	auf
Haar	IN	1	um
hinderlich	NN	1	Ihrem
Abschied	NN	1	Abschied
12000	PRP	1	mich
Füssen	NNP	1	Füßen
irren	NN	1	Wahl
hassen	VB	1	hassen
gesunden	IN	1	von
schlüge	NN	1	dächte
auszuhalten	RB	1	vielleicht
Geniessen	NN	1	Gehen
unnötig	PRP	1	Es
schlimm	DT	1	ein
dahinter	RP	1	auch
Stark	PRP$	1	gesunden
Narr	VB	1	macht
Fehlers	DT	1	des
wunderlich	JJ	1	wunderlich
erschrecken	VB	1	wird
einzusehen	NN	1	Ihres
Gleichgewichte	NN	1	itzo
dahin	JJ	1	es
vermögend	NN	1	Beleidigungen
Dienerin	VB	1	ausholen
ankommen	PRP	1	es
anwendeten	NN	1	Glücksgüter
wodurch	NN	1	Notlügen
weisst	NN	1	weißt
Herzens	NN	1	Geschenk
vielmalten	PRP	1	mich
bittet	VB	1	kommen
Feuer	IN	1	mit
schlecht	JJ	1	schlecht
beschimpfen	VB	1	setzen
erzürnet	PRP	1	Sie
abzuwaren	VB	1	beruht
Kurz	VB	1	vorzuwerfen
Gegenliebe	VB	1	suchen
albern	PRP	1	mich
nahe	VB	1	geht
Hause	IN	1	in
schamhaft	VB	1	bin
vollkommen	DT	1	eine
Verflucht	IN	1	zu
Gemüt	VB	1	weiß
Leute	PRP	1	ihr
welchem	VB	1	ankommen
Behüte	DT	1	eine
vorteilhaftesten	NN	1	allezeit
Geschlechts	DT	1	des
Gegengunst	NN	1	Gegengunst
umschreiben	VB	1	umschreiben
Liebeserklärungen	JJ	1	er
zärtlichst	JJ	1	zärtlichste
erwägen	VB	1	haben
genennt	NN	1	Freundschaft
niederträchtigen	IN	1	über
stärk	JJ	1	stärker
Erklärungen	NN	1	Gesichte
ewig	VB	1	ist
kaltsinnig	IN	1	wie
unüberwindlich	IN	1	mit
verpflichten	CC	1	desto
entzückende	NN	1	Lügen
durchaus	VB	1	kann
uneigennützigst	VB	1	haben
Verschwiegenheit	IN	1	in
Tauschen	VB	1	könnte
Versuchen	JJ	1	gut
Kapitalten	IN	1	mit
Scherz	NN	1	Scherz
zaudern	NN	1	O
hättest	WRB	1	hättest
ausschweifende	VB	1	hat
Umstand	VB	1	wird
dumm	IN	1	als
entschuldigen	VB	1	würde
Halt	PRP	1	er
anderern	IN	1	daß
Gunstbezeigungen	NN	1	Gunstbezeigungen
übrigen	IN	1	wenig
vorhin	PRP	1	Sie
Streich	JJ	1	Streich
balden	VBN	1	bald
Glücklichste	NN	1	Handel
solle	NN	1	Hand
besonder	IN	1	auf
beinahe	DT	1	einem
Galimathias	WDT	1	dessen
Vollkommen	NN	1	Unglück
grösstes	VB	1	zeigen
oft	DT	1	die
Seit	IN	1	als
Schelmstück	PRP	1	es
Vorwande	DT	1	einem
recht	VB	1	einsehen
hintergangen	DT	1	einen
jemand	NN	1	Ei
darbien	PRP$	1	sein
menschlich	NN	1	Schande
schätzte	DT	1	alles
Mitleiden	IN	1	an
falle	VB	1	tat
beschämt	PRP	1	mich
kostbar	IN	1	durch
Einfallen	NN	1	Einfallen
aushalten	DT	1	diese
schuld	NN	1	schuld
Leibesbeschaffenheit	DT	1	einer
müd	NN	1	Beschäftigung
geleg	PRP	1	mir
ausholen	MD	1	will
Dienste	NN	1	Dienste
Verbrechen	VB	1	sein
Soldatenmode	RB	1	ganz
lernen	PRP	1	Ihnen
unserer	PRP	1	mich
einsehen	PRP	1	ihr
ausstehen	NN	1	ausstehen
stehen	DT	1	das
Jahre	IN	1	vor
Hab	DT	1	alle
Wen	RB	1	nicht
Schluss	VB	1	sein
zugestossen	DT	1	ein
schimpfte	NN	1	entreißen
Stande	JJ	1	Sie
Glücklichsten	IN	1	willen
allerliebster	RB	1	endlich
wirst	NN	1	Lisette
güldne	PRP	1	Ihm
Einöde	NN	1	Einöde
nunmehr	NN	1	Leander
Entschlusses	NN	1	Wahrheit
verinteressiert	NN	1	Ihrigen
dagegen	MD	1	will
beurteilen	NN	1	Lisette
Königin	NN	1	Liebe
Heute	RB	1	Heute
Gemüter	NN	1	Vereinigung
besen	VB	1	erste
vermuteten	IN	1	da
Bestreben	NN	1	Bestreben
Ansehung	VB	1	haben
merken	NN	1	bekümmert
beschieden	PRP	1	mir
schwiegen	NN	1	schwiegen
anzuvertrauen	PRP$	1	Ihr
Bauersfrau	DT	1	eine
Vertrauen	IN	1	in
Reich	JJ	1	lieber
eifersüchtigen	PRP	1	ich
gleichwo	NN	1	gleichwo
nachzusetzen	DT	1	der
geh	VB	1	hätten
fliehen	PRP$	1	Ihr
Notwendigkeit	IN	1	bei
Waage	NN	1	Kleinigkeit
nichte	VB	1	suchten
falsch	JJ	1	er
Munde	JJ	1	Munde
Anhalten	IN	1	durch
standhafte	WDT	1	das
ungesund	IN	1	durch
schwer	JJ	1	es
beschwerlich	PRP$	1	meine
Freunden	RB	1	ja
Knall	PRP	1	sie
Madamen	NN	1	ha
Lieben	NN	1	Lieben
gehe	MD	1	soll
schüchtern	NN	1	Ihrem
eingelaufen	RB	1	so
Zeug	VB	1	ist
Verdriessliche	PRP	1	Er
blindlings	NN	1	beste
beizustehen	NN	1	vorfallender
stehet	PRP$	1	meinen
Verlassen	VB	1	verstehe
übereilet	VB	1	haben
Wolfe	MD	1	will
gäbe	NN	1	gäbe
erkundigen	PRP$	1	unserer
herausfordern	NN	1	herausfordern
liebsten	RB	1	wohl
schimpft	CC	1	und
auchen	NN	1	Unrecht
fähig	RB	1	einmal
setzten	VB	1	erholen
beisteh	NN	1	Not
unvergeblich	IN	1	bei
Wählen	DT	1	nichts
Angesicht	VB	1	muß
klug	JJ	1	klug
Philosophin	CC	1	und
mitbringen	PRP	1	ich
Entschlusse	PRP$	1	ihrem
verhasst	RB	1	so
nützlich	WDT	1	was
Reue	IN	1	über
Vater	PRP	1	mich
geschwind	RB	1	nicht
versichert	NN	1	versichert
gottlose	NN	1	Leichtsinnigkeit
Ohre	IN	1	hinter
würfeln	DT	1	beide
verzeiht	NN	1	Leander
Antwort	NN	1	Antwort
Schale	CC	1	oder
ostindisch	IN	1	in
Anblick	NN	1	Anblick
Erlauben	RB	1	wenig
lass	JJ	1	laß
finde	JJ	1	geheime
Gerechter	NN	1	Freundes
vorhalte	NN	1	süße
Neugierigkeit	IN	1	über
Tode	IN	1	nach
Versichern	JJ	1	aufrichtige
Fehler	NN	1	Weder
Beschäftigung	PRP	1	ihm
Frauenzimmers	VB	1	werden
Unruhe	WDT	1	was
Lob	IN	1	von
zufried	VB	1	bin
gewisseste	VB	1	habe
jemanden	VB	1	scheinen
besinnen	NN	1	Leandern
kämpfen	PRP	1	mir
vertrauen	PRP	1	mich
gedulden	JJ	1	klein
weiss	VBN	1	verbunden
gebe	RP	1	an
Sei	PRP	1	Er
Ganze	WDT	1	das
Schweig	JJ	1	Schweig
zehn	VB	1	müssen
Wisset	NN	1	Euch
weder	NN	1	itzo
Verziehn	NNP	1	Leander
Kannst	NN	1	Kannst
betrifft	VB	1	finden
heraus	RB	1	eher
Geh	NN	1	Frau
entzogen	PRP	1	Ihnen
Tugend	RB	1	Doch
selig	VB	1	habe
Ansehen	NN	1	Ehre
Könnten	VBN	1	verborgen
unschuldig	VB	1	sind
Rechenschaft	PRP$	1	meinem
Rockknöpfe	RB	1	eher
andres	NN	1	Damon
schaden	DT	1	des
löblich	DT	1	eine
fest	VB	1	ist
Floh	VB	1	hat
teilen	PRP	1	Ihnen
Liebste	NN	1	Liebste
ins	NN	1	Gut
fühlen	WRB	1	ja
entziehen	PRP	1	ihn
vorfallender	NN	1	Vermögen
Vorurteil	IN	1	so
glaube	VB	1	besitzen
bewahren	PRP	1	mich
sehren	NN	1	eitle
n	NN	1	[
Treue	IN	1	Auf
Nachwelt	IN	1	von
vorzubringen	DT	1	einer
Reizungen	RB	1	so
lahm	PRP	1	Sie
Geiz	NN	1	Bosheit
geholfen	IN	1	zu
nütze	RB	1	nicht
besorgten	IN	1	als
Unwürdigern	IN	1	an
verblendet	IN	1	bis
Arbeit	NN	1	Arbeit
eingenommen	RB	1	zu
Wertester	NN	1	ha
verlören	DT	1	alles
ändern	RP	1	geändert
Unkosten	JJ	1	geschehen
kurzen	DT	1	den
besitze	WP	1	Was
berede	JJ	1	ich
verachtungswürdiger	VB	1	Ist
Liebst	PRP	1	ihm
sau	RB	1	deswegen
lachen	NN	1	ha
geirret	NN	1	Wahl
auszusöhnen	NN	1	Glücke
Zweifelt	VBN	1	tun
Unsere	JJ	1	gleich
Niemand	NN	1	Niemand
wüsste	NN	1	wüßte
scheinet	DT	1	der
hierinne	NN	1	Recht
niederträchtiger	VB	1	war
entdeckten	NN	1	entdeckten
verunglücket	DT	1	einem
gewuchert	NN	1	meinigen
schw	VB	1	weiß
Narren	NN	1	Narren
Welch	JJ	1	Welchen
beurteile	WRB	1	auch
Nebenbuhlern	NN	1	Nebenbuhlern
Vereinigung	DT	1	die
gehässiger	PRP	1	ihr
Bettlerin	IN	1	als
glücklichen	IN	1	durch
lasst	JJ	1	jungen
Schwäche	VB	1	fühle
Kummer	NN	1	Lisette
schäme	UH	1	ach
besess	IN	1	ohne
Häusern	IN	1	in
brechen	NN	1	Eidschwur
Schäfchen	NN	1	Wolfe
Allein	DT	1	selber
abwarten	VB	1	abwarten
sagten	IN	1	zu
erleichtern	NNP	1	Kummer
edle	NN	1	Damon
Zufalle	DT	1	dem
prächtig	CC	1	und
gewinnen	PRP	1	sie
Zwei	PRP	1	Er
wen	RP	1	erst
Geier	RP	1	geschimpft
Verlust	DT	1	dieser
niemals	PRP	1	euch
parat	PRP	1	sich
vermutet	PRP	1	mir
Bundes	VB	1	vermöge
gewollt	NN	1	Himmel
wundersam	JJ	1	wundersam
bin	IN	1	wie
begegnen	DT	1	ein
einzigen	RB	1	noch
Abends	RB	1	nur
klugen	RB	1	so
Vorwand	RB	1	auch
beunruhigen	NN	1	Verlust
neuem	RB	1	wieder
Zärtliche	DT	1	das
Lebt	VBN	1	unterschieden
beunruhiget	JJ	1	verdrießlich
schlagen	VB	1	schlagen
abzulaufen	VB	1	abzulaufen
Kohle	PRP	1	er
Damons	NN	1	Damons
schonen	VB	1	möchte
erste	RB	1	wenn
Vernunft	JJ	1	klein
trockne	NN	1	trockne
Sperlinge	IN	1	für
jaten	NN	1	andre
vernehmen	NN	1	Herrn
vorstelle	JJ	1	ich
Empfindung	DT	1	die
Regel	DT	1	die
verdammen	JJ	1	ganze
Geldern	DT	1	den
versteht	RB	1	nicht
liebt	DT	1	Eine
klüger	RB	1	also
garen	NN	1	Eurer
sagt	TO	1	zu
Lisett	RB	1	nur
hinter	DT	1	einen
Bosheit	IN	1	über
niemalsen	NN	1	großmütigen
aufbringen	JJ	1	kein
Beifall	IN	1	durch
wahren	VB	1	weiß
seinetwegen	NN	1	liebenswürdigsten
vorgesucht	NN	1	Liebeserklärungen
Nehmen	VB	1	bekommen
ums	NN	1	Ach
Punkt	DT	1	den
gehören	DT	1	das
bemühen	MD	1	will
Tagen	NN	1	Tagen
stehlen	PRP	1	ich
Sammelplatz	NN	1	Sammelplatz
Befürchten	NN	1	Erklärungen
vergeben	PRP	1	ihm
ungestüm	JJ	1	ungestüm
lossprechen	VB	1	würde
führen	IN	1	Je
Maus	PRP	1	Es
entzücket	IN	1	von
acht	CD	1	acht
sag	UH	1	Nun
habt	IN	1	für
verachtungswert	NN	1	Vergnügen
binden	DT	1	die
hergekommen	RB	1	deswegen
anfängt	WDT	1	was
Itzo	PRP	1	Sie
Wichtigen	RB	1	denn
Bräutigam	DT	1	einen
nötig	JJ	1	nötige
Grab	IN	1	mit
geizig	VB	1	gibt
Jugend	IN	1	in
verschweigen	PRP	1	es
ausdrücklich	RB	1	nicht
Setzen	NN	1	Geheimnis
entzückt	JJ	1	vergnügt
befreien	TO	1	zu
gründen	RB	1	doch
Antrage	IN	1	in
Seits	VB	1	befreien
erworbener	RB	1	so
verderben	NN	1	Ihrem
schlage	NN	1	Leandern
woran	NN	1	Freund
eitel	NN	1	verachtungswert
Geldes	IN	1	bloß
Wesentlichen	IN	1	in
Feindschaft	NN	1	Feindschaft
fern	IN	1	in
Alsdenn	PRP	1	Er
verursachen	NN	1	Verdruß
Urteilen	VB	1	erhalten
aufzuopfern	NN	1	aufzuopfern
abfinden	PRP$	1	abfinden
Hartnäckigkeit	VB	1	kenne
entschlassen	TO	1	zu
nähern	NN	1	Unglück
dürfte	VB	1	dürfte
verargen	PRP	1	es
vermögen	PRP	1	mir
dran	RB	1	nicht
ausnehmende	RB	1	so
gäben	NN	1	gäben
unbillig	RB	1	also
Bald	VB	1	halten
beleidigten	DT	1	eine
Rtlr	IN	1	Auf
Geheimnis	PRP	1	mir
Zweck	NN	1	Zweck
aufgehört	PRP	1	mich
sähe	PRP	1	es
ausschütten	IN	1	gegen
tändeln	RB	1	noch
zählen	JJ	1	närrischen
übrig	JJ	1	übrig
kostbarste	NN	1	Welt
davor	VB	1	hat
wenigst	CC	1	oder
ltzo	NN	1	ltzo
wiederholte	DT	1	den
artige	JJ	1	artige
häufig	CC	1	und
Herren	NN	1	Herren
fort	JJ	1	gleich
erdichtete	NN	1	erdichtete
verkündigen	PRP	1	Ihm
Frauenzimmer	IN	1	wenn
Voll	JJ	1	wertester
sterben	VB	1	fliehen
munter	NN	1	Stark
verdammte	NN	1	Liebe
widerfahren	RB	1	auch
prächtige	NN	1	einzusehen
ungeschickt	NN	1	Freundschaft
Dienen	NN	1	Dienen
bewaffnet	DT	1	Die
Grausamer	NN	1	verunglücket
Begierde	IN	1	als
Entdecken	NN	1	Unglück
treten	VB	1	bekommen
willen	DT	1	des
Wucher	IN	1	mit
streite	NN	1	streite
zärtlichsten	CC	1	und
gelangen	NN	1	Reichtume
loben	RB	1	nie
Tränen	IN	1	aus
keins	PRP	1	ich
wert	RB	1	ist
teilten	PRP$	1	unserm
Banquerouten	IN	1	mit
schweig	JJ	1	schweig
zanken	NN	1	zanken
Anbeter	NN	1	Anbeter
redete	NN	1	redete
erholen	IN	1	an
Freundin	NN	1	Freundin
unwahrscheinlich	DT	1	das
vorsagen	PRP$	1	Ihrer
verliebte	NN	1	verliebte
Antrag	CC	1	Und
Versuch	RB	1	so
Erstaunen	NN	1	Verdruß
weichet	VB	1	kann
Zwischen	CC	1	und
vorzuwerfen	RB	1	dabei
einigermassen	RB	1	einigermaßen
Verdrusse	NN	1	Ursache
Mährgen	VB	1	erzähle
Fällen	IN	1	in
täten	NN	1	O
unerschrocknen	DT	1	einem
Eigennutz	VB	1	sei
nähmen	DT	1	das
Aufrichtig	TO	1	zu
geheim	IN	1	für
niederträchtige	NNP	1	niederträchtige
unschmackhaft	JJ	1	eitel
ersetzen	CC	1	desto
wohlgemachte	IN	1	für
holen	PRP	1	sie
Schmerz	NN	1	Vergnügen
Alsdann	NNP	1	Alsdann
irr	WRB	1	aber
