Title: Der Misogyn
Number of all lemmas: 5055
Nummber of different lemmas: 2136

Lemma	POS	Frequency	Tokens
Herr	NN, JJ, NNP	76	Herr
Lelio	NN, NNP, JJ, RB	57	Lelio
sagen	VBN, VB	53	gesagt, sagen, sage
wohl	RB, RP, IN	43	wohl
Vater	NN, NNP	41	Vater
ja	RB, RP, IN	36	ja
Schwester	NN	32	Schwester
schon	RB, RP, IN	31	schon
Sohn	NN, NNS	29	Sohn, Söhne
mussen	VB, VBN	29	muß, mußt
lieb	JJ, VB, NN	27	lieb, lieber, lieben, liebe
Leander	NN, NNP	27	Leander
Hilaria	NN, NNP, RP	27	Hilaria
Bruder	NN	27	Bruder
eben	RB, VB, RP, VBN, IN, NNP	27	eben
sehen	VB, RB, VBN	26	sehen, sah, sieht, gesehen
mehr	RB, RP, NNP, IN, WRB	26	mehr
kommen	VB, RP, VBN	25	kommen, käme, gekommen, komme, kommt
glauben	VB, VBN	25	glauben, glaubt, geglaubt, glaube, glaubten, glaubte
gut	JJ, RB	24	gut, guten, gute, gutem, guter
Tochter	NN, NNP	23	Tochter
ganz	IN, JJ, RB	23	ganz, ganze, ganzen
tun	VB, VBN, RP	22	tun, tut, getan
gehen	VB	21	gehen, gegangen, geht
weeissen	VB, RB	21	weiß
Valer	NN	20	Valer
mögen	VBN, VB	20	mag, möchte, mögen, magst, möchten
Solbist	NN, NNP	20	Solbist
Liebe	NN	20	Liebe
gewiss	NN, JJ	19	gewiß, gewissen, gewisse, gewisser
Laura	NNP, NN	19	Laura
hören	VB	19	hörst, hören, höre, hört
gar	IN, RB, RP	19	gar
O	NN, NNP	19	O
Ja	NN	18	Ja
Augen	NN, JJ	18	Augen
bringen	VBN, VB	17	gebracht, bringen, brachte, bringe
Leandern	NN, JJ, VB	17	Leandern, Leander
gleich	RB, JJ	17	gleich, gleichen, gleicher
erst	RB, JJ, RP, VB	16	erst, erste, ersten
kömmen	MD	15	kömmst, kömmt
wissen	VB, RB	14	wissen
ab	RP, RB	14	ab
hast	NN	14	hast
Unglück	NN	14	Unglück
lassen	VB, RB	14	lassen, ließ, lasse
Frau	NN	14	Frau
denken	VB	13	denken, denke, denkt
Mann	NN	13	Mann
Herrn	NN, JJ	13	Herrn
halten	VB, VBN	13	gehalten, halten, hält
Wumshäter	NN, NNP	13	Wumshäter
rechen	VB, VBN	13	rechte, recht, rechten
genug	RB, RP	13	genug
soen	VBN, RB	12	so
wenig	RB, DT, IN	12	wenig, wenige
Johann	NNP, NN	12	Johann
nehmen	VB, RB, VBN	12	nehmen, nehme, genommen
Weiber	NN, JJ	12	Weiber
bald	IN, RB, WRB	12	bald
geben	VB, VBN	11	geben, gegeben
dürfen	VB, VBN	11	dürfte, durfte, darf, durften, dürfen
Welt	NN	11	Welt
setzen	VB, VBN	11	setzen, gesetzt
Herz	NN, NNS	10	Herz, Herzen
Pars	NN	10	Pars
Prozess	NN	10	Prozeß
heuen	VB, VBN	10	heute, heut
finden	VB, RP, VBN	10	findet, finden, gefunden
allein	WRB, RB, RP	10	allein
wahr	RP, JJ, RB	9	wahr
Zeit	NN	9	Zeit
läng	JJ	9	länger
gehören	VB, VBN, RP	9	gehörst, gehöre, gehört
glücklich	JJ	9	glücklich, glücklichen
immer	RB	9	immer
einzig	JJ	9	einzigen, einzige, einzig, einziger
Ei	NN	9	Ei
klug	JJ, RB	9	klug
Nein	NN	9	Nein
unmöglich	JJ	9	unmöglich
wirklich	JJ	8	wirklich
Lassen	MD	8	Lassen
Hand	NN, JJ	8	Hand
folgen	VB	8	folgen
hoffen	VB	8	hoffen, hoffe
sag	NN	8	sag
leicht	JJ	8	leicht, leichter
einander	PRP	8	einander
erfahren	VBN, VB, RP	8	erfahren, erfuhr
Recht	NN	8	Recht
endlich	RB, JJ, IN	8	endlich
Paradies	NN, NNS	8	Paradies, Paradiese
Frauenzimmer	NN	8	Frauenzimmer
Himmel	NN	8	Himmel
bleiben	VB	8	bleibt, bleiben
wenigstens	RB, WRB, IN	8	wenigstens
Gut	NN, JJ	8	Gut, Guter
Rede	NN	8	Rede
stehen	VB	8	steht, stehen, stehe
sehe	PRP$	8	sehe
oft	IN, RB, RP, WRB	8	oft
wer	WP	8	wer
drei	CD	7	drei
Person	NN	7	Person
bitten	VB	7	bitte, bitten
fällen	VB, VBN, RP	7	gefällt, fällt
klein	JJ	7	klein, kleinen, kleine, kleiner
gewinnen	VBN, VB	7	gewonnen, gewinnen
Art	NN	7	Art
nunmehr	RB, NNP, RP	7	nunmehr
sollten	NN	7	sollten
je	RB, IN	7	je
Wort	NN, NNS	7	Wort, Worte
Sache	NN	7	Sache
Madmoisell	NN	7	Madmoisell
möglich	JJ	7	möglich
gross	JJ	7	groß, große, großen, großer
Gehen	VB, NNP	7	Geht, Gehen
Menschen	NN	7	Menschen
bekommen	VBN, VB	7	bekommen
Gleichheit	NN	7	Gleichheit
Mutter	NN, JJ	7	Mutter
reden	VB, VBN	7	reden, rede
Jungfer	NN, NNP	7	Jungfer
Heirat	NN, NNS	7	Heirat, Heiraten
weit	JJ	7	weit
eher	RB, IN	7	eher
suchen	VB, RP, VBN	7	suchen, gesucht, sucht
längst	RB, WRB, RP	7	längst
willst	WRB, IN	6	willst
fangen	VB, VBN, RP	6	fängst, fingen, fängt, gefangen
Schweig	JJ, RB	6	Schweig
desto	CC	6	desto
vielleicht	RB, RP	6	vielleicht
weiblich	JJ	6	weiblichen, weibliches, weiblicher, weibliche
schönste	NN, NNP	6	schönste
Wer	WP	6	Wer
lange	IN, WRB, NNP, RB, RP	6	lange
kurz	JJ	6	kurz
beid	DT, JJ	6	beide, beides
Dass	IN	6	Daß
Je	IN, RB	6	Je
kennen	VB	6	kenne, kennen
Betrachtung	NN	6	Betrachtung
Kommen	NN	6	Kommen
verlieren	VBN, VB	6	verloren, verlieren, verliert
Warum	NN	6	Warum
Verzeichnis	NN	6	Verzeichnis
Vaters	NN	6	Vaters
Erfahrung	NN	6	Erfahrung
antworen	VB	6	antworten
Gott	NN	6	Gott
gern	RB, IN	6	gern
Hause	NN, NNP	6	Hause
Leichtgläubigkeit	NN	6	Leichtgläubigkeit
Glück	NN	6	Glück
Gewiss	UH	6	Gewiß
vortrefflich	JJ	6	vortrefflich, vortreffliche
andre	NN	5	andre
schöne	NN	5	schöne
Wasser	NN, JJ	5	Wasser
vergleichen	VB	5	vergleichen, vergliche
los	RP, RB	5	los
gehabt	NN, NNP	5	gehabt
Geschlecht	NN	5	Geschlecht
Lisette	NN	5	Lisette
unserm	PRP$	5	unserm
Torheit	NN	5	Torheit
wegen	RP, IN	5	wegen
ähnlich	JJ	5	ähnlich
Bitte	NNS, NN	5	Bitten, Bitte
merken	VB, VBN	5	merkt, merken, gemerkt
liebster	JJ, NN	5	liebster
geschwind	RP, RB	5	geschwind
besser	RP, RB, IN	5	besser
schicken	VB, VBN	5	geschickt, schicken
Verdruss	NN	5	Verdruß
Stadt	NN	5	Stadt
Stille	NN	5	Stille
bloss	RB, JJ, IN	5	bloß, bloße
darüber	RB	5	darüber
Bedingung	NN	5	Bedingung
arm	JJ	5	arm, armes, armen
lass	JJ, NN	5	laß, lasse
Schaden	NN	5	Schaden
warum	WRB	5	warum
reisen	VB	5	reisen
darauf	RB	5	darauf
Gesicht	NN	5	Gesicht
Seele	NN	5	Seele
verbinden	VB, VBN	5	verbinde, verbunden
verlangen	VB, RP	5	verlangen, verlangt
Höre	NN	5	Höre
Adam	NNP	5	Adam
Lust	NN	5	Lust
jemals	IN, RB	4	jemals
Miene	NNS, NN	4	Mienen, Miene
vorher	RB	4	vorher
bösen	NN	4	bösen
Antwort	NN	4	Antwort
weniger	RP, RB	4	weniger
Vergnügen	NN	4	Vergnügen
Mamsell	NN	4	Mamsell
Vernunft	JJ, NN	4	Vernunft
best	JJ, NN	4	besten
erzählen	VB	4	erzählt, erzählen, erzählte
Schmeicheleien	NN	4	Schmeicheleien
nie	RB	4	nie
sprechen	VB, PRP$	4	sprechen
niemals	RB, RP	4	niemals
Sagen	NN	4	Sagen
stiften	VB	4	stiften
Ende	NN	4	Ende
verdienen	VBN, VB	4	verdient, verdienen
fort	RP	4	fort
deswegen	RB, RP	4	deswegen
Tat	NN	4	Tat
lächerlich	JJ	4	lächerliche, lächerlich
unsere	PRP$	4	unsere
Sage	NN	4	Sage
Einwilligung	NN	4	Einwilligung
st	PRP$	4	st
entbehren	VB	4	entbehren
lieben	VB, NN	4	lieben, liebe
zweit	JJ	4	zweite, zweiten
Geduld	NN	4	Geduld
ansehen	VB, RP	4	ansehen, angesehen
versichert	NN	4	versichert
Hätte	NN	4	Hätte
hernach	NN	4	hernach
Weibern	NN	4	Weibern
her	IN	4	her
Ehre	NN	4	Ehre
alt	JJ	4	alten, alte
Braut	NN	4	Braut
Körper	NN	4	Körper
besitzen	VB	4	besitzen
St	PRP$	4	St
List	NN	4	List
Leanders	NN	4	Leanders
nötigen	VB, VBN	4	nötigen, nötig
nein	RP, RB	4	nein
vollkomm	JJ	4	vollkommen
Gehorsam	NN	4	Gehorsam
Tage	NN	4	Tage
Manne	NN	4	Manne
fürchte	NN	4	fürchte
Tagen	NN	4	Tagen
besonders	RB	4	besonders
erklären	VB	4	erklären
fein	JJ	4	fein, feinen
danken	VB	4	danken
Verstand	NN	4	Verstand
erstaunen	VB	4	erstaunen
Mannsperson	NN	4	Mannsperson
kaum	RB	4	kaum
gelten	VB	4	gelten, gilt
ungeduldig	JJ	4	ungeduldig
zärtlich	JJ	4	zärtlich, zärtlichen, zärtliche
begehen	VB, VBN	4	begehen, begangen
etwa	IN, RB	4	etwa
seit	IN	4	seit
grau	JJ	4	graue, grau
gefallen	VB, RP	4	gefallen
gebe	NN	4	gebe
sollst	RB, RP	4	sollst
gleichwohl	RB, IN	4	gleichwohl
Weibsbild	NN	4	Weibsbild
Allein	NN	4	Allein
Gelegenheit	NN	4	Gelegenheit
Ohr	NN	4	Ohr
zwei	CD	4	zwei
geringsten	NN	4	geringsten
freilich	RB, IN	4	freilich
ha	NN	4	ha
jung	JJ	4	junge, jung, jungen, junger
voraus	JJ, RB	3	voraus
Unrecht	NN	3	Unrecht
wahrhaftig	JJ	3	wahrhaftig
Merken	NN	3	Merken
Acht	NN	3	Acht
schiehen	VB, RB	3	geschieht
spät	JJ	3	spät
hintergehen	NN, VB	3	hintergehen, hintergeht
vergessen	VBN, RP	3	vergessen
verschwiegen	NN	3	verschwiegen
Hülfe	NN	3	Hülfe
versprechen	VB	3	versprechen, versprachen
Mädchen	NN	3	Mädchen
Rechte	NN	3	Rechte
Gönner	NNP	3	Gönner
geliebt	NN	3	geliebt
wussen	VB	3	wußte
Ganz	NN	3	Ganz
abgeschmackt	JJ	3	abgeschmackt
Sei	NN	3	Sei
entschuldigen	VB	3	entschuldigt, entschuldigen
dafür	RB	3	dafür
Macht	NN	3	Macht
Bruders	NN	3	Bruders
Leute	NN	3	Leute
Freilich	JJ	3	Freilich
anfangen	RP, VB	3	anfängt, anfangen
enthalten	VBN, VB	3	enthalten, enthielt
wider	IN	3	wider
Sies	RB, RP	3	Sies
dächte	NN	3	dächte
Garten	NN	3	Garten
Beweis	NNS, NN	3	Beweise, Beweis
schäme	NN	3	schäme
Eigenschaft	NNS	3	Eigenschaften
weiss	VB	3	weiß
schwarz	JJ	3	schwarze, schwarz
darausen	VB	3	daraus
Schulden	NN	3	Schulden
leiden	VB	3	leiden
Dingen	NN	3	Dingen
gestraft	NN	3	gestraft
Sachte	PRP$	3	Sachte
ehrlich	JJ	3	ehrlichen, ehrlicher
versuchen	RB, VBN, VB	3	versucht, versuchen
Weiberfeinde	NN	3	Weiberfeinde
liebte	NN	3	liebte
liebern	VB	3	lieber
Advokat	NN	3	Advokat
schlassen	VB	3	schließen, schließt
Verdacht	NN	3	Verdacht
Gesellschaft	NN	3	Gesellschaft
Beste	NN	3	Beste
schuldig	JJ	3	schuldig
blind	JJ	3	blinden, blind
Nase	NN	3	Nase
schlecht	JJ	3	schlechte
Kurz	NN	3	Kurz
Treten	NN	3	Treten
Furcht	NN	3	Furcht
lernen	RB, VB	3	lernt, lernen
führen	PRP$, VB	3	führen
bereits	RB, IN	3	bereits
Mädel	NN	3	Mädel
Erlauben	NN	3	Erlauben
Glücke	NN	3	Glücke
darin	RB	3	darin
tragen	VBN, VB	3	getragen, tragen, trägt
hochzuehrender	NNP	3	hochzuehrender
dabei	RB	3	dabei
erschaffen	VB	3	erschaffen
Ankunft	NN	3	Ankunft
Falle	NN	3	Falle
darf	VB, RB	3	darf
erzeigen	NN	3	erzeigen
zuvor	RB	3	zuvor
vergeben	VB	3	vergeben
unangenehm	JJ	3	unangenehm
überzeugt	JJ, RB	3	überzeugt
zuerst	RB, RP	3	zuerst
Darf	NN	3	Darf
richtig	JJ	3	richtig, richtiges
breit	JJ	3	breit
übel	JJ	3	übel
worden	VBN	3	worden
meist	DT	3	meisten
Auchen	RB, VB	3	Auch
alsdenn	RB	3	alsdenn
streiten	VB	3	streiten
grösst	JJ	3	größte
schlechten	NN, JJ	3	schlechten
halte	NN	3	halte
dreimal	RB	3	dreimal
heiraten	VB	3	heiraten
Alter	NN	3	Alter
närrisch	JJ	3	närrisch
ernsthaft	JJ, RB	3	ernsthaft
fallen	VB	3	fallen
wagen	VB, VBN	3	wagen, gewagt
Erzählung	NN	3	Erzählung
bedenken	VB	3	bedenken
Umstand	NNS	3	Umstände
Ursache	NN	3	Ursache
selb	DT	3	selber
unsinnig	JJ	3	unsinnige, unsinnig
Hören	NN	3	Hören
seh	PRP$	3	seh
finde	NN	3	finde
zusammen	RB, RP	3	zusammen
Freundschaft	NN	3	Freundschaft
abern	RP, VBN, RB	3	aber
Gegenwart	NN	3	Gegenwart
verlassen	VB	3	verlassen
Wette	NN	3	Wette
Namen	NN	3	Namen
erwarten	VB	3	erwarten, erwartet
acht	CD	3	acht
daraus	RB	3	daraus
Geheimnis	NNS, NN	3	Geheimnisse, Geheimnis
helfen	VB	3	helfen, hilft
erlangen	VB, VBN	3	erlangten, erlangt, erlangen
endlichen	VB, VBN	3	endlich
liebst	NN, RP, RB	3	liebste, liebst
Gewogenheit	NN	3	Gewogenheit
Familie	NN	3	Familie
Brief	NNS	3	Briefe
gütig	JJ	3	gütig
schön	JJ	3	schön
genassen	VB	3	genießen
Brautwerber	NN	3	Brautwerber
Fragen	NN	3	Fragen
Register	NN	3	Register
Hochedelgeborner	NN	3	Hochedelgeborner
Übel	NN	3	Übel
geheim	JJ	3	geheim, geheime
hinderlich	JJ	3	hinderlich
dahin	RB	3	dahin
ichs	NN	3	ichs
zurück	RP, RB, IN	3	zurück
jemand	RB, DT	3	jemand
Vielleicht	IN, RB, RP	3	Vielleicht
leben	VB	3	leben, lebt
dochen	VBN, RB	3	doch
Untreue	NN	3	Untreue
wäre	VB	3	wäre
Wahrheit	NN	3	Wahrheit
besinnen	VB	3	besonnen, besinnen
Freund	NNS, NNP	3	Freunde, Freund
Kopf	NN	3	Kopf
insonders	NN	3	insonders
heeissen	VB	3	heißt
erkennen	VB, VBN	3	erkennen, erkannt
erstaune	NN	3	erstaune
hängen	VB	3	gehangen, hängen
Vertrauen	NN	3	Vertrauen
Weiberfeindschaft	NN	3	Weiberfeindschaft
Mensch	NN	3	Mensch
davon	RB	3	davon
Ihrigen	NN	3	Ihrigen
Indemen	RB, VB	2	Indem
Sprache	NN	2	Sprache
Farbe	NN	2	Farbe
Wuchs	NN	2	Wuchs
Weibsbilde	NN	2	Weibsbilde
angefangen	NN	2	angefangene, angefangen
überzeugen	VB	2	überzeugt, überzeugen
Unglücke	NN	2	Unglücke
reichen	VB	2	reiche, reichen
welch	WDT	2	welche, welches
Verderbens	NN	2	Verderbens
sicher	RP, RB	2	sicher
Zweifel	NN	2	Zweifel
wann	WRB	2	wann
Scham	NN	2	Scham
Jungen	NN	2	Jungen
verbindlich	JJ	2	verbindlich
Weise	NN	2	Weise
Schätzbarste	NN	2	Schätzbarste
Drei	CD	2	Drei
Lisettchen	JJ, VB	2	Lisettchen
gröss	JJ	2	größer
Seite	NN	2	Seite
völlig	JJ	2	völlig
Bleib	NN	2	Bleib
unterscheiden	VB, VBN	2	unterscheiden, unterschieden
brauchen	VB	2	brauchen, braucht
Verkleidung	NN	2	Verkleidung
herkommen	VB	2	herkommen
albern	JJ	2	albern, albernes
vieles	NN	2	vieles
leugnen	PRP$, VB	2	leugnen
stellen	VB	2	stellen
Anschlag	NN	2	Anschlag
Einfall	NN	2	Einfall
recht	RB, NN	2	recht
Liebhaber	NN	2	Liebhaber
Sinne	NN	2	Sinne
daher	RB	2	daher
sieh	NN	2	sieh
Ehen	NN	2	Ehen
vielmehr	RB, RP	2	vielmehr
schämen	VB	2	schämen
Sohne	PRP$	2	Sohne
erhalten	VB	2	erhalten
daranen	RB, VB	2	daran
Unglücklicher	NN	2	Unglücklicher
könne	VB	2	könne
Handlung	NN	2	Handlung
Sieh	NN	2	Sieh
vergeb	NN	2	vergeb
vertrauen	VB	2	vertrauen
wüsste	NN	2	wüßte
legen	VBN	2	gelegt
ankommen	VB, VBN	2	ankommen
unglücklich	JJ	2	unglückliches, unglücklich
Streit	NNS, NN	2	Streite, Streit
Stolz	NN	2	Stolz
gönnen	VB	2	gönnen
verwünschte	NN	2	verwünschte
Zärtlichkeit	NN	2	Zärtlichkeit
Ha	NN	2	Ha
Schwager	NN	2	Schwager
darunter	RB	2	darunter
bestärkt	NN	2	bestärkt
nochmals	RB	2	nochmals
bös	JJ, NN	2	böse, bösen
woran	WDT	2	woran
schweigen	VB	2	schweigen, schweigt
wahrscheinlicher	NNP, NN	2	wahrscheinlicher
Bauer	NN	2	Bauer
behandeln	VBN, VB	2	behandelt
woher	WRB, RB	2	woher
dritt	JJ	2	dritten, dritte
erscheinen	VB	2	erschienen, erscheinen
Taler	NN	2	Taler
dacht	RB	2	dacht
Uneinigkeit	NN	2	Uneinigkeit
Erstaunen	NN	2	Erstaunen
offenbar	JJ	2	offenbar, offenbare
Eben	NN	2	Eben
Mademoisell	NN	2	Mademoisell
gehorchen	VB	2	gehorchen
herzlich	JJ	2	herzlich
mache	NN	2	mache
gerechteste	NN	2	gerechteste
Gütigkeit	NN	2	Gütigkeit
Wahrhaftig	JJ	2	Wahrhaftig
Tölpel	NN	2	Tölpel
Gange	NN	2	Gange
stolz	JJ	2	stolz
ausgegangen	RB, NN	2	ausgegangen
ungern	NN	2	ungern
Probe	NN	2	Probe
küsst	NN	2	küßt
Schlimmen	NN	2	Schlimmen
Antworten	NN	2	Antworten
Sachen	NN	2	Sachen
Kuppeln	NN	2	Kuppeln
verheiratet	JJ	2	verheiratet
bemerken	VB, VBN	2	bemerken, bemerkt
gehn	NN	2	gehn
erbitten	VB	2	erbitten
geht	VB	2	geht
sau	JJ	2	sauer
fassen	VBN, VB	2	gefaßt
Ähnlichkeit	NN	2	Ähnlichkeit
dazuen	VB	2	dazu
betrachten	VB	2	betrachten
Alters	NN	2	Alters
verdrüsslichen	VBN	2	verdrüßlich
väterlich	JJ	2	väterlichen, väterliche
verdrüsslich	JJ	2	verdrüßlichen
einräumen	VB	2	einräumen
Partes	NN	2	Partes
Anverwandten	NN	2	Anverwandten
Jahr	NN	2	Jahr
sichs	NN	2	sichs
tue	NN	2	tue
Verbeugung	NN	2	Verbeugung
Hast	NN	2	Hast
Unmöglich	JJ, RB	2	Unmöglich
Mund	NN	2	Mund
zugleich	RB	2	zugleich
Höflichkeit	NN	2	Höflichkeit
öffentlich	JJ	2	öffentlich, öffentlichen
darübern	VB, RB	2	darüber
glücklichen	VBN	2	glücklich
bereden	NN	2	bereden
begegnen	VB	2	begegnen
Getroffen	NN	2	Getroffen
Nebenbuhler	NN	2	Nebenbuhler
unschuldigen	PRP$	2	unschuldigen
Kinder	NN	2	Kinder
habt	NN	2	habt
wärst	NN	2	wärst
fragen	RP, VB	2	gefragt, fragen
nötig	JJ, VB	2	nötig, nötiger
diejenig	JJ, WDT	2	diejenige, diejenigen
Neigung	NN	2	Neigung
dabeien	VB	2	dabei
Nu	NN	2	Nu
Schönheit	NN	2	Schönheit
Küche	NN	2	Küche
schönen	VB, PRP$	2	schönen
Aufwartung	NN	2	Aufwartung
Wissen	NN	2	Wissen
zanken	NN	2	zanken
pfui	UH	2	pfui
sagst	NN	2	sagst
notwendig	JJ, RB	2	notwendig
empfindlich	JJ	2	empfindliches, empfindliche
liebste	NN	2	liebste
laut	JJ	2	lauter, laut
frei	JJ	2	frei
aufzuwickeln	NN	2	aufzuwickeln
zweimal	RB	2	zweimal
Türe	NN	2	Türe
Ähnliches	NN	2	Ähnliches
leid	JJ	2	leid
Jahren	NN	2	Jahren
Pfui	NN	2	Pfui
darum	RB	2	darum
Gewissen	NN	2	Gewissen
mirs	NN	2	mirs
fürchtete	NN	2	fürchtete
hochschätze	NN	2	hochschätze
irren	VB	2	irren
Augenschein	NN	2	Augenschein
insgesamt	RB, IN	2	insgesamt
ihrentwegen	PRP$	2	ihrentwegen
verschieden	RB, JJ	2	verschieden, verschiedene
weitläuftig	JJ	2	weitläuftig
nimmermehr	NN	2	nimmermehr
Tag	NN	2	Tag
ersparen	VB	2	ersparen
geringste	NN	2	geringste
lässen	VB	2	läßt
versteh	NN	2	versteh
überall	RB, RP	2	überall
Vergebung	NN	2	Vergebung
schamrot	NN	2	schamrot
Vollkommenheiten	NN	2	Vollkommenheiten
hitzig	JJ	2	hitzigen, hitzig
Achtung	NN	2	Achtung
Händen	NN	2	Händen
hie	JJ, RB	2	hier
bedient	NN	2	bedient
Anschlage	NN	2	Anschlage
Gesichtsbildung	NN	2	Gesichtsbildung
Tode	NN	2	Tode
Fehler	NN	2	Fehler
dadurch	RB	2	dadurch
zwingen	VB	2	zwingen
vergehen	VB	2	vergeht, vergehen
Lisettch	JJ, VB	2	Lisettchen
erfährt	NN	2	erfährt
Schlimmste	NN	2	Schlimmste
Ding	NN, JJ	2	Ding, Dingen
ungehalten	NN	2	ungehalten
bekomme	NN	2	bekomme
Aufrichtigkeit	NN	2	Aufrichtigkeit
andermal	RB	2	andermal
Sollen	MD, NN	2	Soll, Sollen
künftig	JJ	2	künftigen
Rate	NN	2	Rate
Lass	NN	2	Laß
Wiedersehen	NN	2	Wiedersehen
Nehmen	VB	2	Nehmen
mehreres	NN	2	mehreres
Schicksal	NN	2	Schicksal
sähe	NN	2	sähe
Feind	NN	2	Feind
heimlich	JJ	2	heimlich
häuslich	JJ	2	häuslichen
Gebieterin	NN	2	Gebieterin
bedacht	NN	2	bedacht
prozessieren	VB	2	prozessieren
weder	CC	2	weder
hieher	NN	2	hieher
mitgeben	NN	2	mitgeben
Leben	NN	2	Leben
zuversichtlich	JJ	2	zuversichtlich
Mache	NN	2	Mache
Komödienschreiber	NN	2	Komödienschreiber
reich	JJ	2	reich
wünscht	JJ	2	wünscht, wünschte
verwickelt	NN	2	verwickelt
verdammten	NN	2	verdammten
demjenigen	NN	2	demjenigen
verwickeln	NN	2	verwickeln
Hut	NN	2	Hut
befehlen	VB	2	befehlen
weswegen	IN, WRB	2	weswegen
verschonen	VB	2	verschonen
Willen	NN	2	Willen
Freude	NN	2	Freude
triumphierenden	NN	2	triumphierenden
Äusserlichen	NN	2	Äußerlichen
wette	NN	2	wette
Sobald	NN	2	Sobald
hiervon	RB	2	hiervon
wundern	VB	2	wunderten, wundern
unbekannt	JJ	2	unbekannten
eifersüchtig	JJ	2	eifersüchtig
liegen	VB	2	liegt
Liebkosungen	NN	2	Liebkosungen
geraten	RP, VB	2	geraten
heraus	RP, JJ	2	heraus
wunderlich	JJ	2	wunderlich, wunderlichen
gedenken	VB, VBN	2	gedenken, gedacht
hässlich	JJ	2	häßlichen, häßlich
aufrichtig	JJ, NN	2	aufrichtig, aufrichtiges
zufried	JJ	2	zufrieden
einbilden	NN	2	einbilden
weisen	VB	2	weisen
Zuflucht	NN	2	Zuflucht
nied	JJ	2	nieder
hierin	NN	2	hierin
verlor	JJ	2	verloren
vorstellen	VBN, VB	2	vorgestellt, vorstellen
Kaufmann	NN	2	Kaufmann
Schelm	NN	2	Schelm
jetzen	VBN, RB	2	jetzt
trauen	VB	2	trauen
bessern	VBN	2	gebessert, besser
Rolle	NN, JJ	2	Rolle
verständiger	NNP, NN	2	verständiger
Schöne	NN	2	Schöne
Sentenz	NN	2	Sentenz
Geh	NN	2	Geh
hassen	VB	2	hassen
Hoffnung	NN	2	Hoffnung
ziehen	VBN	2	gezogen
Reiz	NNS	2	Reize
Vors	NN	2	Vors
erweisen	VBN, VB	2	erweisen, erwies
feurig	JJ	2	feurig
Vergleichen	RB, VB	2	Vergleichen
daran	RB	2	daran
eins	CD	2	eins
Bildung	NN	2	Bildung
Lebhaftigkeit	NN	2	Lebhaftigkeit
melden	VB	2	melden
aussterben	VB	2	aussterben
Gehülfin	NN	2	Gehülfin
Haus	NN	2	Haus
Unsinnigkeit	NN	2	Unsinnigkeit
Blumenstrausse	NN	2	Blumenstrauße
Respekt	NN	1	Respekt
herausreissen	NN	1	herausreißen
eheleiblich	JJ	1	eheleiblichen
Liebste	NN	1	Liebste
Ehr	TRUNC	1	Ehr-
versprichst	NN	1	versprichst
Kleid	NNS	1	Kleider
euerm	NNP	1	euerm
Platz	NN	1	Platz
richten	VB	1	richten
ausserordentlich	RB	1	außerordentlich
Trotz	IN	1	Trotz
gerade	IN	1	gerade
pflegen	VB	1	pflegen
Denkungsart	NNP	1	Denkungsart
zweideutig	JJ	1	zweideutig
Fortspielen	VB	1	Fortspielen
nachgelesen	NN	1	nachgelesen
Handelsmann	NN	1	Handelsmann
anfang	JJ	1	anfangen
versprach	NN	1	versprach
verfolgen	VB	1	verfolgen
Unzeit	NN	1	Unzeit
sehren	VB	1	sehr
Rufen	NN	1	Rufen
warne	NN	1	warne
Flattergeist	NN	1	Flattergeist
Kindheit	NN	1	Kindheit
äusserlich	JJ	1	äußerlichen
toll	RB	1	toll
annehmen	VB	1	annehmen
neu	JJ	1	neue
begucken	NN	1	begucken
allzuwohl	CC	1	allzuwohl
verspreche	NN	1	verspreche
Vorteil	NN	1	Vorteil
gelebt	NN	1	gelebt
Gestehen	NN	1	Gestehen
Mangel	NN	1	Mangel
gesinnt	NN	1	gesinnt
putzen	RP	1	geputzt
müd	JJ	1	müde
Frist	NN	1	Frist
ungebetn	NN	1	ungebetne
Gefälligkeit	NN	1	Gefälligkeit
Jed	JJ	1	Jeder
sicherer	NN	1	sicherer
ausfallen	VB	1	ausfallen
Sirene	NN	1	Sirene
hieren	VBN	1	hier
arme	NN	1	arme
Dinge	NN	1	Dinge
Fingers	JJ	1	Fingers
warm	JJ	1	warm
hole	VB	1	hole
Stube	NN	1	Stube
richtete	NN	1	richtete
untreu	JJ	1	untreu
Habit	NN	1	Habit
springen	VB	1	springe
heirate	NN	1	heirate
anstehen	NN	1	anstehen
Närrisch	JJ	1	Närrisches
Höflichkeitsbezeigungen	NN	1	Höflichkeitsbezeigungen
Sähe	NN	1	Sähe
niemand	DT	1	niemand
satt	JJ	1	satt
Maskerade	NN	1	Maskerade
höre	VB	1	höre
hoh	JJ	1	hohen
Legen	NN	1	Legen
Raserei	NN	1	Raserei
fleissig	JJ	1	fleißig
überhaupt	RB	1	überhaupt
standhaft	NN	1	standhaft
Anstatt	NN	1	Anstatt
billig	JJ	1	billig
Rückzuge	NN	1	Rückzuge
wegkommen	VB	1	wegkommen
dreimaligen	NN	1	dreimaligen
antreffen	NN	1	antreffen
Augenblick	NN	1	Augenblick
Ansuch	JJ	1	Ansuchen
verstellt	NN	1	verstellt
gütige	NN	1	gütige
Trost	NN	1	Trost
Frage	NN	1	Frage
Allzuglücklicher	NN	1	Allzuglücklicher
Gestalt	NN	1	Gestalt
mitnehmen	VB	1	mitnehmen
ungetreuen	NN	1	ungetreuen
Haushaltung	NN	1	Haushaltung
Akten	NN	1	Akten
aufrichtiger	NNP	1	aufrichtiger
Wüsste	NN	1	Wüßte
bisher	IN	1	bisher
Hie	RB	1	Hier
falsch	JJ	1	falschen
Antrag	NN	1	Antrag
Maske	NN	1	Maske
bestrickt	NN	1	bestrickt
geweissen	VB	1	gewiß
Zieh	NN	1	Zieh
erschrecklich	JJ	1	erschrecklich
befreiet	NN	1	befreiet
Desto	NN	1	Desto
zerriss	JJ	1	zerrissen
Klotz	NN	1	Klotz
verabscheuen	VB	1	verabscheuen
Stirne	NN	1	Stirne
erwidert	NNP	1	erwidert
abziehen	RP	1	abgezogen
behutsamsten	NN	1	behutsamsten
Beitrag	NN	1	Beitrag
Wahne	NN	1	Wahne
schweig	JJ	1	schweig
Geschwind	NN	1	Geschwind
beimess	DT	1	beimessen
Hängen	NN	1	Hängen
Mühle	NN	1	Mühle
Anpreisung	NN	1	Anpreisung
entschloss	JJ	1	entschlossen
Köpfchen	NN	1	Köpfchen
Verzeihen	NN	1	Verzeihen
Hure	NN	1	Hure
unterstehst	NN	1	unterstehst
daraufen	VB	1	darauf
Ehekriepel	NN	1	Ehekriepel
Gönnen	NN	1	Gönnen
ange	NN	1	ange
vorbereiten	VB	1	vorbereiten
betauerten	NN	1	betauerten
Mannskleidern	NN	1	Mannskleidern
Ernste	NN	1	Ernste
Gleichwohl	RB	1	Gleichwohl
nichtswürdigen	NN	1	nichtswürdigen
angemerkt	NN	1	angemerkt
mürrisch	JJ	1	mürrischen
Worten	NN	1	Worten
Schuhen	NN	1	Schuhen
gefährlich	JJ	1	gefährlich
raten	VB	1	raten
auszuspalten	VB	1	auszuspielen
tot	JJ	1	tot
innerlich	JJ	1	innerlichen
Woher	NN	1	Woher
Vexieren	NN	1	Vexieren
leichtsinnig	JJ	1	leichtsinnig
Ungewisses	NN	1	Ungewisses
nahe	IN	1	nahe
formell	JJ	1	formellen
galant	JJ	1	galant
weggeschnitten	NN	1	weggeschnitten
Sternchen	NN	1	Sternchen
Nichtswürdiges	NN	1	Nichtswürdiges
Geschlechts	NN	1	Geschlechts
Gleichgültigkeit	NN	1	Gleichgültigkeit
Nichtswürdigen	NN	1	Nichtswürdigen
See	NN	1	See
vorgegebene	NN	1	vorgegebene
treu	DT	1	treuen
ewig	JJ	1	ewig
vorziehen	VB	1	vorziehe
Schelmereien	NN	1	Schelmereien
vorzustellen	VB	1	vorzustellen
Bissen	NN	1	Bissen
Mitleid	NN	1	Mitleid
Einfalt	NN	1	Einfalt
angenehm	JJ	1	angenehm
bleib	NN	1	bleib
lästern	NN	1	lästern
genennt	NN	1	genennt
besuchen	VB	1	besuchen
Kanzeleistile	NN	1	Kanzeleistile
vorbauen	NN	1	vorbauen
hältst	WRB	1	hältst
Sicherheit	NN	1	Sicherheit
gedachte	NN	1	gedachte
unbeantwortet	NN	1	unbeantwortet
Räuber	NN	1	Räuber
beschämt	JJ	1	beschämt
nämlich	RB	1	nämlich
geschlagen	NN	1	geschlagen
Dienste	NN	1	Dienste
Verzeihung	NN	1	Verzeihung
Jahre	NN	1	Jahre
liess	VB	1	ließ
Ihrentwegen	JJ	1	Ihrentwegen
Verbindung	NN	1	Verbindung
kaumen	RP	1	kaum
angehend	JJ	1	angehender
sagt	JJ	1	sagt
mengen	VB	1	mengt
eigensinnigen	NN	1	eigensinnigen
gewandt	JJ	1	gewandt
hundertmalten	VBN	1	hundertmal
Königin	NN	1	Königin
kurzen	NN	1	kurzen
Possen	NN	1	Possen
abgehalten	NN	1	abgehalten
rechtschaffen	JJ	1	rechtschaffenen
Reputation	NN	1	Reputation
bezeuge	NN	1	bezeuge
verteidigen	VB	1	verteidigen
saur	JJ	1	saurer
Führen	NN	1	Führen
Dache	NN	1	Dache
schwach	JJ	1	schwach
Strenge	NN	1	Strenge
schimpflich	JJ	1	schimpflich
Hippia	NN	1	Hippia
ausführen	VB	1	ausführen
Proportion	NN	1	Proportion
Hässlich	JJ	1	Häßliche
heraussagen	NN	1	heraussagen
Umgange	NN	1	Umgange
töricht	JJ	1	töricht
irr	JJ	1	irre
Maule	NN	1	Maule
rufen	VB	1	ruft
schadlos	NN	1	schadlos
Entschuldigung	NNS	1	Entschuldigungen
unebene	NN	1	unebene
trocknen	VB	1	trocknen
verlange	NN	1	verlange
Ausrufungen	NN	1	Ausrufungen
Anfangs	NN	1	Anfangs
Behüte	NN	1	Behüte
Wendung	NN	1	Wendung
stärk	JJ	1	stärker
Schreien	NN	1	Schreien
wohlen	RB	1	wohl
edle	NN	1	edle
Unglücklichen	VB	1	Unglücklichen
treuer	NN	1	treuer
abschläglich	JJ	1	abschläglichen
Vergleichung	NN	1	Vergleichung
natürliche	IN	1	natürliche
Grund	NN	1	Grund
müsse	VB	1	müsse
Schuld	NN	1	Schuld
Geschöpf	NN	1	Geschöpf
Verstandes	NN	1	Verstandes
Klienten	NN	1	Klienten
fest	RP	1	fest
zänkisch	JJ	1	zänkisch
lässt	VB	1	läßt
erkennt	NN	1	erkennt
Hälfte	NN	1	Hälfte
könnt	JJ	1	könnte
bösesten	NN	1	bösesten
wusste	VB	1	wußte
Eheleute	NN	1	Eheleute
geschweige	CC	1	geschweige
Valerens	NN	1	Valerens
Eroberung	NN	1	Eroberung
mangeln	VB	1	mangeln
vertausch	VB	1	vertauschen
beklag	NN	1	beklag
frostig	JJ	1	frostig
vernünftig	RB	1	vernünftig
Trunkenheit	NN	1	Trunkenheit
Ebenbilde	NN	1	Ebenbilde
worein	WRB	1	worein
meinern	JJ	1	meiner
sollt	NN	1	sollt
jetzo	NN	1	jetzo
Hundes	NN	1	Hundes
Narren	NN	1	Narren
eheste	NN	1	eheste
angekommen	NN	1	angekommen
lasst	WRB	1	laßt
ohngefähr	NN	1	ohngefähr
einzunehmen	NN	1	einzunehmen
Nickels	NN	1	Nickels
erwarte	NN	1	erwarte
Verführungen	NN	1	Verführungen
getreue	NN	1	getreue
Flamme	NN	1	Flamme
Gratulationsrede	NN	1	Gratulationsrede
billiget	NN	1	billiget
Tugend	NN	1	Tugend
Dieserwegen	NN	1	Dieserwegen
Leidenschaft	NN	1	Leidenschaft
einstecken	NN	1	einstecken
beschweren	VB	1	beschweren
hierher	RB	1	hierher
Orte	NN	1	Orte
Geier	NN	1	Geier
eingewurzelt	JJ	1	eingewurzelter
begehren	VB	1	begehren
Kinderlehren	NN	1	Kinderlehren
Arm	JJ	1	Armer
undankbaren	NN	1	undankbaren
Grimassen	NN	1	Grimassen
vorgesagt	VBN	1	vorgesagt
voraussetzt	NN	1	voraussetzt
Freuden	NN	1	Freuden
widerfahren	NN	1	widerfahren
Vergeben	NN	1	Vergeben
beneiden	VB	1	beneiden
entbrechen	VB	1	entbrechen
leeren	PRP$	1	leeren
Dixi	NN	1	Dixi
Punkt	NN	1	Punkt
Hu	NN	1	Hu
fallt	NN	1	fallt
grauen	PRP$	1	grauen
Befürchten	NN	1	Befürchten
hundertmal	RB	1	hundertmal
steure	NN	1	steure
vertraulich	JJ	1	vertraulich
Allerschlimmste	NN	1	Allerschlimmste
Grab	NN	1	Grab
Mannspersonen	NN	1	Mannspersonen
ausgelernt	NN	1	ausgelernt
Nachsicht	NN	1	Nachsicht
stecken	VB	1	stecken
plaudre	NN	1	plaudre
geringst	JJ	1	geringste
Komödie	NN	1	Komödie
reeissen	VB	1	reißen
gedient	NN	1	gedient
Geschichte	NN	1	Geschichte
Billigkeit	NN	1	Billigkeit
vorkommen	VB	1	vorkommen
unbillig	JJ	1	unbillig
Wirkungen	NN	1	Wirkungen
bestrafen	VBN	1	bestraft
Backen	NN	1	Backen
Verbindlichkeit	NNS	1	Verbindlichkeiten
nunen	VB	1	nun
ausgezischt	NN	1	ausgezischt
liesse	NN	1	ließe
rasenden	NN	1	rasenden
Nuren	RB	1	Nur
versprochenen	NN	1	versprochenen
Saufeja	NN	1	Saufeja
schlauer	JJ	1	schlauer
erspare	NN	1	erspare
mannbaren	NN	1	mannbaren
aufnehmen	VBN	1	aufgenommen
verdammte	NN	1	verdammte
demütigste	NN	1	demütigste
Plaudern	NN	1	Plaudern
Schwachheit	NN	1	Schwachheit
wisse	NN	1	wisse
erfreut	VB	1	erfreut
Dorfschaft	NN	1	Dorfschaft
Ehemann	NN	1	Ehemann
törichste	NN	1	törichste
aufgingen	NN	1	aufgingen
Willst	WRB	1	Willst
Freundin	NN	1	Freundin
erscheine	NN	1	erscheine
unerbittlich	JJ	1	unerbittlich
Verstellung	NN	1	Verstellung
stutzen	VB	1	stutzen
nu	UH	1	nu
verstehen	VB	1	verstehen
erstaunlich	JJ	1	erstaunliche
Zweierlei	NN	1	Zweierlei
stiess	NN	1	stieß
Solch	DT	1	Solche
desperaten	NN	1	desperaten
Unbekannten	NN	1	Unbekannten
Hund	NN	1	Hund
Vergessen	NN	1	Vergessen
beschrieben	NN	1	beschrieben
scharf	JJ	1	scharf
Kränke	NN	1	Kränke
Prozesses	NN	1	Prozesses
Pferd	NN	1	Pferd
möglichen	VB	1	möglichen
verwünschtes	NN	1	verwünschtes
Vaterstadt	NN	1	Vaterstadt
rot	JJ	1	roten
Verstellen	NN	1	Verstellen
quälen	VB	1	quälen
tust	NN	1	tust
schweige	NN	1	schweige
Ansatz	NN	1	Ansatz
Schade	NN	1	Schade
betagten	NN	1	betagten
Juvenals	NN	1	Juvenals
verliebt	JJ	1	verliebt
Grossmut	NN	1	Großmut
Referenz	NN	1	Referenz
applizieren	NN	1	applizieren
mehrern	NN	1	mehrern
hattet	NN	1	hattet
sinnreichste	NN	1	sinnreichste
entzücken	NN	1	entzücken
Nachahmung	NN	1	Nachahmung
abbinden	VB	1	abbinden
schwerlich	JJ	1	schwerlich
Kömmt	NN	1	Kömmt
schmerzlich	JJ	1	schmerzliche
verrichten	VB	1	verrichten
damien	IN	1	damit
würdest	RB	1	würdest
zuvorkommen	NN	1	zuvorkommen
selben	VBN	1	selbst
Grabe	NN	1	Grabe
Glaubst	NN	1	Glaubst
Narrenspossen	NN	1	Narrenspossen
Groll	NN	1	Groll
Vermögen	NN	1	Vermögen
Bedenke	NN	1	Bedenke
Knickse	NN	1	Knickse
Morgen	NN	1	Morgen
Gesperre	NN	1	Gesperre
Nickel	NN	1	Nickel
Vernehmen	NN	1	Vernehmen
platterdings	NN	1	platterdings
Ehestand	NN	1	Ehestand
Lebenslauf	NN	1	Lebenslauf
selige	NN	1	selige
Tugendsame	NN	1	Tugendsame
Lachen	NN	1	Lachen
Weiberfeinds	NN	1	Weiberfeinds
verwundern	NN	1	verwundern
Möchte	NN	1	Möchte
kanns	NN	1	kanns
vorgekommen	NN	1	vorgekommen
gewinne	NN	1	gewinne
Lidio	NN	1	Lidio
Handschuh	JJ	1	Handschuh
lesen	VB	1	lesen
Sehen	NN	1	Sehen
abtrete	NN	1	abtrete
Grausame	NN	1	Grausame
Lektion	NN	1	Lektion
worüber	RB	1	worüber
Eva	NNP	1	Eva
würdigen	VB	1	würdigen
Weibsstück	NN	1	Weibsstück
Schmeichelei	NN	1	Schmeichelei
Amte	NN	1	Amte
unsern	PRP$	1	unsern
wundre	NN	1	wundre
Schreiber	NN	1	Schreiber
vorzustehen	VB	1	vorzustehen
sterben	VB	1	starb
beantworten	PRP$	1	beantworten
Augenblicke	NN	1	Augenblicke
zumal	IN	1	zumal
gewohnt	JJ	1	gewohnt
Narrn	NN	1	Narrn
durchdringend	JJ	1	durchdringend
ausgefallen	NN	1	ausgefallen
menschlicher	NN	1	menschlicher
Mühlräder	NN	1	Mühlräder
Leuten	NN	1	Leuten
Orten	NN	1	Orten
zusammenfährst	NN	1	zusammenfährst
befunden	NN	1	befunden
Contentis	NN	1	Contentis
Hilariaten	NNP	1	Hilaria
unwidersprechlich	JJ	1	unwidersprechlich
Wumshätern	NN	1	Wumshätern
Fleisch	NN	1	Fleisch
ciceronianisch	JJ	1	ciceronianisches
ärgern	VB	1	ärgern
Namenstag	NN	1	Namenstag
unbesonnene	NN	1	unbesonnene
ärgert	NN	1	ärgert
ungehudelt	NN	1	ungehudelt
davonen	VB	1	davon
richtiges	NN	1	richtiges
richtigen	VBN	1	richtig
Barmherziger	NNP	1	Barmherziger
fasen	VB	1	fast
meinetwegen	RB	1	meinetwegen
bescheiden	JJ	1	bescheidenen
nimm	NN	1	nimm
zugetan	NN	1	zugetan
geliebte	NNP	1	geliebte
Geck	NN	1	Geck
Spare	NN	1	Spare
beherrscht	NN	1	beherrscht
verdienest	NN	1	verdienest
kehren	VB	1	kehren
ehern	JJ	1	eher
erteilt	VB	1	erteilt
versichre	NN	1	versichre
ruhen	VB	1	ruhen
Weibsvolk	NN	1	Weibsvolk
erwerben	VB	1	erwerben
drücken	VB	1	drücken
unterzubringen	NN	1	unterzubringen
Gleichnis	NN	1	Gleichnis
ei	RP	1	ei
aufhalten	VB	1	aufhalten
abzulocken	RP	1	abzulocken
bekömmt	NN	1	bekömmt
freilichen	JJ	1	freilich
rechtswegen	NN	1	rechtswegen
Prozent	JJ	1	Prozent
Verräter	NN	1	Verräter
kenn	NN	1	kenn
betriegen	NN	1	betriegen
gescherzt	NN	1	gescherzt
Wesen	NN	1	Wesen
klaren	VBN	1	klar
Bräutigams	NN	1	Bräutigams
Dummkopf	NN	1	Dummkopf
Felsenherz	NN	1	Felsenherz
Stimmen	NN	1	Stimmen
Fuss	NN	1	Fuß
Glücklichen	RB	1	Glücklichen
Schiffbruchs	NN	1	Schiffbruchs
Wen	NN	1	Wen
Geschichtbücher	NN	1	Geschichtbücher
gefährlichem	NN	1	gefährlichem
wirds	NN	1	wirds
Stutzerch	VB	1	Stutzerchen
zweien	NN	1	zweien
leitete	NN	1	leitete
Advokaten	NN	1	Advokaten
scheinend	JJ	1	scheinenden
dünkt	NN	1	dünkt
aufheben	VB	1	aufheben
Schattenspiel	NN	1	Schattenspiel
ausgeredt	NNP	1	ausgeredt
Such	JJ	1	Suchen
Ihrige	NN	1	Ihrige
Feuer	NN	1	Feuer
unterlassen	VB	1	unterlassen
erzahlt	NN	1	erzahlt
verheiraten	VB	1	verheiraten
wert	RP	1	wert
gehe	NN	1	gehe
sechs	CD	1	sechs
Hiobs	NN	1	Hiobs
Besonders	RB	1	Besonders
Schrecken	NN	1	Schrecken
abfassen	NN	1	abfassen
sah	JJ	1	sah
werdend	JJ	1	werdenden
pro	IN	1	pro
Hohn	NN	1	Hohn
Erklären	VB	1	Erkläre
Schnierbrust	NNP	1	Schnierbrust
Hals	NN	1	Hals
antworten	VB	1	antworten
Helfen	NN	1	Helfen
Babylon	NN	1	Babylon
unbedachtsam	JJ	1	unbedachtsam
fertig	JJ	1	fertig
Verehrer	NN	1	Verehrer
fremden	PRP$	1	fremden
Angst	NN	1	Angst
gekannt	NN	1	gekannt
Monat	NN	1	Monat
wiedern	VB	1	wieder
Mitleiden	NN	1	Mitleiden
ohnedem	RB	1	ohnedem
erbärmlich	JJ	1	erbärmlich
nachsehen	VB	1	nachsehen
jedermann	NNP	1	jedermann
einsehen	VB	1	einsehen
Unerlaubtes	NN	1	Unerlaubtes
ernähren	VB	1	ernähren
äusserstes	NN	1	äußerstes
fasset	NN	1	fasset
artige	NN	1	artige
erstlich	JJ	1	erstlich
unerbrochen	VB	1	unerbrochen
besorge	NN	1	besorge
bekümmern	NN	1	bekümmern
aufhören	VB	1	aufhören
Jesabel	RB	1	Jesabel
Liebenswürdige	NNP	1	Liebenswürdige
gleichgültiger	NNP	1	gleichgültiger
munt	JJ	1	munter
geh	FW	1	geh
Alsdenn	NN	1	Alsdenn
verlangst	NN	1	verlangst
ungeziemenden	NN	1	ungeziemenden
Ornate	NN	1	Ornate
vielmalten	VBN	1	vielmal
verwirrt	JJ	1	verwirrt
erkundigen	VB	1	erkundigen
unsre	PRP$	1	unsre
liebsten	NN	1	liebsten
Europäisch	JJ	1	Europäische
schreien	VB	1	schreist
versichere	NN	1	versichere
Wert	NN	1	Wert
versichern	VB	1	versichern
glassierten	NN	1	glaßierten
verzeihen	VB	1	verzeihen
Huldigung	NN	1	Huldigung
anbelangen	VB	1	anbelangt
entweder	CC	1	entweder
Lelioen	NN	1	Lelio
zugegen	NN	1	zugegen
Zwang	NN	1	Zwang
herschicken	NN	1	herschicken
kömmtsen	MD	1	kömmts
Beweisen	NN	1	Beweisen
jemanden	NN	1	jemanden
Verblendung	NN	1	Verblendung
gedulden	NN	1	gedulden
Ehekontrakt	NN	1	Ehekontrakt
scherze	NN	1	scherze
Testimoniis	NN	1	Testimoniis
Ohrfeige	NN	1	Ohrfeige
Hunde	NN	1	Hunde
andrer	NN	1	andrer
hoffe	VB	1	hoffe
wohlgeratene	NN	1	wohlgeratene
herum	IN	1	herum
grösserm	NN	1	größerm
glaube	VB	1	glaube
Ungehorsam	NN	1	Ungehorsam
Bisse	NN	1	Bisse
wahrnehmen	VB	1	wahrnehmen
Besten	NN	1	Besten
Bisher	NN	1	Bisher
schwächen	VB	1	schwächen
Plane	NN	1	Plane
schwächer	NN	1	schwächer
Waden	NN	1	Waden
Kröten	NN	1	Kröten
vergaffte	NN	1	vergaffte
mannigfaltigsten	NN	1	mannigfaltigsten
Friede	NNS	1	Frieden
Busen	NN	1	Busen
seufzet	NN	1	seufzet
Verfahren	NNP	1	Verfahren
nimmst	NN	1	nimmst
hinsah	NN	1	hinsah
bieten	VB	1	bieten
entstehen	VB	1	entstehen
eingetrieben	NN	1	eingetrieben
aussehen	VB	1	aussehen
meinst	JJ	1	meinst
dicke	NN	1	dicke
meinigen	JJ	1	meinigen
Ehesach	JJ	1	Ehesachen
wüssten	NN	1	wüßten
schonen	VB	1	schonen
kennet	NN	1	kennet
Bravo	NN	1	Bravo
schmeichle	NN	1	schmeichle
höh	JJ	1	höher
gewiesen	NN	1	gewiesen
wahren	PRP$	1	wahren
Eigennützigen	NN	1	Eigennützigen
verzweifelten	NN	1	verzweifelten
Erscheinung	NNS	1	Erscheinungen
hör	JJ	1	höre
durchs	NN	1	durchs
anständig	JJ	1	anständig
bemühen	VB	1	bemühen
erzähle	RB	1	erzähle
bedenke	NN	1	bedenke
fürchtest	NN	1	fürchtest
Schlüsse	NN	1	Schlüsse
orationis	NN	1	orationis
bereuet	NN	1	bereuet
Gehet	NN	1	Gehet
steuren	NN	1	steuren
Rednergesellschaft	NN	1	Rednergesellschaft
widerspenstig	JJ	1	widerspenstig
verzehren	VB	1	verzehren
sechsten	NN	1	sechsten
Medullina	NN	1	Medullina
ausreden	NN	1	ausreden
verüben	VB	1	verüben
vergreift	NN	1	vergreift
Meinung	NN	1	Meinung
rühmen	NN	1	rühmen
Weibsbilder	NN	1	Weibsbilder
empfinden	VB	1	empfinden
stark	JJ	1	stark
gesagt	VBN	1	gesagt
ehe	CC	1	ehe
Hochzeitkarmen	NN	1	Hochzeitkarmen
erdenken	NNP	1	erdenken
Zuneigung	NN	1	Zuneigung
Zeichen	NN	1	Zeichen
gewachsen	NN	1	gewachsen
gesellschaftlich	JJ	1	gesellschaftliche
versah	NN	1	versah
Schulter	NN	1	Schulter
Musse	NN	1	Muße
eingehen	VB	1	eingehen
schöner	NN	1	schöner
schönes	NN	1	schönes
Vorbeigehen	NN	1	Vorbeigehen
vertrackt	NN	1	vertrackt
anzudeuen	VB	1	anzudeuten
Tropfen	NN	1	Tropfen
Hof	NN	1	Hof
Gelichters	NN	1	Gelichters
erinnern	VB	1	erinnern
allzugleichgültig	JJ	1	allzugleichgültig
worauf	WRB	1	worauf
freuen	VB	1	freuen
Gesichtch	VB	1	Gesichtchen
aufgetragen	NN	1	aufgetragen
eigentlich	JJ	1	eigentlich
schätzen	VB	1	schätzen
aufzuhalten	NN	1	aufzuhalten
Schlechtest	NN	1	Schlechteste
ärgster	NN	1	ärgster
Gottes	NN	1	Gottes
Entzückung	NN	1	Entzückung
Schwindsucht	NN	1	Schwindsucht
anzuhören	VB	1	anzuhören
verwelkten	NN	1	verwelkten
Aufzug	NN	1	Aufzug
Beistandes	NN	1	Beistandes
heftig	JJ	1	heftig
Fama	NN	1	Fama
Einkauf	NN	1	Einkauf
Eltern	NN	1	Eltern
vergeissen	VB	1	vergißt
unsres	PRP$	1	unsres
unsrer	PRP$	1	unsrer
dienen	VB	1	dienen
Krähe	NN	1	Krähe
törichten	NN	1	törichten
müsste	VB	1	müßte
schimärisch	JJ	1	schimärischen
Kuppelpelz	NN	1	Kuppelpelz
wohin	WRB	1	wohin
Garne	NN	1	Garne
hinein	RB	1	hinein
Bleiben	VB	1	Bleiben
Sturm	NN	1	Sturm
Mannes	NN	1	Mannes
niedergehen	NN	1	niedergehen
Koller	NN	1	Koller
Ehescheidungsprozessen	NN	1	Ehescheidungsprozessen
Rücken	NN	1	Rücken
Kleinigkeit	NN	1	Kleinigkeit
unzählige	NN	1	unzählige
rate	NN	1	rate
Daumen	NN	1	Daumen
Strafe	NN	1	Strafe
unmöglichen	VBN	1	unmöglich
deponierten	NN	1	deponierten
abe	JJ	1	aber
gestand	VB	1	gestanden
allzutiefe	NN	1	allzutiefe
Solbien	NNP	1	Solbist
besass	NN	1	besaß
hinaus	IN	1	hinaus
ahndet	NN	1	ahndet
Lehre	NN	1	Lehre
Gesichte	NN	1	Gesichte
hochgeschätzt	NN	1	hochgeschätzt
treffen	VB	1	getroffen
Auktionatorstimme	NN	1	Auktionatorstimme
schrei	NN	1	schrei
glaubt	JJ	1	glaubte
Wirds	NN	1	Wirds
Jahres	NN	1	Jahres
stelle	NN	1	stelle
eilen	VB	1	eilen
Wurzeln	JJ	1	Wurzeln
Erzählen	NN	1	Erzählen
wohnen	VBN	1	wohnen
belangen	NN	1	belangen
Schönste	NNP	1	Schönste
nachkommen	VB	1	nachkommen
sonnenklar	NN	1	sonnenklar
Kräften	NN	1	Kräften
Schminke	NN	1	Schminke
aufs	NN	1	aufs
überflüssige	NN	1	überflüssige
hätte	RB	1	hätte
Tobias	NNP	1	Tobias
abbringen	NN	1	abbringen
Ebenbild	NN	1	Ebenbild
ruhmredig	JJ	1	ruhmredig
Grillen	NN	1	Grillen
umarmen	VB	1	umarmen
antworte	NN	1	antworte
komm	NN	1	komm
edel	JJ	1	edel
Schon	RB	1	Schon
Unternehmens	NN	1	Unternehmens
ohngeachtet	NN	1	ohngeachtet
bedeutend	JJ	1	bedeutenden
zerreeissen	VB	1	zerreißen
unbewusste	NN	1	unbewußte
anbringen	VB	1	anbringen
aushacken	NN	1	aushacken
widersprechen	VB	1	widersprechen
rasend	JJ	1	rasend
Meisterstück	NN	1	Meisterstück
werfen	VBN	1	geworfen
Männerfeindin	NN	1	Männerfeindin
deutlich	JJ	1	deutlicher
gesunden	VB	1	gesunden
zehnmal	RB	1	zehnmal
verliebtes	NN	1	verliebtes
Vorschlag	NN	1	Vorschlag
versehen	VB	1	versehen
kaufen	VB	1	kaufe
Zacharias	NNP	1	Zacharias
weibbar	JJ	1	weibbaren
bekehrt	NN	1	bekehrt
doppelte	NN	1	doppelte
Weibsperson	NN	1	Weibsperson
allerliebster	NN	1	allerliebster
feindseliger	NNP	1	feindseliger
gleichsam	RB	1	gleichsam
abhalten	VB	1	abhalten
leichtfertige	NN	1	leichtfertige
Wischiwaschi	NNP	1	Wischiwaschi
vertraute	NN	1	vertraute
altes	NN	1	altes
Fuchs	NN	1	Fuchs
stumpfe	NN	1	stumpfe
gewartet	NN	1	gewartet
Rat	NN	1	Rat
gespielt	NN	1	gespielt
Leand	JJ	1	Leander
Gutes	NN	1	Gutes
Lippe	NN	1	Lippe
erlauben	VB	1	erlauben
zankt	NN	1	zankt
dazukömmt	RB	1	dazukömmt
hart	JJ	1	hart
zugestehen	VB	1	zugestehen
Zeugnis	NN	1	Zeugnis
hoffentlich	RB	1	hoffentlich
Deinig	DT	1	Deinige
unerträglich	JJ	1	unerträglich
Muster	NN	1	Muster
Witwe	NN	1	Witwe
Schatz	NN	1	Schatz
Schritt	NN	1	Schritt
unruhig	JJ	1	unruhig
Füssen	NNP	1	Füßen
Knoten	NN	1	Knoten
valten	VBN	1	viel
zufrieden	VB	1	zufriedener
Henker	NN	1	Henker
koste	NN	1	koste
Endlich	RB	1	Endlich
Handel	NN	1	Handel
abgebe	NN	1	abgebe
wofür	WRB	1	wofür
höchst	JJ	1	höchst
Märchen	NN	1	Märchen
ausgehen	VB	1	ausgehen
speit	NN	1	speit
weisst	NN	1	weißt
nennen	VB	1	nennen
Schatten	NN	1	Schatten
Cäsonia	NN	1	Cäsonia
Aufführung	NN	1	Aufführung
schlank	VB	1	schlanker
musst	JJ	1	mußte
unverschämt	JJ	1	unverschämt
wagst	NN	1	wagst
Haustüre	NN	1	Haustüre
Närrin	NN	1	Närrin
Sorgen	NN	1	Sorgen
schmächtiger	NNP	1	schmächtiger
Sprüchworte	NN	1	Sprüchworte
wenigmale	NN	1	wenigmale
reise	NN	1	reise
unterstanden	NN	1	unterstanden
gefährlichste	NN	1	gefährlichste
messen	VBN	1	gemessen
Vornehmste	NN	1	Vornehmste
Wege	NN	1	Wege
grösstes	NN	1	größtes
Zeigen	NN	1	Zeigen
meinig	JJ	1	meinige
verschuldet	NN	1	verschuldet
Augenmass	NN	1	Augenmaß
unterdrücken	VB	1	unterdrücken
überlassen	VB	1	überlassen
mässigen	VB	1	mäßigen
Gründen	NN	1	Gründen
Peruque	NN	1	Peruque
Zuschauer	NN	1	Zuschauer
Gehör	JJ	1	Gehör
rechtschaffenen	NN	1	rechtschaffenen
ehrfurchtsvollen	NN	1	ehrfurchtsvollen
Wunderwerke	NN	1	Wunderwerke
Mehr	NN	1	Mehr
Freiheit	NN	1	Freiheit
miteinander	RB	1	miteinander
reuet	NN	1	reuet
Stande	NN	1	Stande
frisch	JJ	1	frischen
irgend	JJ	1	irgend
Heute	RB	1	Heute
Gleis	NNS	1	Gleise
Narrheit	NN	1	Narrheit
vergnügt	JJ	1	vergnügt
hoffnungslose	NN	1	hoffnungslose
verschlagenste	NN	1	verschlagenste
bedanke	NN	1	bedanke
Hörst	NN	1	Hörst
Spass	NN	1	Spaß
Gunstbezeugungen	NN	1	Gunstbezeugungen
lachen	VB	1	lachen
gelb	JJ	1	gelben
Schwägerin	NN	1	Schwägerin
treiben	VB	1	treiben
Sorge	NN	1	Sorge
eignen	VB	1	eignen
Verzeichnisse	NN	1	Verzeichnisse
weggekommen	NN	1	weggekommen
Schuppen	NN	1	Schuppen
sechstausend	JJ	1	sechstausend
zuzukehren	NN	1	zuzukehren
exklamieren	NN	1	exklamieren
manchmal	RB	1	manchmal
Schurken	NN	1	Schurken
sei	VB	1	sei
auchen	VB	1	auch
verraten	VB	1	verraten
Spitzenkrause	NN	1	Spitzenkrause
Ausspruch	NN	1	Ausspruch
Ursach	VB	1	Ursachen
aufschlagen	VB	1	aufschlagen
Orator	NN	1	Orator
niemanden	NN	1	niemanden
Kind	NNP	1	Kind
Kinn	NN	1	Kinn
gebietrischer	NN	1	gebietrischer
geheiligten	NN	1	geheiligten
stehst	NN	1	stehst
rechtschaffn	JJ	1	rechtschaffnen
Realitäten	NN	1	Realitäten
längern	VBN	1	länger
Zank	NN	1	Zank
empfehle	NN	1	empfehle
weislich	JJ	1	weislich
Barbarisch	JJ	1	Barbarische
Leibt	NN	1	Leibt
überheben	NN	1	überheben
Schranke	NNS	1	Schranken
heiratete	NN	1	heiratete
Zusammenkunft	NN	1	Zusammenkunft
Antworte	NN	1	Antworte
unange	NN	1	unange
heute	RB	1	heute
Messalina	NN	1	Messalina
Natur	NN	1	Natur
beleidigen	VB	1	beleidigen
Gickelgackel	NNP	1	Gickelgackel
Gelehrten	NN	1	Gelehrten
beleidiget	NN	1	beleidiget
Prozesse	NN	1	Prozesse
näher	JJ	1	nähere
ärger	NN	1	ärger
trügen	VB	1	trügt
bewegen	VB	1	bewegen
Ruin	NN	1	Ruin
herein	RB	1	herein
eingenommen	NN	1	eingenommen
beweisen	VB	1	beweisen
künftger	NN	1	künftger
Ehrerbietigkeit	NN	1	Ehrerbietigkeit
Gehn	NN	1	Gehn
ähnlichen	VBN	1	ähnlich
Unmöglichkeit	NN	1	Unmöglichkeit
scheinet	NN	1	scheinet
rächt	NN	1	rächt
scheinen	VB	1	scheinen
ähnlicher	RB	1	ähnlicher
Immerhinen	RB	1	Immerhin
Ufer	NN	1	Ufer
Bissch	JJ	1	Bißchen
Kummer	NNP	1	Kummer
begierig	JJ	1	begierig
Dienst	NN	1	Dienst
Gabe	NNS	1	Gaben
Staat	NNP	1	Staat
frischen	VB	1	frische
verändert	JJ	1	verändert
danke	RB	1	danke
Last	FW	1	Last
verstehn	NN	1	verstehn
abweisen	VBN	1	abgewiesen
steif	JJ	1	steif
Gutdünken	NN	1	Gutdünken
Denken	NN	1	Denken
Zufall	NNS	1	Zufälle
männlich	JJ	1	männliche
rechten	NN	1	rechten
Versparen	NN	1	Versparen
Bringe	NN	1	Bringe
ertappten	NN	1	ertappten
sorgen	VB	1	sorgen
Zerstreuung	NN	1	Zerstreuung
bezaubernden	NN	1	bezaubernden
verstatten	NN	1	verstatten
Gassen	NN	1	Gassen
Jungfern	NN	1	Jungfern
Soen	VBN	1	So
hasse	NNP	1	hasse
hoff	NN	1	hoff
steh	NN	1	steh
Pack	NN	1	Pack
vertauscht	NN	1	vertauscht
respektieren	VB	1	respektieren
erführe	NN	1	erführe
schaffen	VB	1	schaffen
verderben	VBN	1	verdorben
einräume	NN	1	einräume
Zoll	NN	1	Zoll
stossen	VB	1	stoßen
verursachen	VB	1	verursacht
übermässiger	NNP	1	übermäßiger
gehorsam	JJ	1	gehorsam
Genehmhaltung	NN	1	Genehmhaltung
besiegen	VB	1	besiegen
verräterisch	JJ	1	verräterischen
vorbringen	VB	1	vorbringen
betrogen	NN	1	betrogen
Plappermaul	NN	1	Plappermaul
Hätten	NN	1	Hätten
Schwerlichen	VBN	1	Schwerlich
darinen	VB	1	darin
besorgen	VB	1	besorgen
beschwerlich	JJ	1	beschwerlichen
link	JJ	1	linke
zehnfach	NN	1	zehnfach
wetten	VB	1	wetten
Herren	NN	1	Herren
sowohl	CC	1	sowohl
Grunde	NN	1	Grunde
Überdrusse	NN	1	Überdrusse
gesuchte	NN	1	gesuchte
Begierde	NN	1	Begierde
abtreten	VBN	1	abgetreten
sichere	NN	1	sichere
Einsicht	NN	1	Einsicht
erhole	NN	1	erhole
ausgeartete	NN	1	ausgeartete
Werke	NN	1	Werke
Merkmale	NN	1	Merkmale
Hilarien	NN	1	Hilarien
Nacht	NN	1	Nacht
einigermassen	RB	1	einigermaßen
Vertrauten	NN	1	Vertrauten
betreibsamer	NN	1	betreibsamer
dächten	NN	1	dächten
Ah	NN	1	Ah
Lobrede	NN	1	Lobrede
holen	VBN	1	geholt
Ausnahme	NN	1	Ausnahme
gehet	NN	1	gehet
verwirren	VB	1	verwirren
leichen	VBN	1	leicht
Ungewiss	JJ	1	Ungewissen
letzt	JJ	1	letzte
dadurchen	VB	1	dadurch
Steh	NN	1	Steh
lenken	VB	1	lenken
geschehen	VBN	1	geschehen
hochschätzte	NN	1	hochschätzte
Arglistigen	NN	1	Arglistigen
übrigens	RB	1	übrigens
Weib	NN	1	Weib
Ruhe	NN	1	Ruhe
Ihrentwillen	NN	1	Ihrentwillen
aufgeworfene	NN	1	aufgeworfene
entfernen	VB	1	entfernen
Mütterch	JJ	1	Mütterchen
bestens	NN	1	bestens
allzuähnlich	JJ	1	allzuähnlich
ausgekratzt	NN	1	ausgekratzt
grossmütig	JJ	1	großmütig
verdriesst	NN	1	verdrießt
begnügen	VB	1	begnügen
beschlossen	VB	1	beschloß
eigensinnig	RP	1	eigensinnig
notwendiges	JJ	1	notwendiges
gestehen	VB	1	gestanden
Geburtstag	NN	1	Geburtstag
Bedenken	NN	1	Bedenken
prahlen	VB	1	prahlen
denke	VB	1	denke
Vergilt	NN	1	Vergilt
Befehl	NN	1	Befehl
leb	JJ	1	leben
Wunsch	NN	1	Wunsch
kannst	VB	1	kannst
Gartenhaus	NN	1	Gartenhaus
Stolze	NN	1	Stolze
Unterschied	NN	1	Unterschied
Schiedsrichter	NN	1	Schiedsrichter
Schultern	NN	1	Schultern
derbe	IN	1	derbe
Eifersüchtig	JJ	1	Eifersüchtig
Fliege	NN	1	Fliege
gehts	NN	1	gehts
anhalten	VBN	1	angehalten
komplimentiert	NN	1	komplimentiert
Beiläufig	JJ	1	Beiläufig
geriet	NN	1	geriet
Schlachtopfer	NN	1	Schlachtopfer
Kredit	NN	1	Kredit
Vorschlage	NN	1	Vorschlage
Hui	NN	1	Hui
Nachkommenschaft	NN	1	Nachkommenschaft
übern	NN	1	übern
stechen	VB	1	stechen
Hilft	NN	1	Hilft
winkte	NN	1	winkte
Weiberfeind	NN	1	Weiberfeind
gründlich	JJ	1	gründlich
schmeicheln	VB	1	schmeicheln
liebenswürdig	JJ	1	liebenswürdigen
Veränderung	NN	1	Veränderung
fortpflanzen	VB	1	fortpflanzen
angenehmere	NN	1	angenehmere
dafüren	RB	1	dafür
ziemlich	JJ	1	ziemlich
auspresste	NN	1	auspreßte
Schnadern	NNP	1	Schnadern
verlasse	NNP	1	verlasse
gereuet	NN	1	gereuet
Kleidung	NN	1	Kleidung
nochen	VB	1	noch
hege	NN	1	hege
Seufzern	NN	1	Seufzern
Zwecke	NN	1	Zwecke
gereuen	NN	1	gereuen
sprichst	NN	1	sprichst
Freilichen	VBN	1	Freilich
Folge	NN	1	Folge
Aussteuer	NN	1	Aussteuer
mute	NN	1	mute
horchen	VB	1	horchen
Sohnes	NN	1	Sohnes
umgehen	VB	1	umgeht
Sekretär	NN	1	Sekretär
bestreiten	VB	1	bestreiten
siehst	NN	1	siehst
Notwendigkeit	NN	1	Notwendigkeit
Junggesellen	NN	1	Junggesellen
Womit	NN	1	Womit
morgen	RB	1	morgen
Weit	NN	1	Weit
Zunge	NN	1	Zunge
Stricken	NN	1	Stricken
sichersten	NN	1	sichersten
gleichgültig	JJ	1	gleichgültig
sträflicher	NN	1	sträflicher
auskäme	NN	1	auskäme
Unsinnig	RB	1	Unsinnig
Blicken	NN	1	Blicken
anstellen	VB	1	anstellen
dazumal	RB	1	dazumal
einzufädeln	NN	1	einzufädeln
Gehirn	NNS	1	Gehirne
abgeschmackter	NN	1	abgeschmackter
aussetzen	VB	1	aussetzen
Kompliment	NN	1	Kompliment
ablaufen	VB	1	ablaufen
Vorbereitungen	NN	1	Vorbereitungen
Gleich	NN	1	Gleich
bewandert	NN	1	bewandert
gutes	NN	1	gutes
Verschwiegenen	NN	1	Verschwiegenen
vorhern	VBN	1	vorher
matt	JJ	1	matt
Werts	NN	1	Werts
schönern	NN	1	schönern
bekennen	VB	1	bekennen
Habichtsnase	NN	1	Habichtsnase
ofen	VBN	1	oft
Selbstbetrug	NN	1	Selbstbetrug
bestätigen	VB	1	bestätigen
Daran	RB	1	Daran
liebenswürdiger	NN	1	liebenswürdiger
quo	NN	1	quo
zugehen	VB	1	zugehen
vielleichen	VBN	1	vielleicht
wovon	WRB	1	wovon
Wirklich	JJ	1	Wirklich
umständlich	JJ	1	umständlich
vorgegeben	JJ	1	vorgegebenen
Hasse	NN	1	Hasse
einerlei	RB	1	einerlei
folge	NN	1	folge
Parenthesi	NN	1	Parenthesi
wodurch	WRB	1	wodurch
klopfen	VB	1	klopfen
Glied	NNS	1	Glieder
Aufwand	NN	1	Aufwand
Konzepte	NN	1	Konzepte
Paar	NN	1	Paar
täglich	RB	1	täglich
Ewigkeit	NN	1	Ewigkeit
gefassten	NN	1	gefaßten
nasenweise	NN	1	nasenweise
zuhalten	NN	1	zuhalten
berufen	VB	1	berufen
einleiten	VB	1	einleiten
vorhergesagen	VBN	1	vorhergesagt
Schwiegertochter	NN	1	Schwiegertochter
fliegender	NN	1	fliegender
Umschreibung	NN	1	Umschreibung
Zipfeln	NN	1	Zipfeln
hättest	RP	1	hättest
äussern	VB	1	äußern
solls	RB	1	solls
Widersprech	JJ	1	Widersprechen
weglassen	VB	1	weglassen
unvermerkt	NN	1	unvermerkt
Herrch	VB	1	Herrchen
Mode	NN	1	Mode
Ernst	NNP	1	Ernst
plaudern	VB	1	plaudern
verkleinert	NN	1	verkleinert
verantworten	VB	1	verantworten
kuriös	NN	1	kuriös
geschwindesten	NN	1	geschwindesten
denk	NN	1	denk
geleg	JJ	1	gelegen
Hexen	NN	1	Hexen
Wollt	NN	1	Wollt
Törichters	NN	1	Törichters
Heuchlerin	NN	1	Heuchlerin
abgelaufen	NN	1	abgelaufen
scherzest	NN	1	scherzest
Leutch	JJ	1	Leutchen
Schluss	NN	1	Schluß
Rande	NN	1	Rande
Vormittags	NN	1	Vormittags
verfluchte	NN	1	verfluchte
völligen	NN	1	völligen
rechnen	VB	1	rechnen
erwecken	VB	1	erwecken
ausgezahlt	NN	1	ausgezahlt
Geschäften	NN	1	Geschäften
Unsere	PRP$	1	Unsere
verfolgt	VB	1	verfolgt
Gast	NN	1	Gast
Entweder	NN	1	Entweder
dawider	RB	1	dawider
genugen	RP	1	genug
gewürdiget	NN	1	gewürdiget
Anhalten	NN	1	Anhalten
reis	JJ	1	reise
Danksagung	NN	1	Danksagung
zuhält	NN	1	zuhält
Geben	NN	1	Geben
Lieben	NN	1	Lieben
heftigern	VB	1	heftiger
ganzes	NN	1	ganzes
spotten	VB	1	spotten
Contenta	NN	1	Contenta
Entschluss	NNS	1	Entschlüsse
Gesetzt	NN	1	Gesetzt
verhindern	VBN	1	verhindert
mags	NN	1	mags
Jungfergesichtch	JJ	1	Jungfergesichtchen
Frauensperson	NN	1	Frauensperson
Stoff	NN	1	Stoff
Verdienste	NN	1	Verdienste
überlegen	VB	1	überlegen
suchet	NN	1	suchet
allezeit	NN	1	allezeit
zumuten	VB	1	zumuten
vergebens	RB	1	vergebens
Augenzeuge	NN	1	Augenzeuge
taten	NN	1	taten
Eigensinne	NN	1	Eigensinne
anfechten	VB	1	anfechten
Anteil	NN	1	Anteil
Lob	NNS	1	Lobe
Ausspielen	VB	1	Ausspielen
Achsel	NN	1	Achsel
Geringfügigkeit	NN	1	Geringfügigkeit
mitgebracht	NN	1	mitgebracht
sträflich	JJ	1	sträflichen
teuerst	JJ	1	teuerste
mühseligen	NN	1	mühseligen
scherzen	VB	1	scherzen
Abscheulichkeit	NN	1	Abscheulichkeit
nichtswürdige	NN	1	nichtswürdige
Rechnung	NN	1	Rechnung
Gespräch	NN	1	Gespräch
allmählig	JJ	1	allmählig
Versicherungen	NN	1	Versicherungen
gewissen	VB	1	gewissen
spricht	JJ	1	spricht
Injuriarum	NN	1	Injuriarum
selten	RB	1	selten
Fahren	NN	1	Fahren
unstreitiges	PRP$	1	unstreitiges
Besinnen	NN	1	Besinnen
abwerfen	NN	1	abwerfen
hierauf	NN	1	hierauf
Konnte	NN	1	Konnte
ändern	VB	1	ändern
umkleide	NN	1	umkleide
wohern	RB	1	woher
entdecken	VB	1	entdecken
Erhaltung	NN	1	Erhaltung
Tollhaus	NN	1	Tollhaus
erinnert	NN	1	erinnert
Hochachtung	NNP	1	Hochachtung
verstellen	NN	1	verstellen
Plage	NN	1	Plage
Verzweiflung	NN	1	Verzweiflung
Kaufmanne	NN	1	Kaufmanne
bewundere	NN	1	bewundere
Unsinn	NN	1	Unsinn
schw	JJ	1	schwer
Wohltat	NN	1	Wohltat
Einbildung	NN	1	Einbildung
untersuchen	VB	1	untersuchen
Angriffe	NN	1	Angriffe
Welch	NN	1	Welch
mitkommen	VB	1	mitkommen
nachdenke	NN	1	nachdenke
lese	NN	1	lese
martern	NN	1	martern
vorschlagen	VB	1	vorgeschlagen
Spöttischer	NN	1	Spöttischer
weh	RP	1	weh
Unterredung	NN	1	Unterredung
geholfen	NN	1	geholfen
Lebe	NN	1	Lebe
Umständen	NN	1	Umständen
klugen	VBN	1	klug
dienstfertige	NN	1	dienstfertige
besehen	JJ	1	besehen
ersuchen	VB	1	ersuchen
haue	NN	1	haue
womit	WRB	1	womit
Verheiratung	NN	1	Verheiratung
Spötterei	NN	1	Spötterei
Mitgeben	NN	1	Mitgeben
erschrecklicher	NN	1	erschrecklicher
Rechtskonsulent	NN	1	Rechtskonsulent
genau	RB	1	genau
Quid	NN	1	Quid
Beispiele	NN	1	Beispiele
unbeschadet	NNP	1	unbeschadet
durchbringen	VBN	1	durchbringt
Gerechtigkeit	NN	1	Gerechtigkeit
vermissen	VB	1	vermissen
wende	NN	1	wende
kleinen	VB	1	kleinen
nochmaligen	NN	1	nochmaligen
Mutwillen	NN	1	Mutwillen
Sprüchelch	JJ	1	Sprüchelchen
gleichfalls	RB	1	gleichfalls
Geniessen	NN	1	Genießen
ausgenomm	JJ	1	ausgenommen
Maul	NN	1	Maul
aufbinden	NN	1	aufbinden
Jugend	NN	1	Jugend
spitziges	NN	1	spitziges
listigste	NN	1	listigste
neidisch	JJ	1	neidisch
etwan	NN	1	etwan
Stücke	NN	1	Stücke
vorzüglichern	VB	1	vorzüglicher
bescheid	JJ	1	bescheiden
Berufsverrichtungen	NN	1	Berufsverrichtungen
Gewölbe	NN	1	Gewölbe
Materie	NN	1	Materie
Bald	NN	1	Bald
erstaunt	NN	1	erstaunt
anwünscht	NN	1	anwünscht
inner	JJ	1	innere
Amt	NN	1	Amt
auszusetzen	NN	1	auszusetzen
Anfall	NN	1	Anfall
vermengen	VB	1	vermengen
Blick	NN	1	Blick
wär	NN	1	wär
nuren	VB	1	nur
seid	NN	1	seid
zweifeln	VB	1	zweifeln
ärgerlich	JJ	1	ärgerlich
beisammen	JJ	1	beisammen
versteinert	NN	1	versteinert
brauche	NN	1	brauche
Absätze	NN	1	Absätze
Nachricht	NN	1	Nachricht
Hispulla	NN	1	Hispulla
einbringen	VB	1	einbringen
Geschmack	NN	1	Geschmack
Welle	NNS	1	Wellen
versagen	RP	1	versagt
Kuppler	NN	1	Kuppler
lächlende	NN	1	lächlende
Maria	NNP	1	Maria
Fusse	NN	1	Fuße
ernstlich	JJ	1	ernstlich
Ogulina	NN	1	Ogulina
Ach	NN	1	Ach
ungeachtet	RP	1	ungeachtet
Reihe	NN	1	Reihe
höchste	NN	1	höchste
Kindern	NN	1	Kindern
alleinen	RP	1	allein
schminken	VB	1	schminken
schwamm	NN	1	schwamm
