Title: Minna von Barnhelm, oder das Soldatenglück
Number of all lemmas: 9597
Nummber of different lemmas: 3479

Lemma	POS	Frequency	Tokens
Herr	NN, JJ, NNP	211	Herr
Fräulein	NN, NNP, JJ	150	Fräulein
Major	NN, NNP, FW	135	Major
wohl	RP, RB, IN, JJ	80	wohl
Franziska	NNP, NN	79	Franziska
Tellheim	IN, RB	73	Tellheim
sagen	VB, RP, VBN	72	sagen, sage, gesagt, sagt, sagte
gut	JJ, VB	69	guten, gut, guter, gute
Mann	NN, NNP	66	Mann
hören	VBN, VB, RB	61	hörte, hört, höre, hörst, hören, hörten, höret
Wirt	NNS, NN, NNP, JJ	54	Wirte, Wirt
Ring	NN, NNS	49	Ring, Ringe
lieb	JJ, NN, VB	47	lieb, lieber, liebe, lieben
Just	NNP, NN, RB	47	Just
Geld	NN, JJ	45	Geld
gnädiges	NN, JJ	41	gnädiges
Minna	NNP, NN	40	Minna
Werner	NNP, NN	40	Werner
sehen	VB, RP, VBN	38	sehen, sieht, sah, gesehen
Ihro	NN, NNP, JJ	36	Ihro
nehmen	VB, VBN	34	nehmen, nimmt, nehme, nahm, nahmen, genommen
Wachtmeister	NN, RB, NNP	34	Wachtmeister
weeissen	VB	33	weiß
Ehre	NN, JJ	31	Ehre
Frauenzimmerchen	NN, RB, VB	30	Frauenzimmerchen
Herrn	NN, JJ	30	Herrn
sprechen	VB, VBN	29	spricht, sprechen, sprach
ist	VB, JJ, RB	28	ist
gar	RP, RB, IN	27	gar
gern	RB, RP, VBN, IN	27	gern
eben	RB, IN, RP, FW	27	eben
Freund	NNP, NN, NNS	27	Freund, Freunde
glauben	VB, RB, VBN	26	glaube, glauben, glaubte, geglaubt, glaubt
kennen	VB	25	kennen, kennt, kenne
Kind	NN	25	Kind
Brief	NN, NNS	25	Brief, Briefe
kömmen	MD	24	kömmt
allein	RP, IN, RB	24	allein
gewiss	NN, JJ	23	gewiß, gewisse, gewissen
wenig	IN, RB, JJ, RP, FW	23	wenig, wenigen
Gnade	NNS, NN	23	Gnaden, Gnade
rechen	VB	23	recht, rechten, rechte
wahr	RP, JJ, RB	22	wahr, wahre
Hand	NN, JJ	22	Hand
denken	VB	22	denken, dachte, denke, denkt
schuldig	JJ, RB	22	schuldig
vergessen	VBN, RP, VB	21	vergessen
soen	RB, VBN, VB	21	so
erst	RB, JJ, IN	21	erst, erste, ersten
Unglück	NN	21	Unglück
wissen	VB, VBN, RB	20	wissen
lesen	VB, VBN, RP	20	lesen, gelesen
meine	PRP$	20	meine
de	FW, NN	20	de
Ah	NN	20	Ah
finden	VB, VBN, RP	19	fand, gefunden, finden, findet, fanden
besser	RP, RB, IN, VB	19	besser
schönes	NN, JJ	19	schönes
Mademoiselle	NN, NNP	19	Mademoiselle
Zimmer	NN	19	Zimmer
Liebe	NN, NNP	19	Liebe
Herz	NN, NNS	18	Herz, Herzen
glücklich	JJ, VB	18	glückliche, glücklich, glücklichen, glücklicher, glückliches
hundert	CD	17	hundert
bezahlen	VB, VBN, RP	17	bezahlen, bezahlt
Taler	NN	17	Taler
Augen	NN	17	Augen
seiner	PRP$	17	seiner
Welt	NN	17	Welt
bitten	VB	16	bitte, bitten
Gnad	NNP, NN	16	Gnad
Wort	NN, NNS, JJ	15	Wort, Worte
unglücklich	JJ	15	unglücklichen, unglückliche, unglücklich
Ha	NN	15	Ha
ehrlich	JJ, VB	15	ehrlichen, ehrlicher, ehrliche, ehrlich, ehrliches
Glück	NN	15	Glück
gross	JJ	15	großen, große, groß, großer
Offizier	NN, NNS	15	Offizier, Offiziere
Manne	NN	15	Manne
le	NNP, NN, FW, JJ	15	le
ziehen	VB, VBN	15	gezogen, ziehet, zog, ziehen, zieht
Mädchen	NN	14	Mädchen
wider	IN, RP	14	wider
Gut	NN, JJ, VB	14	Gut, Guter, Gute
gnädige	NN, JJ	14	gnädige
que	NNP, NN	14	que
sonst	RB, IN, RP	14	sonst
suchen	VB	14	suchen, sucht, gesucht
Barnhelm	NNP, NN	13	Barnhelm
ik	JJ, NN	13	ik
nie	RB, IN, RP	13	nie
Pistole	NNS	13	Pistolen
Soldat	NN, NNS, NNP	13	Soldat, Soldaten
nit	NN	13	nit
hast	NN, NNP	13	hast
lässen	VB	13	läßt
heuen	VBN, RB, VB	13	heute, heut
Herrschaft	NN	13	Herrschaft
Sachse	NNS	13	Sachsen
mik	NN, NNP	13	mik
willst	WRB, RP, RB	12	willst
Ik	NN, FW, JJ	12	Ik
genug	IN, RP, RB	12	genug
Zeit	NN, JJ	12	Zeit
verstehen	VB, VBN	12	verstehe, verstehen, versteht, verstanden
fehlen	VB	12	fehlt, fehlte, fehlen
kann	VB	12	kann
habe	RB	12	habe
Vous	NN, FW, NNP	12	Vous
reden	VB, VBN	12	redest, redet, reden, rede, geredet
heeissen	VB, RB, JJ	12	heißen, heiße, heißt
Seele	NN	12	Seele
la	NN, FW, NNP, JJ	12	la
ha	NN	12	ha
brauchen	VB, RB	11	brauchen, braucht
Dienste	NN	11	Dienste
wirst	WRB, RB, JJ	11	wirst
klein	JJ	11	klein, kleinen, kleines, kleine, kleiner
gehn	NN	11	gehn
fort	RP	11	fort
Ihrem	NN	11	Ihrem
geschwind	RB, IN, RP	11	geschwind
Ei	NN	11	Ei
bekommen	VB, VBN	11	bekommen
schön	JJ, NN	11	schön, schöne, schönes
Hause	NN	11	Hause
zurück	RB, IN, JJ, RP	11	zurück
Oheim	NN	10	Oheim
Geschwind	NN	10	Geschwind
andern	DT, JJ, NN	10	andern, andere
brav	JJ	10	braver, braves, braven, brav
Morgen	NN	10	Morgen
Bettler	NN	10	Bettler
spielen	VB, VBN	10	spielen
et	NN, FW	10	et
Sache	NN	10	Sache
Friede	NN, NNS	10	Friede, Frieden
Meine	PRP$	10	Meine
werfen	VB, VBN	10	werfen, geworfen, warf, wirft
nennen	VB	10	nennen, nenne
arm	JJ	10	armen, arm
seh	PRP$, JJ	10	seh, sehen
Namen	NN	10	Namen
Vater	NN, NNP	10	Vater
Leben	NN	10	Leben
Finger	NN	10	Finger
heraus	RP, JJ, RB	10	heraus
Frau	NNP, NN	10	Frau
stehen	VB, VBN	10	stehen, stehe, steht, standen, stand
setzen	VB	10	setzen, setzte, setzt
Augenblick	NN, NNP	9	Augenblick
Seite	NN	9	Seite
schreiben	VBN, VB, RP	9	geschrieben, schreiben, schreibt
best	NN, JJ	9	beste, besten
lieben	VB, NN	9	liebe, lieben
war	JJ, VB	9	war
muss	VB, RB	9	muß
Schuldner	NN	9	Schuldner
Wahrhaftig	JJ, RB	9	Wahrhaftig
Soen	RB, VBN	9	So
Kerl	NN, NNP	9	Kerl
lernen	VB, VBN	9	lernen, gelernt, lernt
König	DT, NN, FW	9	Könige, König
Alles	NN, JJ	9	Alles
einzig	JJ	9	einzige, einziger, einzig
meines	NN, JJ	9	meines
verlieren	VB, VBN	9	verliert, verloren, verlieren
Spass	NN	9	Spaß
lass	JJ, RB	9	laß
voll	JJ	9	voll, voller, vollen
einander	PRP	9	einander
Krieg	NNS, NN	9	Kriege, Krieg
wünschen	VB, VBN	9	wünschen, gewünscht, wünschte, wünscht, wünsche
freilich	RB, RP, JJ	9	freilich
Mensch	NN, NNP	9	Mensch
bien	NN, FW	8	bien
Polizei	NN	8	Polizei
wüsste	NN	8	wüßte
gehören	VB, RP, VBN	8	gehöret, gehört
Sehen	VB, NN	8	Sieht, Sehen, Seht
hoffen	VB	8	hoffen, hoffe
Madame	NN	8	Madame
los	RB, RP	8	los
liebste	NN, NNP	8	liebste
darum	RB	8	darum
komm	NN	8	komm
bloss	IN, RB, JJ	8	bloß, bloßer
Komm	NNP, NN	8	Komm
Hören	NN	8	Hören
Gott	NN	8	Gott
Minister	NN	8	Minister
weit	JJ	8	weit
un	NN	8	un
letzt	JJ, VB	8	letzten, letzter, letzte, letztem
entgegen	IN, RP, TO	8	entgegen
befehlen	VB	8	befohlen, befehlen
Dukaten	NN	8	Dukaten
ichs	NN	8	ichs
leben	VB	8	leben, lebt, lebten, lebe
Persien	NN	8	Persien
Wernern	NNP, NN, JJ	8	Wernern
ce	NN, NNP	8	ce
ins	IN	8	ins
Nachricht	NN, NNS	8	Nachricht, Nachrichten
Paul	NNP	7	Paul
drei	CD	7	drei
Indemen	RB	7	Indem
Gedanke	NN, NNS	7	Gedanke, Gedanken
Streich	JJ, NN	7	Streiche, Streich, Streiches
mache	NN	7	mache
Tag	NN	7	Tag
lange	RB, IN	7	lange
liebern	VB, NN	7	lieber
nimm	NN	7	nimm
schlecht	JJ	7	schlechte, schlechter, schlecht
Leute	NN	7	Leute
wert	RP, RB, JJ	7	wert
zwanzig	CD	7	zwanzig
Menschen	NN	7	Menschen
erinnern	VB	7	erinnerte, erinnern, erinnere
Türe	NN	7	Türe
damien	IN, VB, RB	7	damit
Recht	NN	7	Recht
Händen	NN	7	Händen
Gnädiges	NN	7	Gnädiges
abern	CC, RB, VB	7	aber
herein	RP, RB	7	herein
bin	VB, NN, JJ	7	bin
Nacht	NN	7	Nacht
indes	RB, CC	7	indes
sind	VB, RB	7	sind
fahren	RP, VB	7	gefahren, fahren, fuhr
Vielleicht	RP, RB	7	Vielleicht
erhalten	VB, VBN	7	erhalten, erhält
Lieber	NN	7	Lieber
sehe	PRP$	7	sehe
Geh	NN	7	Geh
sollst	RP, IN, RB, WRB	7	sollst
wem	WP	7	wem
zwei	CD	7	zwei
Thüringen	NNP	7	Thüringen
eins	CD	7	eins
brauche	NN	7	brauche
Verlust	NN	6	Verlust
neu	JJ	6	neue, neuen, neu
Heraklius	NN	6	Heraklius
ward	NNP	6	ward
weniger	RB, IN	6	weniger
gehabt	NN	6	gehabt
aufheben	VB, VBN, RP	6	aufheben, aufgehoben
Bedienten	NN	6	Bedienten
Schwester	NN	6	Schwester
hab	NN, JJ	6	hab
borgen	VB	6	geborgt, borgen
hat	RB	6	hat
läng	JJ	6	länger
Arm	NN, NNS	6	Arm, Arme
vielleicht	RB, IN, RP	6	vielleicht
Louisdor	NN	6	Louisdor
nochmals	RB, IN, RP	6	nochmals
gib	NN	6	gib
Eben	NN	6	Eben
Ihres	NN	6	Ihres
gestern	RB, IN	6	gestern
gnädig	NN, JJ	6	gnädige, gnädiges, gnädigen
behalten	VBN, VB	6	behalten, behalte
Kurz	NN	6	Kurz
sag	NN	6	sag
Männer	NN, NNP	6	Männer
Wohin	NN	6	Wohin
merken	VB, VBN	6	merke, merken, gemerkt, merkt
geh	NN	6	geh
übel	JJ	6	übel, üble
trinken	RB, VB	6	trinkt, trinken, tranken
grausam	JJ	6	grausam, grausame, grausamen
Mühe	NN	6	Mühe
ruhig	JJ	6	ruhig, ruhiger
lachen	VB	6	lachen, lache
zwingen	VB	6	zwingt, zwingen
Jungfer	NN	6	Jungfer
fällen	VBN, VB	6	gefällt, fällt
Krüppel	NN	6	Krüppel
Geheimnis	NNS, NN	6	Geheimnisse, Geheimnis
holen	VB, PRP$	6	holt, hole, holen
Marloff	NN	6	Marloff
Not	NN, FW	6	Not
Ende	NN	6	Ende
Justen	NN	6	Justen
morgen	RB, NNP, RP	6	morgen
Budel	NN	6	Budel
welchem	WP	6	welchem
Wolle	NNS	6	Wollen
versetzt	NN	6	versetzt
Rechnung	NN	6	Rechnung
bald	RB, WRB, RP	6	bald
Welch	NN, JJ	6	Welch, Welcher, Welches
Wünsch	NN, JJ	5	Wünsche
Jäger	NN, NNP	5	Jäger
Zweifel	NN	5	Zweifel
eigen	JJ	5	eigenen, eigenes, eigene
sahe	NN	5	sahe
laufen	VB, VBN	5	laufen, lief
wussen	VB	5	wußte
Vergnügen	NN	5	Vergnügen
annehmen	VB	5	annehmen, annimmt
bar	JJ	5	bar, bares
schämen	VB	5	schämen
unglücklicher	NN	5	unglücklicher
erkenne	NN	5	erkenne
fest	RP, JJ, RB	5	fest, festen
erzählen	VB	5	erzählen, erzählt
Stolz	NN, NNP	5	Stolz
Wechsel	NN	5	Wechsel
stecken	VB	5	steckt, stecken
Tränen	NN	5	Tränen
Ding	NN, NNP	5	Ding, Dinger
me	FW, NN, NNP	5	me
Lachen	NN	5	Lachen
unserm	PRP$	5	unserm
Gesellschaft	NN	5	Gesellschaft
Beutel	NN	5	Beutel
keines	NN	5	keines
en	PRP	5	en
kenn	NN	5	kenn
gehe	NN	5	gehe
verdienen	VB, VBN	5	verdient, verdienen
Weg	NN	5	Weg
verzeihen	VB, PRP$	5	verzeihen
Kann	NNP, NN	5	Kann
Jahr	NN	5	Jahr
Güte	NN	5	Güte
Erlauben	NN	5	Erlauben
tausend	CD	5	tausend
stark	JJ	5	stark
sodann	NNP	5	sodann
Wagen	NN, JJ	5	Wagen
Warte	NN	5	Warte
gibts	NN	5	gibts
richtig	JJ	5	richtig
Sohn	NN	5	Sohn
St	PRP$, NNP	5	St, St.
erlauben	VB	5	erlauben, erlaubt, erlaubet, erlaube
ernsthaft	JJ	5	ernsthafte, ernsthaften, ernsthaft
Mannes	NN	5	Mannes
jen	DT, NN	5	jenem, jenen, jen
kam	VB, JJ	5	kam
Hat	NN	5	Hat
Dank	RP, IN, TO	5	Dank
Tage	NN	5	Tage
brechen	VB, RP	5	brechen, gebrochen
Dienst	NN	5	Dienst, Dienste
erwarten	VB	5	erwarten, erwartet
gnädigen	JJ, NN	5	gnädigen
Dame	NNP, NN	5	Dame
Nehmen	VB	5	Nehmen
verkennen	VB, PRP$	5	verkennen
Himmel	NN	5	Himmel
früh	JJ	5	früh
Bruder	NN	5	Bruder
Grossen	NN	5	Großen
warten	VBN, VB, RB	5	warten
Gütern	NN	5	Gütern
wovon	WRB	5	wovon
Fräuleins	NN	5	Fräuleins
umsonst	IN, RB, RP	5	umsonst
verbinden	VB, VBN, RP	5	verbunden, verbinde
Stände	NN	5	Stände
weisen	PRP$, RB, VB, JJ	5	weisen, wies, weisend
ists	NN	5	ists
plaudern	VB	5	plaudern
betrügen	VB	5	betrügen
Stelle	NN	5	Stelle
ganzes	NN	5	ganzes
vier	CD	5	vier
gefallen	VB, VBN	5	gefallen
fremd	JJ	5	fremde, fremdes, fremd
wäre	VB, RB	5	wäre
Wahrheit	NN	5	Wahrheit
Stadt	NN, JJ	5	Stadt
wild	JJ, VB	5	wildes, wilde, wilden, wild
Kopf	NN	5	Kopf
Gewiss	UH	5	Gewiß
jung	VB, JJ	5	junge, jung, jungen
betteln	VB	4	betteln
schöne	NN	4	schöne
Eure	NN	4	Eure
voraus	IN, RP, JJ	4	voraus
versetzen	VB, VBN	4	versetzen, versetzt
Gr	NN	4	Gr
Wasser	NN	4	Wasser
Acht	NN	4	Acht
ma	NN, FW	4	ma
ers	NN	4	ers
étes	FW, NN	4	étes
niemand	RB, DT	4	niemand
Weise	NN	4	Weise
Hie	RB	4	Hier
deinen	NN, JJ	4	deinen
jammert	NN	4	jammert
darnach	RB	4	darnach
gefährlich	JJ	4	gefährlich
Schlüssel	NN	4	Schlüssel
Bedienter	NN	4	Bedienter
durchaus	RB	4	durchaus
Mitleid	NN	4	Mitleid
entschuldigen	VB, PRP$	4	entschuldigen
Bank	NN	4	Bank
Gewalt	NN	4	Gewalt
Seit	IN	4	Seit
Tochter	NN	4	Tochter
Mache	NN, NNP	4	Mache
Bin	NN	4	Bin
Freilich	JJ	4	Freilich
freuen	VB	4	freuen
rufen	VB	4	ruft, rief
achtzig	CD	4	achtzig
kennst	NN	4	kennst
mehren	VBN, VB	4	mehr
Grobian	NN, JJ	4	Grobian
weiss	VB	4	weiß
Art	NNP, NN, JJ	4	Art
lieset	NN	4	lieset
jamais	NN	4	jamais
Tat	NN	4	Tat
bring	JJ, FW	4	bringe, bring
unmöglich	JJ	4	unmöglich
su	NN	4	su
gelass	NN, JJ	4	gelaß, gelassen
blind	JJ	4	blinde, blinden, blind
ewig	JJ	4	ewig
sechs	CD	4	sechs
vollends	NN	4	vollends
aufsuchen	VB	4	aufsuchen
drum	RB, RP	4	drum
zugleich	RB, IN	4	zugleich
Unsere	PRP$	4	Unsere
meinigen	NN, JJ	4	meinigen
Chevalier	NN, FW	4	Chevalier
Kinder	NN	4	Kinder
suche	NN	4	suche
Sollte	NN	4	Sollte
Tellheims	NN	4	Tellheims
Spiel	NN	4	Spiel
unser	PRP$	4	unser
dienen	VB	4	dienen
müsste	VB	4	müßte
gewahr	NN	4	gewahr
Schatulle	NN	4	Schatulle
Verzeihung	NN	4	Verzeihung
treffen	VB, RP	4	treffen, getroffen, trifft
à	JJ, NN	4	à
Ton	NN	4	Ton
Fritz	NN	4	Fritz
Quartier	NN, NNS	4	Quartier, Quartiere
Gutes	NN, NNP	4	Gutes
ersparen	VB	4	ersparen
avec	NN, FW	4	avec
Wilhelm	NNP	4	Wilhelm
Umstand	NNS	4	Umstände
unserer	PRP$	4	unserer
Freude	NN, NNP	4	Freude
Notwendigkeit	NN	4	Notwendigkeit
sei	JJ, VB, RB	4	sei
Auge	NN	4	Auge
Fingern	NN	4	Fingern
verlassen	VB	4	verlassen
verdiene	NN	4	verdiene
unsrer	PRP$	4	unsrer
vermutet	NN	4	vermutet
gnädiger	NNP	4	gnädiger
Lass	NN	4	Laß
Vernunft	NN	4	Vernunft
Kutscher	NN	4	Kutscher
verkaufen	VB	4	verkauft, verkaufen
Treppe	JJ, NN	4	Treppe
Gesicht	NN	4	Gesicht
schaffen	VB, RP	4	schaffen, schafft, geschaffen
Majors	NN, JJ	4	Majors
Herren	NN	4	Herren
leicht	JJ	4	leicht
Kamerad	NN	4	Kamerad
Hände	NN	4	Hände
lang	JJ	4	langer, lang
geschehen	RP, VBN	4	geschehen
lügen	VBN, VB	4	gelogen, lügen
reich	JJ	4	reicher, reich
wenigstens	IN, RB, WRB	4	wenigstens
les	NNP, FW, NN	4	les
erklären	VB	4	erklären, erklärte
Reitknecht	NN	4	Reitknecht
sik	NN	4	sik
Türken	NN	4	Türken
verlangen	VB	4	verlangen, verlangt
zehn	CD	4	zehn
Riccaut	FW, NN	4	Riccaut
verabschieden	VB, VBN	4	verabschiedete, verabschiedet
Meinig	DT	4	Meinige
hässlich	JJ	4	häßlich, häßlichen
ehe	CC	4	ehe
Paar	NN, JJ	4	Paar
jemand	DT	4	jemand
Sonne	NN	4	Sonne
Pf	NN	4	Pf
Anteil	NN	4	Anteil
Treue	NN	4	Treue
oft	RB, RP	4	oft
wen	WP	4	wen
besehen	NN	4	besehen
Ohr	NN	4	Ohr
Willen	NN	4	Willen
langen	VBN	4	lang, lange
weder	CC	4	weder
Diener	NNP, NN	4	Diener
treten	VB	4	tritt, treten
Haus	NN	4	Haus
notwendig	JJ	4	notwendig
würde	RB	3	würde
ausfahren	NN, NNP	3	ausfahren
jemals	RB, RP	3	jemals
träumen	VB, RP	3	träumen, geträumt
Misstrauen	NN	3	Mißtrauen
Miene	NN	3	Miene
toll	JJ	3	toll
mes	FW, NN	3	mes
Damen	NN	3	Damen
putzen	VB, VBN	3	putzen, geputzt
Königlich	JJ	3	Königlichen, Königliches, Königliche
reichen	VB, JJ	3	reicht, reichte
welch	WP, WDT	3	welches, welche
hieren	VB, VBN, RB	3	hier
Dinge	NN	3	Dinge
warm	JJ	3	warm
sterben	VB	3	sterbe, sterben
Himmels	NN	3	Himmels
Excellence	NNP, NN	3	Excellence
wenden	VB	3	wendet, wendend
trefflich	JJ	3	trefflich, trefflichen
Monat	NN	3	Monat
amis	FW	3	amis
Läufer	NN	3	Läufer
tragen	VB	3	tragen, trägt
Muss	NN	3	Muß
Verzeihen	NN	3	Verzeihen
daraufen	VB	3	darauf
iss	NN	3	iß
Strasse	NN	3	Straße
Schreibepulte	NN	3	Schreibepulte
Mohr	NN	3	Mohr
Herzens	NN	3	Herzens
Woher	NN	3	Woher
galant	JJ	3	galant
besuchen	VB	3	besuchte, besuchen
befiehlt	NN	3	befiehlt
Reisen	NN	3	Reisen
christlich	JJ	3	christlich, christlicher
aufzuheben	NN	3	aufzuheben
fait	NNP, NN	3	fait
Kammerfrau	NN	3	Kammerfrau
Tasse	NN	3	Tasse
enthalten	VB	3	enthält
genauer	RP, IN	3	genauer
Verachtung	JJ, NN	3	Verachtung
une	NN, FW	3	une
Cest	NN	3	Cest
Schweig	JJ	3	Schweig
seines	PRP$	3	seines
legen	VB, VBN	3	legen, gelegt
dächte	NN	3	dächte
bonne	FW	3	bonne
kalt	JJ, VB	3	kalt, kalte
gewinnen	VB, VBN, RP	3	gewinnen, gewonnen
sitzen	VB	3	sitzen
niemals	RB	3	niemals
Briefch	JJ	3	Briefchen
Sieh	NN	3	Sieh
jaten	RP, VB, RB	3	ja
Zärtlichkeit	NN	3	Zärtlichkeit
He	NN	3	He
vertraulich	JJ	3	vertraulichen, vertrauliche, vertraulich
Graf	NN	3	Graf
hübsch	JJ	3	hübsch, hübsche
Schulden	NN	3	Schulden
nunen	VBN, VB, RB	3	nun
woher	RP, WRB	3	woher
dacht	VB, RB, JJ	3	dachte, dacht
nichtswürdige	NN	3	nichtswürdige
ne	NNP, NN	3	ne
nu	UH	3	nu
Erniedrigung	NN	3	Erniedrigung
hierzu	NN	3	hierzu
verliebt	JJ	3	verliebt, verliebten
ansehen	VB	3	ansieht, angesehen
fassen	VB	3	faßt, fassen
übergeben	RP, VB	3	übergeben
versuchen	VB	3	versuchen
Summe	NN	3	Summe
verbergen	VB	3	verbergen
liebte	NN	3	liebte
unsers	PRP$	3	unsers
Roi	NNP, NN	3	Roi
Handschrift	JJ, NN	3	Handschrift
unsern	PRP$	3	unsern
gewohnt	JJ	3	gewohnt
mag	VB, RB	3	mag
Martin	NNP	3	Martin
ungern	NN	3	ungern
kurz	JJ	3	kurz
davonen	VB, RB	3	davon
Verleumder	NN	3	Verleumder
Rechnungen	NN	3	Rechnungen
halb	JJ, CD	3	halben, halb
erweisen	VBN	3	erwiesen
Gerechtigkeit	NN	3	Gerechtigkeit
ei	RP	3	ei
Verräter	NN	3	Verräter
Sachen	NN	3	Sachen
hätte	RB	3	hätte
dünkt	NN	3	dünkt
beklage	NN	3	beklage
schlagen	PRP$, VB	3	schlagen, schlug
Gattin	NN	3	Gattin
fordern	VB	3	gefordert, fordern
anzunehmen	VB	3	anzunehmen
Name	NN, JJ	3	Name
Unser	PRP$, JJ	3	Unser, Unserer
Wem	NN	3	Wem
Diensten	NN	3	Diensten
Danziger	NNP	3	Danziger
erwacht	NN	3	erwacht
Krieges	NNP, NN	3	Krieges
tout	NNP, JJ, NN	3	tout, toute
Darum	RB	3	Darum
herum	IN	3	herum
sogleich	RB	3	sogleich
Bettel	NN	3	Bettel
pas	NNP, NN	3	pas
Il	NN	3	Il
darübern	VB, RB	3	darüber
glücklicher	NN	3	glücklicher
Ergreift	NN	3	Ergreift
moi	NN, FW	3	moi
anzustecken	VB	3	anzustecken
schonen	RB, VB	3	schon
hör	NN	3	hör
Eurer	NN	3	Eurer
schicken	VBN, RP, VB	3	geschickt, schicken
jagen	VB	3	jagen, jagt
fragen	VB	3	fragen, fragt
dabeien	VB	3	dabei
essen	VB	3	essen
Nu	NN	3	Nu
Küche	NN	3	Küche
schönen	PRP$, VB	3	schönen
Grafen	NN	3	Grafen
vors	NN	3	vors
au	NNP, NN	3	au
sagst	NN	3	sagst
Erst	IN, RB	3	Erst
Winter	NN	3	Winter
alt	JJ	3	alter, alten, alt
tu	NN	3	tu
wohin	RB, WRB	3	wohin
entschloss	JJ	3	entschlossen
räumen	VBN, VB	3	geräumt, räumen
Liebhaber	NN	3	Liebhaber
zweimal	RB, RP	3	zweimal
Bekanntschaft	NN	3	Bekanntschaft
lustig	JJ, VB	3	lustig, lustige
Verdienst	NN	3	Verdienst
besitzen	VB	3	besitzen
Pfui	NN	3	Pfui
Marliniere	FW	3	Marliniere
schlechten	NN	3	schlechten
mirs	NN	3	mirs
ohngeachtet	NN	3	ohngeachtet
herab	NN	3	herab
zweitausend	CD	3	zweitausend
a	PRP	3	a
willkomm	JJ	3	willkommen
Armen	NN	3	Armen
22	CD, JJ	3	22, 22.
verdiente	NN	3	verdiente
Zeugnis	NN	3	Zeugnis
nimmermehr	NN	3	nimmermehr
Dingen	NN	3	Dingen
7	CD	3	7
manch	DT	3	manchen, manches, manche
irren	VB	3	irren, irrt
überall	IN, RB, RP	3	überall
Ursache	NN	3	Ursache
Galle	NN	3	Galle
Gleichheit	NN	3	Gleichheit
logier	NN	3	logier
selb	DT	3	selber
Nit	NN	3	Nit
kostbar	JJ	3	kostbaren, kostbarer
antworen	VB	3	antworten
brauch	NN	3	brauch
Titel	NN, JJ	3	Titel
Hell	JJ	3	Heller
Landsmänninnen	NN	3	Landsmänninnen
schuldigen	VBN	3	schuldig
empfangen	VB	3	empfangen
finde	NN	3	finde
Sünde	NN	3	Sünde
erraten	NN	3	erraten
recht	RB, JJ, NN	3	recht, rechter
9	CD	3	9
andermal	RB, IN, RP	3	andermal
Son	NNP, NN	3	Son
Band	NN	3	Band
danke	RP, IN	3	danke
steif	JJ	3	steif, steife
Zufall	NN	3	Zufall
bös	JJ, VB	3	böse, böser
hinter	IN	3	hinter
Interessen	NN	3	Interessen
Tagen	NN	3	Tagen
Exzellenz	NN, NNP	3	Exzellenz
Comment	NN	3	Comment
Ordre	NN, NNP	3	Ordre
suis	FW, NN	3	suis
willen	IN	3	willen
entgelten	NN	3	entgelten
Rekruten	NN	3	Rekruten
Siehst	NN	3	Siehst
wohnen	VBN, VB	3	gewohnt, wohnen
Stimme	NN	3	Stimme
Eitelkeit	NN	3	Eitelkeit
bedürfen	VB	3	bedarf, bedürfen
gehts	NN	3	gehts
Wohl	IN, RB, RP	3	Wohl
wenigst	JJ	3	wenigsten
Land	NN	3	Land
entsagen	VB, VBN	3	entsagen, entsagt
Sprak	NN	3	Sprak
danken	VB, PRP$	3	danken
Philipp	NNP, NN	3	Philipp
Verstand	NN	3	Verstand
nochen	VBN, VB	3	noch
Kaffee	NN	3	Kaffee
Woche	NN	3	Woche
Kompliment	NN	3	Kompliment
Prinz	NN	3	Prinz
gutes	NN	3	gutes
fluchen	VB	3	fluchen
bekennen	VBN, VB	3	bekannt, bekenne, bekennen
zeigend	JJ	3	zeigend
qui	NN	3	qui
Abschied	JJ, NN	3	Abschied
gedenken	VB, VBN, RP	3	gedenken, gedacht
folge	NN	3	folge
heisst	VB, JJ	3	heißt
Rede	NN	3	Rede
vorhin	IN	3	vorhin
Ernst	NNP	3	Ernst
denk	NN	3	denk
Franzose	NNS, NN	3	Franzosen, Franzose
etwa	RB, RP	3	etwa
fünfhundert	CD	3	fünfhundert
überlegen	VB	3	überlegen
Rolle	JJ, NN	3	Rolle
trage	NN	3	trage
Oheims	NN	3	Oheims
selten	RB, IN, RP	3	selten
Wut	NN	3	Wut
Wirts	NN	3	Wirts
Gelegenheit	NN	3	Gelegenheit
vierhundert	CD	3	vierhundert
voilà	FW, NNP	3	voilà
Maul	NN	3	Maul
erkennen	VBN, VB	3	erkannt, erkennen
Meilen	NN	3	Meilen
erbrechen	VBN, VB	3	erbrochen, erbrechen
Vorsicht	NN	3	Vorsicht
wiss	NN	3	wiß
erfahren	VB, RP	3	erfuhr, erfahren
Stunden	NN	3	Stunden
Ihrigen	NN	3	Ihrigen
Kriegszahlmeister	NN	3	Kriegszahlmeister
Ehe	JJ, NN	2	Eher, Ehe
auk	JJ, NN	2	auk
draus	NN	2	draus
Saale	NNP	2	Saale
Wichtigst	JJ	2	Wichtigste
Regiment	NN	2	Regiment
Schritte	NN	2	Schritte
Unglücks	NN	2	Unglücks
mutwillig	JJ	2	mutwillig
ungefähr	RB, RP	2	ungefähr
aufpassten	NN	2	aufpaßten
kaum	IN, RB	2	kaum
Lieutenant	NN	2	Lieutenant
Stab	NN	2	Stab
gewaltig	JJ	2	gewaltig
spät	JJ	2	spät, späte
Platz	NN	2	Platz
Lebensart	NNP	2	Lebensart
il	NNP, NN	2	il
Gegenstand	NN	2	Gegenstand
hoh	JJ	2	hohen
Neugierde	NN	2	Neugierde
verächtlichen	VBN	2	verächtlich
versprechen	VB	2	versprachen, versprechen
Stunde	NN	2	Stunde
Verbindung	NN	2	Verbindung
Frage	NN	2	Frage
Weiss	NN	2	Weiß
Blut	NN	2	Blut
neunzig	CD	2	neunzig
Parbleu	NN	2	Parbleu
teilen	VB	2	teilen
Bande	NN	2	Bande
deinem	NN	2	deinem
plötzlich	JJ	2	plötzlich
kalten	VBN, VB	2	kalt, kalte
geweissen	VB	2	gewiß
Wirtshäuser	NN	2	Wirtshäuser
klingen	VB	2	klingt
Dero	NN	2	Dero
zerriss	JJ	2	zerrissen
verleiten	VB	2	verleiten
frei	JJ	2	frei
reisen	VB	2	reisen
wahrhaftig	JJ	2	wahrhaftig
begleiten	VB	2	begleiten
Beste	NN	2	Beste
Parade	NN	2	Parade
dahin	RP, RB	2	dahin
Ernste	NN	2	Ernste
Gleichwohl	RP	2	Gleichwohl
Pistol	NN	2	Pistol
Eilends	NN	2	Eilends
Morgenlande	NN	2	Morgenlande
deutsch	JJ	2	deutsch
tot	JJ	2	tot
Närrin	NN	2	Närrin
tod	NN	2	tod
tue	NN	2	tue
nahe	IN, RP	2	nahe
bedanken	VB	2	bedanken
gesprenkt	NN	2	gesprenkt
leihen	VB	2	leihen
Holla	NN	2	Holla
Reisst	WRB	2	Reißt
Falsch	NNP, NN	2	Falsch
Equipage	NN	2	Equipage
balden	VBN, VB	2	bald
zurückgegeben	NN	2	zurückgegeben
speisen	VB	2	speisen
karrt	NN	2	karrt
Macht	NN	2	Macht
Weile	NN	2	Weile
Jahre	NN	2	Jahre
sieh	NN	2	sieh
Beziehung	NN	2	Beziehung
Nimmermehr	FW, NN	2	Nimmermehr
vielmehr	RB, RP	2	vielmehr
Spotte	NN	2	Spotte
Schlägen	NN	2	Schlägen
sais	NN	2	sais
behelfen	NN	2	behelfen
Bestie	NN	2	Bestie
Husch	NN	2	Husch
Brust	NN	2	Brust
Wendung	NN	2	Wendung
daranen	VB, RB	2	daran
Unglücke	NN	2	Unglücke
Unglücklicher	NN	2	Unglücklicher
Grund	NN	2	Grund
mehrer	VB, JJ	2	mehrere
Geschöpf	NN	2	Geschöpf
stehlen	VB, VBN	2	stehlen, gestohlen
Hälfte	NN	2	Hälfte
pocht	NN	2	pocht
Genugtuung	NN, JJ	2	Genugtuung
Sieg	NN	2	Sieg
hättest	WRB, RP	2	hättest
nöten	NN	2	nöten
entbehrlich	JJ	2	entbehrlich
Gesundheit	NN	2	Gesundheit
angekommen	NN	2	angekommen
Beweis	NN	2	Beweis
besen	NN, VB	2	besten
verdienter	NN	2	verdienter
einlösen	NN	2	einlösen
sagten	NN	2	sagten
Blicke	NN	2	Blicke
Tugend	NN	2	Tugend
Wink	NN	2	Wink
hierher	RP	2	hierher
Freuden	NN	2	Freuden
Verschwender	NN	2	Verschwender
ums	IN	2	ums
Punkt	NN	2	Punkt
hundertmal	RB	2	hundertmal
Gütch	JJ	2	Gütchen
ihrigen	PRP$	2	ihrigen
urgieren	VBN, NN	2	urgieret, urgieren
plus	RB, CC	2	plus
gutherzigen	NN	2	gutherzigen
Schwelle	NN	2	Schwelle
unterm	NN	2	unterm
blöde	NN	2	blöde
unentbehrlich	JJ	2	unentbehrlich
très	TRUNC	2	très-
nunmehr	RP	2	nunmehr
Tone	NN	2	Tone
lösen	VB	2	löse, lösen
Feldzug	NNS, NN	2	Feldzüge, Feldzug
schönsten	NN	2	schönsten
Gleichfalls	RP, RB	2	Gleichfalls
Freundin	NN	2	Freundin
niedergeschlagen	NN	2	niedergeschlagen
doute	NN	2	doute
reicht	VB	2	reicht
vollkommenste	NN	2	vollkommenste
ersetzen	VB	2	ersetzen
coeur	NN	2	coeur
trennen	VB	2	trennen
Weisen	NN	2	Weisen
Juen	NN	2	Just
Aussicht	NN	2	Aussicht
macht	VB	2	macht
quälen	VB	2	quälen
Verdiensten	NN	2	Verdiensten
Grossmut	NN	2	Großmut
äussersten	NN	2	äußersten
wenns	NN	2	wenns
Angelegenheiten	NN	2	Angelegenheiten
dit	NN, NNP	2	dit
übrige	JJ, NN	2	übrige
Vermögen	NN	2	Vermögen
schrecklich	JJ	2	schreckliche, schreckliches
besetzen	RP, VBN	2	besetzt
Appetit	NN	2	Appetit
ziemen	VB	2	ziemt
geteilet	NN	2	geteilet
Absicht	NN	2	Absicht
Summa	NN	2	Summa
vorsichtig	JJ	2	vorsichtig
bange	NN	2	bange
Verlangen	NN	2	Verlangen
kanns	NN	2	kanns
weigern	VB	2	weigert, weigern
bleibe	NN	2	bleibe
garstiger	NNP, NN	2	garstiger
mitbringen	VB	2	mitbringt, mitbringen
Bilden	NN	2	Bilden
würdigen	PRP$	2	würdigen
würdiger	NN, NNP	2	würdiger
Sage	NN	2	Sage
Fremden	NN	2	Fremden
Leuten	NN	2	Leuten
umarmen	VB	2	umarmen
schlimm	JJ	2	schlimm
Verdacht	NN	2	Verdacht
beschliessen	VBN	2	beschlossen
st	PRP$	2	st
abgedankt	NN	2	abgedankt
nous	FW	2	nous
trunken	NN	2	trunken
woran	WDT	2	woran
fasen	VB	2	fast
still	JJ	2	stille, still
mais	NN	2	mais
Galgen	NN	2	Galgen
verdrängen	VBN	2	verdrängt
wiedergeben	VB	2	wiedergeben
non	FW, NN	2	non
Begreifen	VB	2	Begriffe
nok	NN	2	nok
verliess	NN	2	verließ
Mittag	NN	2	Mittag
Rittmeisterin	JJ, NN	2	Rittmeisterin
Capitaine	NNP, NN	2	Capitaine
Tlr	NN	2	Tlr
siehst	NN	2	siehst
ähnlich	JJ	2	ähnlich
Ihrige	NN	2	Ihrige
Feuer	NN	2	Feuer
zurückgenommen	NN	2	zurückgenommen
zugehend	JJ	2	zugehend
Elend	NN	2	Elend
erwartet	JJ	2	erwartete, erwartet
and	JJ	2	ander
Mais	FW, NN	2	Mais
traurig	JJ	2	traurige, traurig
vornehm	JJ, VB	2	vornehm, vornehme
Bein	NNS	2	Beine
fertig	JJ	2	fertig
zutrauen	NN	2	zutrauen
Munde	NN	2	Munde
gekannt	NN	2	gekannt
Dreiteil	NN	2	Dreiteil
Geduld	NN	2	Geduld
Ringes	NN	2	Ringes
Könik	NN	2	Könik
betrachten	VB, RP	2	betrachte, betrachtet
Fenster	NN	2	Fenster
Bewegung	NN	2	Bewegung
verlegen	VB	2	verlegt, verlegen
kosen	VB	2	kosten
ehemalig	JJ	2	ehemaligen
Röllchen	VB	2	Röllchen
beschwöre	NN	2	beschwöre
Frauenzimmer	NN	2	Frauenzimmer
brauchst	NN	2	brauchst
auszuräumen	NN	2	auszuräumen
Wohltaten	NN	2	Wohltaten
wiedergefunden	NN	2	wiedergefunden
verdrüsslich	JJ	2	verdrüßlich
erkundigen	VB	2	erkundigen
fremden	PRP$	2	fremden
schreien	VB	2	schrie, schreien
einräumen	VB	2	einräumen, eingeräumt
verzeih	NN, NNP	2	verzeih
versichere	NN	2	versichere
Tapferkeit	NN	2	Tapferkeit
weggeritten	RP, NN	2	weggeritten
Hätte	NN	2	Hätte
Verzeih	NN	2	Verzeih
Grobheit	NN	2	Grobheit
eitel	JJ	2	eitel
Mäuler	NN	2	Mäuler
Stich	NN, NNS	2	Stich, Stiche
andrer	NN	2	andrer
dergleichen	PRP	2	dergleichen
Unmöglich	JJ	2	Unmöglich
Jammert	NN	2	Jammert
Glücke	NN	2	Glücke
ergriff	NN	2	ergriff
lüderlich	JJ	2	lüderliches, lüderliche
Höflichkeit	NN	2	Höflichkeit
Befehl	NNS, NN	2	Befehle, Befehl
schickt	NN	2	schickt
Abends	NN	2	Abends
Nochen	RB, VBN	2	Noch
darf	RB, VB	2	darf
tüchtiger	NN	2	tüchtiger
fortune	FW, NNP	2	fortune
höh	JJ	2	höher
Engel	NN	2	Engel
Handschreiben	VB	2	Handschreiben
vergeben	VB, RP	2	vergeben
nötig	JJ	2	nötig
verzehren	VB	2	verzehren
ausreden	NN	2	ausreden
öfters	RB	2	öfters
helfen	VB	2	helfen
dran	RP	2	dran
geringst	JJ	2	geringste
heucheln	VB	2	heucheln
starr	JJ	2	starr
täglich	RB	2	täglich
Ungetreue	NN	2	Ungetreue
Tropfen	NN	2	Tropfen
Beutelch	VB, JJ	2	Beutelchen
Verrichtungen	NNP, NN	2	Verrichtungen
Wissen	NN	2	Wissen
Überlegung	NN	2	Überlegung
zanken	NN	2	zanken
Offizieren	NN	2	Offizieren
Darf	NN	2	Darf
wackern	NN, JJ	2	wackern
Pfennig	NN	2	Pfennig
Donnés	NN, TRUNC	2	Donnés, Donnés-
Schlosse	NN	2	Schlosse
einzigesmal	NN	2	einzigesmal
verstehst	NN	2	verstehst
empfindlich	VB, JJ	2	empfindlicher, empfindlich
tilgen	NN, VBN	2	tilgen, getilgt
Habe	NN	2	Habe
hinein	RP	2	hinein
breit	JJ	2	breite
sans	PRP$	2	sans
Reise	NN	2	Reise
heiss	JJ	2	heiß
enden	VB	2	enden
unterstehen	NN	2	unterstehen
Freundes	NN	2	Freundes
nenn	JJ, NN	2	nennen, nenn
heben	VB	2	hebt, hebe
kriegen	VB, RP	2	kriegt, gekriegt
Barmherzigkeit	NN	2	Barmherzigkeit
schwarz	JJ	2	schwarz
Bezahlung	NN	2	Bezahlung
aufs	NN	2	aufs
Tod	NN	2	Tod
Teufel	NN	2	Teufel
Sr	NN	2	Sr
Grillen	NN	2	Grillen
antworte	NN	2	antworte
halte	NN	2	halte
klagen	VB, VBN	2	klagen, geklagt
Bahn	NN	2	Bahn
Gegenwart	NN	2	Gegenwart
Schwemme	NN	2	Schwemme
Augenblicke	NN	2	Augenblicke
zerreeissen	VB	2	zerreißen
Füssen	NNP	2	Füßen
Bst	RB	2	Bst
erinnert	NN	2	erinnert
untertänigen	NN	2	untertänigen
dreimal	RB	2	dreimal
kaufen	VB, VBN	2	kaufe, gekauft
Armes	NN	2	Armes
ergreift	NN	2	ergreift
wohnt	NN	2	wohnt
Alter	NN	2	Alter
alle	RB	2	alle
Hast	NN	2	Hast
Guten	NN	2	Guten
fünf	CD	2	fünf
Vorsatze	NN	2	Vorsatze
Missverständnis	NN	2	Mißverständnis
endlich	RB	2	endlich
Nachts	NN	2	Nachts
spalten	VB	2	spalten
Witwe	NN	2	Witwe
dire	NN	2	dire
blieb	NN	2	blieb
versteh	NN	2	versteh
Merkst	NN	2	Merkst
Henker	NN	2	Henker
fallen	VB	2	fallen
dont	NN	2	dont
wagen	VB	2	wagen
warte	NN	2	warte
unriktig	JJ	2	unriktig
Dämmerung	NN	2	Dämmerung
äusserst	NN	2	äußerste
frisieren	VB	2	frisieren
Hatte	NN	2	Hatte
Ansprüche	NN	2	Ansprüche
jeu	NN	2	jeu
weisst	NN	2	weißt
Reicht	NN	2	Reicht
Groll	NN	2	Groll
Gefährlichkeit	NN	2	Gefährlichkeit
freue	NN	2	freue
Tisch	NN	2	Tisch
stehn	NN	2	stehn
Vergebung	NN	2	Vergebung
reise	NN	2	reise
ungehalten	NN	2	ungehalten
Affaire	NN	2	Affaire
gestehen	VB	2	gestehen, gestanden
schlafen	VB	2	schlafen
Viertelstündchen	VB, JJ	2	Viertelstündchen
Wege	NN	2	Wege
empfinde	NN	2	empfinde
edlen	JJ, NN	2	edlen
herumlaufen	NN	2	herumlaufen
gesunden	PRP$	2	gesunden
Stande	NN	2	Stande
frisch	JJ	2	frisches, frisch
verstossen	VB	2	verstoßen
mieux	NNP	2	mieux
schüchtern	JJ	2	schüchtern
ses	PRP$	2	ses
Sorge	NN	2	Sorge
eignen	VB, RB	2	eignen
Eigenliebe	NN	2	Eigenliebe
Geschlechts	NNP, NN	2	Geschlechts
manchmal	RP, RB	2	manchmal
auchen	VB, VBN	2	auch
fähig	JJ	2	fähig
Summarum	NN	2	Summarum
klug	JJ	2	klug
immern	RB, VB	2	immer
abgedankter	NN	2	abgedankter
abgedankten	NN	2	abgedankten
Willig	JJ	2	Willig
feinste	NN	2	feinste
wiedersagen	NN	2	wiedersagen
Freundschaft	NN	2	Freundschaft
Schlimmste	NN	2	Schlimmste
Spieler	NN	2	Spieler
gab	VB	2	gab
Wochen	NN	2	Wochen
steh	NN	2	steh
Natur	NN	2	Natur
beleidigen	VB	2	beleidigen
beleidiget	NN	2	beleidiget
fortgehen	NN	2	fortgehen
Bitterkeit	NN	2	Bitterkeit
fühlen	VB	2	fühle
Kammerdiener	NNP	2	Kammerdiener
unendlich	JJ	2	unendlich
künftig	JJ	2	künftige
Bissch	JJ	2	Bißchen
Türen	NN	2	Türen
vollziehen	VB, RP	2	vollziehen, vollzogen
Gebrauch	NN	2	Gebrauch
verändern	RP, VBN	2	verändert
angelangen	VB	2	angelangt
exakt	JJ	2	exakt
vermute	NN	2	vermute
allzu	RB	2	allzu
Ohren	NN	2	Ohren
rien	NNP, NN	2	rien
weis	NN, JJ	2	weis, weise
Ist	VB	2	Ist
funfzig	JJ	2	funfzig
Behalte	NN	2	Behalte
Schicksal	NN	2	Schicksal
vierzehn	CD	2	vierzehn
Feind	NN	2	Feind
unfehlbar	JJ	2	unfehlbar
Gemahl	NN	2	Gemahl
mächtig	JJ	2	mächtig
abbringen	NN	2	abbringen
Schurke	NN	2	Schurke
Unglücklich	JJ	2	Unglückliche, Unglücklichen
versicherte	NN	2	versicherte
Abwesenheit	NN	2	Abwesenheit
Vormund	NN	2	Vormund
aufgeopfert	NN	2	aufgeopfert
Anmerkung	NN	2	Anmerkung
belohnen	VB	2	belohnen
Gib	NNP	2	Gib
höflicher	NN	2	höflicher
Staaten-General	NN	2	Staaten-General
Familie	NN	2	Familie
Weib	NN	2	Weib
Ruhe	NN	2	Ruhe
Fassen	NN	2	Fassen
verdanken	VB	2	verdanken
unterwegens	NN	2	unterwegens
wiedern	VB, VBN	2	wieder
Jagd	NN	2	Jagd
Bedenken	NN	2	Bedenken
cela	NN, FW	2	cela
kannst	RB, JJ	2	kannst
bereuen	VB	2	bereuen
Szene	NN	2	Szene
neigen	VBN	2	geneigt
pour	NNP, NN	2	pour
Ziemen	RB, VB	2	Ziemt, Ziemte
Zahn	NNS	2	Zähne
zwischen	IN	2	zwischen
empfehlen	VB	2	empfehlen, empfiehlt
dafüren	VB	2	dafür
Gibt	NNP	2	Gibt
hindern	VB	2	hindern
überzeugen	VBN, VB	2	überzeugt, überzeugen
wette	NN	2	wette
darumen	RB, VB	2	darum
Budeln	NN	2	Budeln
Erfüllung	NN	2	Erfüllung
Freilichen	VBN	2	Freilich
Bruchsall	NN	2	Bruchsall
öffnen	VB	2	öffnet
spöttisch	JJ	2	spöttischen, spöttisch
Prinze	NNS	2	Prinzen
gesund	JJ	2	gesund
Vaterland	NN	2	Vaterland
Schuss	NN	2	Schuß
Vortrefflich	JJ	2	Vortreffliches, Vortrefflich
Allein	NN	2	Allein
fröhlich	JJ	2	fröhlich, fröhliches
Hör	NN	2	Hör
besinne	NN	2	besinne
schämet	NN	2	schämet
Gefahr	NN	2	Gefahr
Respekt	NN	2	Respekt
bitte	VB	2	bitte
suchte	NN	2	suchte
Strenge	NN	2	Strenge
schimpflich	JJ	2	schimpflich, schimpflichen
erwähnen	VB	2	erwähnen
anzeigen	VB	2	anzeigen, anzeigend
gekränkt	NN	2	gekränkt
Irrtume	NN	2	Irrtume
verpflichten	RP, VB	2	verpflichtet
faut	NN	2	faut
lässt	RB, VB	2	läßt
dumm	JJ	2	dumme
Zuflucht	NN	2	Zuflucht
Genug	NN	2	Genug
Mode	NN	2	Mode
Anblick	NN, NNS	2	Anblick, Anblicke
Monate	NN	2	Monate
schein	JJ	2	scheinen
verlor	JJ	2	verloren
prophezeie	NN	2	prophezeie
begehen	VB	2	begehen
zeigen	VB	2	gezeigt, zeigen
bessern	VBN, PRP$	2	besser, bessern
neben	IN	2	neben
wird	RB	2	wird
dochen	VB, VBN	2	doch
sehn	NNP, NN	2	sehn
möchte	VB	2	möchte
Hofstaatskasse	NNP	2	Hofstaatskasse
Höre	NN	2	Höre
Spitzbuben	NN	2	Spitzbuben
streitig	JJ	2	streitig
wills	RB	2	wills
scherzen	VB	2	scherzen
Geb	NN	2	Geb
näh	JJ	2	näher
Verwirrung	NN	2	Verwirrung
hierauf	NN	2	hierauf
Konnte	NN	2	Konnte
greifen	VB	2	griff, greift
sprek	NN	2	sprek
Kaffeehause	NN	2	Kaffeehause
Tasche	NN	2	Tasche
schriftlich	JJ	2	schriftlich
weg	RP, RB	2	weg
gutt	NN	2	gutt
Esse	NNS	2	Essen
liebt	NN	2	liebt
Lebens	NN	2	Lebens
est	FW, NNP	2	est
Monsieur	NN	2	Monsieur
Biss	JJ, NN	2	Bissen, Biß
oben	IN, RB	2	oben
allhier	NN, NNP	2	allhier
geringsten	NN	2	geringsten
anschreiben	VB	2	anschreiben
Bald	NN	2	Bald
ehemals	RB	2	ehemals
übrig	JJ	2	übrig
auszusetzen	NN	2	auszusetzen
hängen	VBN, VB	2	gehangen, hing
Vertrauen	NN	2	Vertrauen
Tee	NN	2	Tee
nuren	VB	2	nur
sehren	VB	2	sehr
ärgerlich	JJ	2	ärgerlich
beisammen	NN	2	beisammen
Schuld	NN	2	Schuld
packe	NN	2	packe
alleinen	RP, VB	2	allein
Verstande	NN	2	Verstande
vortrefflich	JJ	2	vortreffliche, vortrefflich
hereingezogen	NN	1	hereingezogen
Säue	NN	1	Säue
wären	VB	1	wären
Zurückkunft	NN	1	Zurückkunft
besorge	NN	1	besorge
veut	NN	1	veut
steigen	VB	1	stieg
parlieren	VB	1	parlieren
surpasse	NNP	1	surpasse
wohlfeilste	NN	1	wohlfeilste
wahrlich	JJ	1	wahrlich
reissen	VB	1	riß
könnt	JJ	1	könnte
Kleid	NN	1	Kleid
Sprache	NN	1	Sprache
Hierher	NN	1	Hierher
gedienet	NN	1	gedienet
Charakter	NN	1	Charakter
Künst	JJ	1	Künste
hats	NN	1	hats
Frauenszeug	NN	1	Frauenszeug
träumt	NN	1	träumt
Grenze	NN	1	Grenze
Hieb	FW	1	Hieb
gestoss	VBN	1	gestoßen
zerstreuet	NN	1	zerstreuet
Farbe	NN	1	Farbe
träume	NN	1	träume
Eselsgehirn	NN	1	Eselsgehirn
pflegen	VB	1	pflegt
Denkungsart	NNP	1	Denkungsart
Überall	NN	1	Überall
nied	JJ	1	nieder
Schatten	NN	1	Schatten
üble	NN	1	üble
Lese	NNS	1	Lesen
täte	NN	1	täte
Rachen	NN	1	Rachen
Vorfall	NN	1	Vorfall
Frisch	JJ	1	Frisch
Schutzengel	NN	1	Schutzengel
cher	NN	1	cher
politesses	NN	1	politesses
etoit	NN	1	etoit
winden	VB	1	wand
geschicht	NN	1	geschicht
kampiert	NN	1	kampiert
empor	RP	1	empor
vorstelle	NN	1	vorstelle
angefangen	NN	1	angefangen
reizen	VB	1	gereizt
Willkommen	NN	1	Willkommen
Barschaft	NN	1	Barschaft
nachbringen	NN	1	nachbringen
Flattergeist	NN	1	Flattergeist
seinig	DT	1	seinige
brauchte	NN	1	brauchte
voyés	FW	1	voyés
hilfts	NN	1	hilfts
schickten	NN	1	schickten
Gläsch	JJ	1	Gläschen
schätze	NN	1	schätze
reformé	NN	1	reformé
stecke	NN	1	stecke
rouinir	NN	1	rouinir
Erkennst	NN	1	Erkennst
anspricht	NN	1	anspricht
Packknecht	NN	1	Packknecht
verspreche	NN	1	verspreche
anführen	VB	1	anführen
Seigneur	FW	1	Seigneur
Vorteil	NN	1	Vorteil
Dames	NN	1	Dames
Neidern	NN	1	Neidern
gottlos	NN	1	gottlos
Darnach	RB	1	Darnach
hergegeben	NN	1	hergegeben
Rumpfe	NN	1	Rumpfe
Mangel	NN	1	Mangel
schwärmen	VB	1	schwärmen
desselben	NN	1	desselben
vertieft	NN	1	vertieft
Sehn	NN	1	Sehn
unversehrt	NN	1	unversehrt
Plaudert	NN	1	Plaudert
niedrigste	NN	1	niedrigste
Schön	NN	1	Schön
sentraider	NN	1	sentraider
vermögen	VB	1	vermochte
Säbels	NN	1	Säbels
unvermutete	NN	1	unvermutete
Ärgernis	NN	1	Ärgernis
Uhr	NN	1	Uhr
arme	NN	1	arme
Komödiantin	NN	1	Komödiantin
gespeisen	NN	1	gespeisen
tändelnden	NN	1	tändelnden
Währendes	NN	1	Währendes
91	CD	1	91
Ministre	NN	1	Ministre
Stube	NN	1	Stube
traktiere	NN	1	traktiere
Nachweisungen	NN	1	Nachweisungen
bringe	VB	1	bringe
Lügner	NN	1	Lügner
lohnen	VB	1	lohnen
Trommelschläger	RB	1	Trommelschläger
Rache	NN	1	Rache
hinzugesetzt	NN	1	hinzugesetzt
springen	VB	1	springen
Le	NN	1	Le
Kammermädchens	NN	1	Kammermädchens
La	NN	1	La
Tages	NN	1	Tages
entehren	VB	1	entehrt
Vorbereitung	NN	1	Vorbereitung
Groschen	NN	1	Groschen
unterhalten	VB	1	unterhalten
Gasthof	NN	1	Gasthof
point	FW	1	point
françois	NN	1	françois
adresse	FW	1	adresse
quun	NN	1	quun
Junge	NN	1	Junge
studierte	NN	1	studierte
satt	JJ	1	satt
hol	NN	1	hol
preussisch	JJ	1	preußisch
Augenblickchen	JJ	1	Augenblickchen
bunt	JJ	1	bunt
fleissig	JJ	1	fleißig
hiesige	NN	1	hiesige
A	NN	1	A
Weinen	NN	1	Weinen
vorig	JJ	1	vorige
unterstützet	NN	1	unterstützet
Verzehren	NN	1	Verzehren
billig	JJ	1	billig
Böses	NNP	1	Böses
unbarmherzigen	NN	1	unbarmherzigen
quand	NN	1	quand
Ämtern	NN	1	Ämtern
Winkel	NNP	1	Winkel
gelassen	NN	1	gelassener
Herein	NN	1	Herein
bewohnt	NN	1	bewohnt
vernarret	NN	1	vernarret
Hierdurch	NN	1	Hierdurch
sont	FW	1	sont
stössen	VB	1	stößt
gekränkte	NN	1	gekränkte
hinderts	NN	1	hinderts
blessierten	NN	1	blessierten
Kälte	NN	1	Kälte
ausgebreiteten	JJ	1	ausgebreiteten
moitié	FW	1	moitié
Antwort	NN	1	Antwort
geprahlt	NN	1	geprahlt
Drei	CD	1	Drei
Dorf	NN	1	Dorf
seinigen	PRP$	1	seinigen
kehrte	NN	1	kehrte
falsch	JJ	1	falschen
Grundsätze	NN	1	Grundsätze
dorthin	RP	1	dorthin
Brillant	NN	1	Brillant
begreife	VB	1	begreife
stösst	VB	1	stößt
dasmal	RB	1	dasmal
Unruhen	NN	1	Unruhen
Rechts	NN	1	Rechts
beizutreiben	VB	1	beizutreiben
zugebracht	NN	1	zugebracht
Brüdern	NN	1	Brüdern
Angenehmes	NN	1	Angenehmes
wahrscheinlich	JJ	1	wahrscheinlich
uneingeladen	NN	1	uneingeladen
Besitze	NN	1	Besitze
Rechtschaffenheit	NN	1	Rechtschaffenheit
wohlaffektionierter	NN	1	wohlaffektionierter
abziehen	VB	1	abgezogen
paisla	NN	1	paisla
mentendés	FW	1	mentendés
abgebrannten	NN	1	abgebrannten
schreckhaften	NN	1	schreckhaften
Städten	NN	1	Städten
ähnlichem	NN	1	ähnlichem
ungeputzt	NN	1	ungeputzt
Wars	NN	1	Wars
Hängen	NN	1	Hängen
Mühle	NN	1	Mühle
werde	RB	1	werde
Hure	NN	1	Hure
Komödiantinnen	NN	1	Komödiantinnen
Frauenzimmerch	NN	1	Frauenzimmerchen
Bemühung	NN	1	Bemühung
geliebt	NN	1	geliebt
Bequemlichkeit	NN	1	Bequemlichkeit
gebundener	NNP	1	gebundener
erstrecken	VB	1	erstrecken
Urteil	NN	1	Urteil
vorbereiten	RB	1	vorbereiten
spräche	NN	1	spräche
Gratial	NN	1	Gratial
Seines	PRP$	1	Seines
gehörigen	NN	1	gehörigen
nichtswürdiger	NN	1	nichtswürdiger
Zärtlich	JJ	1	Zärtlich
Cela	NN	1	Cela
vorgehen	VB	1	vorgeht
Schuhen	NN	1	Schuhen
Träumer	NN	1	Träumer
est-ce	NNP	1	est-ce
Ringelch	JJ	1	Ringelchen
verweigern	VB	1	verweigern
herkommen	VB	1	herkommen
Polen	NNP	1	Polen
vermietete	NN	1	vermietete
liebet	NN	1	liebet
Dritt	JJ	1	Dritter
charmante	NN	1	charmante
beschwor	NN	1	beschwor
Rapport	NN	1	Rapport
entre	FW	1	entre
finstern	NN	1	finstern
sonen	VBN	1	sonst
verweile	NN	1	verweile
Schein	NN	1	Schein
übermütig	JJ	1	übermütig
Gleichgültigkeit	NN	1	Gleichgültigkeit
abgeschmackt	JJ	1	abgeschmackt
vieles	JJ	1	vieles
Sei	NN	1	Sei
Seh	PRP$	1	Seh
recommence	NN	1	recommence
Tranchons	NN	1	Tranchons
telle	NN	1	telle
Kammerjungfern	NN	1	Kammerjungfern
Erdichtet	NN	1	Erdichtet
Bissen	NN	1	Bissen
Empfangen	NN	1	Empfangen
zaudern	NN	1	zaudern
leugnen	VB	1	leugnen
auftrüge	NN	1	auftrüge
stellen	VB	1	stellen
hingehen	VB	1	hingeht
aufpassen	VB	1	aufpassen
Gegend	NN	1	Gegend
angenehm	JJ	1	angenehm
angewandt	JJ	1	angewandt
brauk	NN	1	brauk
faveur	NN	1	faveur
Lazarett	NN	1	Lazarett
Ökonomie	NN	1	Ökonomie
Prensdor	FW	1	Prensdor
blosses	NN	1	bloßes
ereifert	NN	1	ereifert
Bons	NN	1	Bons
wegzukapern	NN	1	wegzukapern
wiederverlange	NN	1	wiederverlange
ansehnlich	JJ	1	ansehnlich
y	NNP	1	y
appellés	FW	1	appellés
lächeln	VB	1	lächelte
Sicherheit	NN	1	Sicherheit
prellte	NN	1	prellte
Herzensmajor	NN	1	Herzensmajor
Laissés-Moi	FW	1	Laissés-moi
sperren	VB	1	sperren
zieren	VB	1	zieren
Woran	NN	1	Woran
Wand	NN	1	Wand
komplimentieren	NN	1	komplimentieren
Besondersen	RB	1	Besonders
vermehren	VB	1	vermehren
gutherzige	NN	1	gutherzige
Verantwortung	NN	1	Verantwortung
singen	VB	1	sang
Stübchen	JJ	1	Stübchen
augurer	FW	1	augurer
Ihrentwegen	NN	1	Ihrentwegen
sage	VB	1	sage
liest	NN	1	liest
Markt	NN	1	Markt
impolie	NN	1	impolie
schenken	VB	1	geschenkt
einfällt	NN	1	einfällt
sagt	VB	1	sagt
coute	NN	1	coute
untertänigst	RP	1	untertänigst
Peinigung	NN	1	Peinigung
sies	RB	1	sies
Ständen	NN	1	Ständen
Nürnberg	NNP	1	Nürnberg
hundertmalten	RP	1	hundertmal
zusammenbringen	NN	1	zusammenbringen
Possen	NN	1	Possen
abgehalten	NN	1	abgehalten
Säbel	NN	1	Säbel
umkehrt	NN	1	umkehrt
aufgegangen	NN	1	aufgegangen
Restch	VB	1	Restchen
Wartung	NN	1	Wartung
Betäubung	NN	1	Betäubung
hingesteckt	NN	1	hingesteckt
feste	NN	1	feste
abbrechen	VB	1	abbrechen
Dache	NN	1	Dache
anfangen	VB	1	anfangen
Krieger	NN	1	Krieger
Bekanntschaften	NN	1	Bekanntschaften
Führet	NN	1	Führet
Ehern	VB	1	Eher
Dacht	NN	1	Dacht
blicken	VB	1	blickt
Euer	NN	1	Euer
ledig	JJ	1	ledig
fais	NN	1	fais
beschimpfen	NN	1	beschimpfen
Karossen	NN	1	Karossen
zuhalten	NN	1	zuhalten
fangen	VBN	1	fing
getrieb	JJ	1	getrieben
irr	JJ	1	irre
Maule	NN	1	Maule
Ehrgeiz	NN	1	Ehrgeiz
Verschonen	NN	1	Verschonen
ärmer	NN	1	ärmer
Monaten	NN	1	Monaten
mancherlei	JJ	1	mancherlei
schadlos	NN	1	schadlos
Ringelchen	JJ	1	Ringelchen
Aufschrift	NNP	1	Aufschrift
gleichfallsen	VBN	1	gleichfalls
hätt	NN	1	hätt
funfsehn	NN	1	funfsehn
vermelden	NN	1	vermelden
faché	FW	1	faché
süsseste	NN	1	süßeste
miens	FW	1	miens
Nähern	NN	1	Nähern
sagte	VB	1	sagte
Gewesen	NN	1	Gewesen
Bring	FW	1	Bring
Behüte	NN	1	Behüte
Metier	NN	1	Metier
erfüllen	VBN	1	erfüllt
zufried	JJ	1	zufrieden
Ehrerbietung	NN	1	Ehrerbietung
Majestät	NN	1	Majestät
Unwille	NN	1	Unwille
Unglücklichen	JJ	1	Unglückliche
Vergib	NN	1	Vergib
behorcht	NN	1	behorcht
Kasse	NN	1	Kasse
setzet	NN	1	setzet
Beutelchen	VB	1	Beutelchen
vernichten	VB	1	vernichten
unglücklichen	VB	1	unglücklichen
erführen	NN	1	erführen
paradieren	NN	1	paradieren
Decke	NN	1	Decke
Fordere	NN	1	Fordere
Lustig	JJ	1	Lustig
pardonnerés	FW	1	pardonnerés
drückend	JJ	1	drückend
Gedenke	NN	1	Gedenke
ängstigen	NN	1	ängstigen
Geschlecht	NN	1	Geschlecht
Kleinigkeiten	NN	1	Kleinigkeiten
zänkisch	JJ	1	zänkischen
unbescholtene	NN	1	unbescholtene
tapferst	JJ	1	tapferste
geschiedene	JJ	1	geschiedene
Spiele	NN	1	Spiele
Schäfer	NN	1	Schäfer
Tür	NN	1	Tür
Kerls	NN	1	Kerls
einzulösen	NN	1	einzulösen
tant	NN	1	tant
Rocken	NN	1	Rocken
fände	NN	1	fände
Sag	NN	1	Sag
Blessuren	NN	1	Blessuren
Handlung	NN	1	Handlung
kurzsichtig	JJ	1	kurzsichtig
entehret	NN	1	entehret
Strass	NN	1	Straß
Jahren	NN	1	Jahren
einbildet	NN	1	einbildet
Tell	NN	1	Tell
permis	NN	1	permis
anzugehören	VB	1	anzugehören
ordentlich	JJ	1	ordentlichen
belle	NNP	1	belle
vernünftig	JJ	1	vernünftig
niks	NN	1	niks
behausen	NN	1	behausen
ankleiden	NN	1	ankleiden
navoir	NN	1	navoir
mittelste	NN	1	mittelste
Schande	NNS	1	Schanden
Waise	NN	1	Waise
gespielen	VBN	1	gespielen
Pflege	NN	1	Pflege
eingebildetes	NN	1	eingebildetes
geschmeidig	JJ	1	geschmeidig
humble	NN	1	humble
ereifern	NN	1	ereifern
Branche	FW	1	Branche
schlepp	NN	1	schlepp
reste	NN	1	reste
Unwillen	NN	1	Unwillen
ihres	PRP$	1	ihres
brennet	NN	1	brennet
unternehmen	VB	1	unternehmen
hungerte	NN	1	hungerte
einzunehmen	NN	1	einzunehmen
herwendet	NN	1	herwendet
Handwerk	NN	1	Handwerk
erwarte	NN	1	erwarte
brennen	VB	1	brennen
vornehmen	VB	1	vornehmen
Schicksals	NN	1	Schicksals
faltet	NN	1	faltet
auffing	FW	1	auffing
Mädchens	NN	1	Mädchens
vollesten	NN	1	vollesten
Orts	NNP	1	Orts
Sagen	NN	1	Sagen
Meldet	NN	1	Meldet
Rührung	NN	1	Rührung
Verwunderung	NN	1	Verwunderung
exactement	NNP	1	exactement
unten	RB	1	unten
wiedernehmen	NN	1	wiedernehmen
Kohle	NNS	1	Kohlen
Kamin	NN	1	Kamin
50	CD	1	50
Zusammenhang	NN	1	Zusammenhang
füllen	VB	1	füllt
Empfindung	NN	1	Empfindung
Licht	NN	1	Licht
Verweise	NN	1	Verweise
Alsdann	NNP	1	Alsdann
Versetzt	NN	1	Versetzt
Oberstern	VB	1	Oberster
Versetze	NN	1	Versetze
verwünschte	NN	1	verwünschte
beneiden	VB	1	beneiden
verdienet	NNP	1	verdienet
Geliebten	NN	1	Geliebten
gezieret	NN	1	gezieret
anzufangen	VB	1	anzufangen
Quark	NN	1	Quark
Les	NN	1	Les
stiften	VBN	1	gestiftet
Hm	NN	1	Hm
gönnen	VB	1	gönnen
Mundierungsstücke	NNP	1	Mundierungsstücke
weiblich	JJ	1	weibliche
Ausgange	NN	1	Ausgange
burr	NN	1	burr
Bräutigam	NN	1	Bräutigam
niedersetzte	NN	1	niedersetzte
Zeitlang	NN	1	Zeitlang
verschweigen	VB	1	verschweigen
Orten	NN	1	Orten
Still	NN	1	Still
anbieten	RP	1	angeboten
entlegne	NN	1	entlegne
nachweisen	VB	1	nachweisen
günstig	JJ	1	günstiger
Ruhmbegierde	NN	1	Ruhmbegierde
reeissen	VB	1	reißen
lieber	RB	1	lieber
sou	NN	1	sou
Unmensch	JJ	1	Unmenschen
entferntesten	NN	1	entferntesten
Ermüdung	NN	1	Ermüdung
Fuss	NN	1	Fuß
Müller	NN	1	Müller
resolvier	NN	1	resolvier
Schliess	NN	1	Schließ
einholen	VB	1	einholen
geschieht	RB	1	geschieht
Übertreibungen	NN	1	Übertreibungen
redlichern	NN	1	redlichern
Hernach	NN	1	Hernach
zugehören	NN	1	zugehören
Unschuld	NN	1	Unschuld
liesse	NN	1	ließe
leiden	VB	1	leiden
ersticken	VB	1	ersticken
tugendhaft	NN	1	tugendhaft
Banquier	NN	1	Banquier
Nuren	RB	1	Nur
erbettelt	NN	1	erbettelt
offen	JJ	1	offenen
trug	NN	1	trug
beschwerlich	JJ	1	beschwerlich
liebest	RP	1	liebest
verdammte	NN	1	verdammte
vertrauter	NN	1	vertrauter
Hiernächst	NN	1	Hiernächst
Liverei	NN	1	Liverei
Schneller	NN	1	Schneller
insgeheim	RP	1	insgeheim
bewussten	NN	1	bewußten
dadurk	RB	1	dadurk
albernes	NN	1	albernes
erscheinen	VB	1	erscheinen
Zehn	NN	1	Zehn
bilde	NN	1	bilde
meinest	VB	1	meinest
versparen	NN	1	versparen
Gegenpart	NN	1	Gegenpart
Staate	NN	1	Staate
erholen	VB	1	erholen
scharmieren	NN	1	scharmieren
holdseligste	NN	1	holdseligste
ny	NNP	1	ny
Versuche	NN	1	Versuche
überwachten	NN	1	überwachten
Verstellung	NN	1	Verstellung
verkennt	NN	1	verkennt
öfterer	NN	1	öfterer
Vorbewusst	NN	1	Vorbewußt
Schlafzimmer	NN	1	Schlafzimmer
kennte	NN	1	kennte
beträchtlich	JJ	1	beträchtlich
rätst	NN	1	rätst
stiess	NN	1	stieß
Runde	NN	1	Runde
dien	NN	1	dien
stiesse	NN	1	stieße
Schüchtern	NN	1	Schüchtern
Hund	NN	1	Hund
Vergessen	NN	1	Vergessen
Rois	NNP	1	Rois
Davonen	RB	1	Davon
wenikst	NNP	1	wenikst
Valute	NN	1	Valute
vermaledeite	NN	1	vermaledeite
trockenen	NN	1	trockenen
Schmerz	NN	1	Schmerz
Heimat	NN	1	Heimat
mutwillige	NN	1	mutwillige
hässlicher	NN	1	häßlicher
gespreizt	JJ	1	gespreizten
doits	NN	1	doits
endlik	NN	1	endlik
Wichtigsen	VB	1	Wichtigste
lächelnd	NN	1	lächelnd
sieht	VB	1	sieht
schossen	VB	1	schoß
Wohnung	NN	1	Wohnung
Rittmeister	NN	1	Rittmeister
Adjeu	NN	1	Adjeu
herzlich	JJ	1	herzlich
dringender	RB	1	dringender
überlegt	JJ	1	überlegt
guen	VB	1	gute
Festung	NN	1	Festung
gefiele	NN	1	gefiele
Abschlag	NN	1	Abschlag
ver	NN	1	ver
schweige	NN	1	schweige
deswegen	RB	1	deswegen
ausgelernter	NN	1	ausgelernter
entwischen	VB	1	entwischen
Gastwirt	NN	1	Gastwirt
entdeckt	NN	1	entdeckt
Schade	NN	1	Schade
faules	NN	1	faules
veranlasset	NN	1	veranlasset
wählen	VBN	1	gewählt
schwerlich	JJ	1	schwerlich
Suchen	VB	1	Suchen
dommage	NN	1	dommage
Ehrlichkeit	NN	1	Ehrlichkeit
Kron	NNP	1	Kron
liessen	NN	1	ließen
politisch	JJ	1	politische
stehle	NN	1	stehle
Kalt	NN	1	Kalt
sais-je	NNP	1	sais-je
zuckt	NN	1	zuckt
beurlauben	NN	1	beurlauben
desfalls	RB	1	desfalls
kannte	NN	1	kannte
Gutt	NN	1	Gutt
Savés	TRUNC	1	Savés-
Pret-Au-Val	NN	1	Pret-au-val
rasieren	VB	1	rasieren
aufziehen	VB	1	aufzieht
Drechslerpuppen	NN	1	Drechslerpuppen
Bravour	NN	1	Bravour
einzigem	NN	1	einzigem
einzigen	VB	1	einzige
verdirbst	NN	1	verdirbst
Benennung	NN	1	Benennung
folgend	JJ	1	folgende
Briefschreiben	VB	1	Briefschreiben
fliehen	VB	1	fliehen
zurückgibt	NN	1	zurückgibt
Klage	NNS	1	Klagen
ausräumen	VBN	1	ausgeräumt
höhnisch	JJ	1	höhnisch
vielmehren	VBN	1	vielmehr
nachkomme	NN	1	nachkomme
nimmt	VB	1	nimmt
nêt-homme	NN	1	nêt-homme
gewesenen	NN	1	gewesenen
zugedacht	NN	1	zugedacht
hergekommen	NN	1	hergekommen
langt	JJ	1	langt
Eigentümer	NN	1	Eigentümer
blühende	NN	1	blühende
unbescheiden	NN	1	unbescheiden
Künftige	NN	1	Künftige
beurteilet	NN	1	beurteilet
steckts	NN	1	steckts
Päbstliken	NN	1	Päbstliken
verwundert	NN	1	verwundert
Dach	NN	1	Dach
mehrmal	RB	1	mehrmal
gewinne	NN	1	gewinne
Où	NN	1	Où
parmi	NN	1	parmi
lieblich	JJ	1	lieblich
Vaterlande	NN	1	Vaterlande
honnêt-homme	FW	1	honnêt-homme
übergebe	NN	1	übergebe
August	FW	1	August
habt	NN	1	habt
ertappt	NN	1	ertappt
Distrikte	NN	1	Distrikte
Verordnungen	NN	1	Verordnungen
Besehen	VB	1	Besieht
konnte	VB	1	konnte
Wien	NNP	1	Wien
Feuermauren	NN	1	Feuermauren
vous	NN	1	vous
drehend	JJ	1	drehend
swanzik	NN	1	swanzik
Friedrichsdor	NN	1	Friedrichsdor
erfordern	VB	1	erfordert
unsere	PRP$	1	unsere
anstehen	VB	1	ansteht
Unverschämter	NN	1	Unverschämter
Hintertreppe	JJ	1	Hintertreppe
abgeredet	NN	1	abgeredet
Schuldigkeit	NN	1	Schuldigkeit
Oui	NN	1	Oui
verdrösse	NN	1	verdrösse
küssend	JJ	1	küssend
unbekannen	RP	1	unbekannt
rächten	NN	1	rächten
würdig	JJ	1	würdig
hinwiederum	NN	1	hinwiederum
Lies	WRB	1	Lies
Schlagen	VB	1	Schlägt
Schreiben	NN	1	Schreiben
beantworten	VB	1	beantworten
bedeutend	JJ	1	bedeutenden
stolz	JJ	1	stolz
lähmen	RP	1	gelähmt
laufend	JJ	1	laufenden
Galgenstrick	NNP	1	Galgenstrick
aufzähle	NN	1	aufzähle
ruhmvoll	JJ	1	ruhmvolle
Geschriebenes	NN	1	Geschriebenes
stumm	JJ	1	stumm
Niederträchtigkeit	NN	1	Niederträchtigkeit
besseres	NN	1	besseres
befremdet	NN	1	befremdet
Liebenswürdigsten	NN	1	Liebenswürdigsten
Notfall	NN	1	Notfall
sous	NNP	1	sous
grossen	JJ	1	großen
laimés	FW	1	laimés
zuführend	JJ	1	zuführend
verdienstlicher	NNP	1	verdienstlicher
erstemal	RB	1	erstemal
lässig	JJ	1	lässig
Kantinen	NN	1	Kantinen
grob	JJ	1	groben
füttern	VB	1	füttern
Vier	CD	1	Vier
Tant	NN	1	Tant
Fürchten	NN	1	Fürchten
Hartnäckiger	NNP	1	Hartnäckiger
Verderben	NN	1	Verderben
Verkauft	NN	1	Verkauft
ärgern	VB	1	ärgert
Dabeien	RB	1	Dabei
kennten	NN	1	kennten
Probe	NN	1	Probe
sa	NN	1	sa
Empfang	NN	1	Empfang
ärgert	NN	1	ärgert
Unbesonnenheit	NN	1	Unbesonnenheit
Jenem	RP	1	Jenem
Erzähl	NN	1	Erzähl
richtiger	NNP	1	richtiger
wirblicht	NN	1	wirblicht
vorenthält	NN	1	vorenthält
doppelter	NN	1	doppelter
Stund	NN	1	Stund
Redet	NN	1	Redet
Hitze	NN	1	Hitze
Lachs	NNP	1	Lachs
Geck	NN	1	Geck
unterrichtet	NN	1	unterrichtet
main	FW	1	main
verwahre	NN	1	verwahre
Schlimmen	NN	1	Schlimmen
Bereitschaft	NN	1	Bereitschaft
meistenteils	NN	1	meistenteils
erweiset	NN	1	erweiset
herkömmt	NN	1	herkömmt
vorbei	IN	1	vorbei
ruhen	VBN	1	geruht
son	NN	1	son
vorgab	NN	1	vorgab
gequälet	NN	1	gequälet
Königs	NN	1	Königs
Schulzengerichte	NN	1	Schulzengerichte
Verlass	NN	1	Verlaß
placé	FW	1	placé
Zahlungstermin	NN	1	Zahlungstermin
Dok	NN	1	Dok
weh	RB	1	weh
spassen	PRP$	1	spaßen
hinreicht	NN	1	hinreicht
dahern	VB	1	daher
eu	NN	1	eu
verschämen	VB	1	verschämt
zuschreiben	VB	1	zuschreiben
Ordnung	NN	1	Ordnung
erdrosseln	VB	1	erdrosseln
fasse	NNP	1	fasse
Lieben	NN	1	Lieben
wiederfinden	NN	1	wiederfinden
schmecken	VB	1	schmecken
unanständig	JJ	1	unanständig
Wesen	NN	1	Wesen
Ursachen	VB	1	Ursachen
Elende	NN	1	Elende
spiel	NN	1	spiel
Eilen	NN	1	Eilen
festeste	NN	1	festeste
reformir	NNP	1	reformir
rein	JJ	1	reinen
gilts	NN	1	gilts
pigeonneau	NN	1	pigeonneau
Bewunderern	NN	1	Bewunderern
Justizkollegiis	NN	1	Justizkollegiis
principe	NN	1	principe
Linken	NN	1	Linken
längste	NN	1	längste
umsehen	VB	1	umsieht
wirds	NN	1	wirds
Quälgeist	NN	1	Quälgeist
Raten	NN	1	Raten
Standes	NNP	1	Standes
Royal	NN	1	Royal
murren	VB	1	murren
Stellung	NN	1	Stellung
Topp	NN	1	Topp
Ärgerlich	JJ	1	Ärgerlich
Lohn	NN	1	Lohn
Dato	RB	1	Dato
Wurf	NN	1	Wurf
Such	JJ	1	Suchen
nutzen	VB	1	nutzen
Meile	NN	1	Meile
Verbindlichkeit	NN	1	Verbindlichkeit
ewik	NNP	1	ewik
aufwärts	NN	1	aufwärts
verbaute	NN	1	verbaute
avanciert	RP	1	avanciert
bemerken	VB	1	bemerken
16	CD	1	16
weisend	JJ	1	weisend
gewarnet	NN	1	gewarnet
Schäkerin	NN	1	Schäkerin
vertrauen	VB	1	vertrauen
alles	RB	1	alles
Nimm	NN	1	Nimm
wofür	RP	1	wofür
Erklären	NN	1	Erklären
vertrauet	NN	1	vertrauet
sau	JJ	1	sauer
Reitpferde	NN	1	Reitpferde
Hals	NN	1	Hals
Halt	NNS	1	Halte
De	NN	1	De
wiederhergestellt	RB	1	wiederhergestellt
gehörige	NN	1	gehörige
Erschrecke	NN	1	Erschrecke
warst	WRB	1	warst
trägt	JJ	1	trägt
Teuff	NN	1	Teuff
sonderbar	JJ	1	sonderbare
Höhe	NN	1	Höhe
Französisch	NN	1	Französisch
Tode	NN	1	Tode
parle	NN	1	parle
schweigen	VBN	1	geschwiegen
Monarch	NN	1	Monarch
vollziehe	NN	1	vollziehe
Lande	NN	1	Lande
jedermann	NNP	1	jedermann
voudrois	NN	1	voudrois
bereite	NN	1	bereite
Kurland	NN	1	Kurland
frisiert	NN	1	frisiert
Wen	NN	1	Wen
Bube	NN	1	Bube
Schwert	NN	1	Schwert
losdrücken	NN	1	losdrücken
schassen	VB	1	schießen
dazuen	VB	1	dazu
Lektion	NN	1	Lektion
nüchtern	JJ	1	nüchtern
Rauch	NN	1	Rauch
glücklichern	NN	1	glücklichern
hinterlassen	VB	1	hinterlassen
plump	JJ	1	plump
hörts	NN	1	hörts
Juweln	VB	1	Juwelen
Dinte	NN	1	Dinte
edeln	NN	1	edeln
Sophistin	NN	1	Sophistin
erdichtet	NN	1	erdichtet
Zufolge	NN	1	Zufolge
monde	NN	1	monde
hörte	VB	1	hörte
Wälder	NN	1	Wälder
stürmisch	JJ	1	stürmische
gen	IN	1	gen
Männern	NN	1	Männern
gewilliget	NN	1	gewilliget
schwer	JJ	1	schwer
hingeg	JJ	1	hingegen
carte	FW	1	carte
verwirre	NN	1	verwirre
geputzter	NN	1	geputzter
gesehn	NN	1	gesehn
Kontribution	NN	1	Kontribution
verwirrt	JJ	1	verwirrt
Prahlen	NN	1	Prahlen
Hieren	VBN	1	Hier
Italien	NNP	1	Italien
Bitt	NN	1	Bitte
liebsten	NN	1	liebsten
stärkern	NN	1	stärkern
ausgenomm	JJ	1	ausgenommen
zugestossen	NN	1	zugestoßen
3	CD	1	3
beifall	DT	1	beifallen
lässest	NN	1	lässest
Trunk	NN	1	Trunk
vorgeben	VB	1	vorgeben
ungehangen	NN	1	ungehangen
dachts	RB	1	dachts
leugnest	NN	1	leugnest
Wert	NN	1	Wert
alten	VB	1	alten
erbrochen	RP	1	erbrochen
versichert	NN	1	versichert
Wunderbar	JJ	1	Wunderbar
mans	NN	1	mans
Beutepferde	NN	1	Beutepferde
bezahle	NN	1	bezahle
eröffnen	VB	1	eröffnet
darin	RB	1	darin
Wofür	NN	1	Wofür
vois	NN	1	vois
besorgt	JJ	1	besorgt
Mahlzeit	NN	1	Mahlzeit
wandere	NN	1	wandere
Glücks	NN	1	Glücks
jemanden	NN	1	jemanden
offenherziger	NNP	1	offenherziger
verdammt	JJ	1	verdammt
tückisch	JJ	1	tückische
beiderseits	NN	1	beiderseits
perfekter	NN	1	perfekter
Kehren	VB	1	Kehrt
Armut	NN	1	Armut
abhangen	NNP	1	abhangen
wied	JJ	1	wieder
ausziehen	VB	1	ausziehen
gleichviel	NN	1	gleichviel
befriedigen	VB	1	befriedigen
coupe	FW	1	coupe
sterbenden	NN	1	sterbenden
oberst	JJ	1	obersten
Verteidigen	NN	1	Verteidigen
Geträumt	NN	1	Geträumt
Hunde	NN	1	Hunde
Unrechte	NN	1	Unrechte
Nasenweise	NN	1	Nasenweise
bezahlt	VBN	1	bezahlt
Venedig	NNP	1	Venedig
schiehen	VB	1	geschieht
hernach	NN	1	hernach
Gründe	NN	1	Gründe
eig	JJ	1	eigen
ginge	NN	1	ginge
krank	JJ	1	krank
Vollmacht	NN	1	Vollmacht
Betten	NN	1	Betten
hinkommen	NN	1	hinkommen
soit	NNP	1	soit
vielmal	RB	1	vielmal
genau	RP	1	genau
entstanden	NN	1	entstanden
Mund	NN	1	Mund
verehren	VB	1	verehren
Überreicht	NN	1	Überreicht
Extraction	NN	1	Extraction
Eigensinne	NN	1	Eigensinne
Grösse	NN	1	Größe
schwächer	JJ	1	schwächere
Brieftasche	NN	1	Brieftasche
dhonneur	NN	1	dhonneur
toûjours	NN	1	toûjours
Leut	NN	1	Leut
Gliedmassen	NN	1	Gliedmaßen
Karat	NN	1	Karat
Spitzbube	NN	1	Spitzbube
begreifen	VBN	1	begriffen
zittern	VB	1	gezittert
Edelmut	NN	1	Edelmut
Scherz	NN	1	Scherz
ausarte	NN	1	ausarte
Neuigkeiten	NN	1	Neuigkeiten
weggenommen	NN	1	weggenommen
Empfehl	NN	1	Empfehl
Parteilichkeit	NN	1	Parteilichkeit
Lichtmess	NN	1	Lichtmeß
Beständigkeit	NN	1	Beständigkeit
Ankunft	NN	1	Ankunft
nai	NN	1	nai
fürchteten	NN	1	fürchteten
aufwiegen	RP	1	aufwiegt
vernünftiger	NNP	1	vernünftiger
entstehen	VB	1	entstehen
aufzutreiben	VB	1	aufzutreiben
Arglist	NN	1	Arglist
Abend	NNS	1	Abende
vortrefflicher	NN	1	vortrefflicher
Rummel	NN	1	Rummel
meinst	JJ	1	meinst
cherche	NN	1	cherche
Kommendanten	NN	1	Kommendanten
Unrechtes	NN	1	Unrechtes
Wirtstafel	NN	1	Wirtstafel
Komplott	NN	1	Komplott
Stolzes	NN	1	Stolzes
parat	JJ	1	parat
erbiete	NN	1	erbiete
vorgeschossen	NN	1	vorgeschossen
begegnet	RB	1	begegnet
lachendsten	NN	1	lachendsten
gering	JJ	1	gering
Vorwand	NN	1	Vorwand
Winkelzug	NN	1	Winkelzug
Geschäfte	NNP	1	Geschäfte
mon	JJ	1	mon
Tones	NN	1	Tones
Falle	NN	1	Falle
überliesse	NN	1	überließe
verstehn	NN	1	verstehn
untertänigster	NN	1	untertänigster
Bravo	NN	1	Bravo
holländisch	JJ	1	holländischen
Reichtümern	NN	1	Reichtümern
Hon	JJ	1	Hon
eigne	NN	1	eigne
Geschwindigkeit	NN	1	Geschwindigkeit
pflege	NN	1	pflege
wahrhaft	JJ	1	wahrhaft
aufzusuchen	VB	1	aufzusuchen
Diesen	NN	1	Diesen
wahres	JJ	1	wahres
Vorbitterin	NN	1	Vorbitterin
gebe	NN	1	gebe
Zöge	NN	1	Zöge
Kur	NN	1	Kur
unschuldigen	PRP$	1	unschuldigen
verzweifelten	NN	1	verzweifelten
Gebieterin	NN	1	Gebieterin
auslegen	VBN	1	ausgelegt
Schutz	NN	1	Schutz
vû	NN	1	vû
hieher	NN	1	hieher
unfreundlich	JJ	1	unfreundlich
Partie	NN	1	Partie
Selbsterhaltung	NN	1	Selbsterhaltung
Beides	NN	1	Beides
vis-à-vis	NNP	1	vis-à-vis
Eurem	NN	1	Eurem
willig	JJ	1	willig
führen	VB	1	führte
vorstehende	NN	1	vorstehende
raus	RP	1	raus
nebst	IN	1	nebst
praktiziert	NN	1	praktiziert
artig	JJ	1	artig
Redensart	NN	1	Redensart
on	NNP	1	on
gebrauchen	VB	1	gebraucht
fureur	NN	1	fureur
gebrech	VB	1	gebrechen
Bloss	NN	1	Bloß
Kreatur	NN	1	Kreatur
étre	NN	1	étre
Träumereien	NN	1	Träumereien
behielten	NN	1	behielten
Verlusts	NN	1	Verlusts
rühmen	NN	1	rühmen
invitir	NN	1	invitir
Beruhigung	NN	1	Beruhigung
empfinden	VB	1	empfinden
Tabagie	NN	1	Tabagie
ehr	DT	1	ehr
Erbricht	NN	1	Erbricht
lon	NNP	1	lon
Aufgebot	NNS	1	Aufgebote
langsam	JJ	1	langsam
wägen	VB	1	wägen
fodern	NN	1	fodern
gehauen	NN	1	gehauen
darzustellen	RB	1	darzustellen
Gedränge	NN	1	Gedränge
Freue	NN	1	Freue
gibt	JJ	1	gibt
erschrecke	NN	1	erschrecke
wiederkehrendes	NN	1	wiederkehrendes
foltert	NN	1	foltert
rechnen	VB	1	rechnen
pfleg	NN	1	pfleg
ausgezahlt	NN	1	ausgezahlt
Garnisonregimente	NN	1	Garnisonregimente
interessir	NN	1	interessir
mahnen	VB	1	mahnen
weigerte	NN	1	weigerte
Nouvelle	NN	1	Nouvelle
früher	RP	1	früher
Eigensinn	NN	1	Eigensinn
Vormünder	NN	1	Vormünder
beibehalten	VB	1	beibehalten
Wären	NN	1	Wären
Aufwartung	NN	1	Aufwartung
Zugänge	NN	1	Zugänge
Hof	NN	1	Hof
unveränderlich	JJ	1	unveränderlich
umnebelt	NN	1	umnebelt
gratulier	NN	1	gratulier
gäb	NN	1	gäb
melancholisch	JJ	1	melancholische
file	NN	1	file
allervollständigste	NN	1	allervollständigste
behüte	NN	1	behüte
enterbt	NN	1	enterbt
Redens	NN	1	Redens
Verbeugung	NN	1	Verbeugung
pfui	UH	1	pfui
donnés	NN	1	donnés
anböte	NN	1	anböte
Gespielin	NN	1	Gespielin
Bekannte	NN	1	Bekannte
auszuliefern	NN	1	auszuliefern
erbroch	JJ	1	erbrochen
Futteral	NN	1	Futteral
hölzern	JJ	1	hölzern
dasuen	VB	1	dasu
Meint	NN	1	Meint
grundfalsch	NN	1	grundfalsch
Verdruss	NN	1	Verdruß
sichrer	NN	1	sichrer
schrieb	NN	1	schrieb
eign	JJ	1	eignen
Zurücknehmung	NN	1	Zurücknehmung
herschreibt	NN	1	herschreibt
Gasthöfe	NN	1	Gasthöfe
versiegelte	NN	1	versiegelte
andre	NN	1	andre
Fix	NN	1	Fix
Gelde	NN	1	Gelde
dexterité	FW	1	dexterité
Bestechung	NN	1	Bestechung
missen	NN	1	missen
dreissig	CD	1	dreißig
überflüssig	JJ	1	überflüssige
Flitterseite	NN	1	Flitterseite
Votre	NN	1	Votre
Nachdenken	NN	1	Nachdenken
Kanale	NN	1	Kanale
geziemet	NN	1	geziemet
Freischulze	NN	1	Freischulze
währender	NN	1	währender
währendes	NN	1	währendes
lauf	NN	1	lauf
desprit	NN	1	desprit
zurückhaltend	JJ	1	zurückhaltend
Rücken	NN	1	Rücken
laut	JJ	1	laut
Hoheit	NN	1	Hoheit
Est-Il	NN	1	Est-il
Kleinigkeit	NN	1	Kleinigkeit
Kasten	NN	1	Kasten
rate	NN	1	rate
Trieb	NN	1	Trieb
Haltung	NN	1	Haltung
verbot	JJ	1	verboten
Republik	NN	1	Republik
zuzuschanzen	NN	1	zuzuschanzen
hinaus	IN	1	hinaus
sur	NNP	1	sur
Lehre	NN	1	Lehre
Ähnliches	NN	1	Ähnliches
Versteh	NN	1	Versteh
leid	JJ	1	leid
Gift	NN	1	Gift
kützeln	NN	1	kützeln
fragte	NN	1	fragte
verzweifelt	JJ	1	verzweifelt
Vielleichen	VBN	1	Vielleicht
Windbeutelei	NN	1	Windbeutelei
sert	NNP	1	sert
wiedergegeben	NN	1	wiedergegeben
Halse	NN	1	Halse
sendet	PRP$	1	sendet
Länge	NN	1	Länge
jagte	NN	1	jagte
tust	NN	1	tust
erhitzet	NN	1	erhitzet
eilen	VB	1	eilen
Wozu	NN	1	Wozu
betragen	VB	1	betragen
Neujahr	NN	1	Neujahr
depars	JJ	1	depars
raucht	NN	1	raucht
Hoffnung	NN	1	Hoffnung
Tafel	NN	1	Tafel
bessre	NN	1	beßre
kapern	VB	1	kapern
ansteckender	JJ	1	ansteckender
armen	VB	1	armen
treibt	NN	1	treibt
Vergeben	NN	1	Vergeben
heilen	VB	1	heilen
reizender	NN	1	reizender
rächen	VB	1	rächen
Gefalle	NN	1	Gefalle
Winterquartiere	NN	1	Winterquartiere
Ottomannisch	JJ	1	Ottomannische
Spanien	NNP	1	Spanien
6	CD	1	6
anblickt	NN	1	anblickt
Eigentum	NN	1	Eigentum
Sachés	FW	1	Sachés
Richtigkeit	NN	1	Richtigkeit
gegenwärtig	RB	1	gegenwärtig
redlich	JJ	1	redlichen
hurtig	JJ	1	hurtig
Se	FW	1	Se
beigefallen	VB	1	beigefallen
Perlen	NN	1	Perlen
Herzlich	JJ	1	Herzlich
enfant	NNP	1	enfant
prompt	JJ	1	prompt
Hinten	NN	1	Hinten
Garderobe	NN	1	Garderobe
Zürnen	NN	1	Zürnen
Lächerlichen	VB	1	Lächerlichen
merkte	VB	1	merkte
zehnte	CD	1	zehnte
Dresden	NNP	1	Dresden
Knoten	NN	1	Knoten
versiker	NN	1	versiker
Grille	NN	1	Grille
rasend	JJ	1	rasend
wegwendet	NN	1	wegwendet
pertes	FW	1	pertes
Rennen	NN	1	Rennen
mitleidig	JJ	1	mitleidig
ansteckten	NN	1	ansteckten
Elenden	NN	1	Elenden
konnt	VB	1	konnten
Schlingel	NN	1	Schlingel
Schokolate	NN	1	Schokolate
Gasthofe	NN	1	Gasthofe
wohlhabender	NN	1	wohlhabender
Renner	NN	1	Renner
mystères	FW	1	mystères
bestimmen	VB	1	bestimmte
einsteckt	NN	1	einsteckt
Stütze	NN	1	Stütze
kämen	NN	1	kämen
Unbekannte	NN	1	Unbekannte
rang	PRP	1	rang
Besorgen	VB	1	Besorgten
gleichsam	RB	1	gleichsam
Rechtfertigung	NN	1	Rechtfertigung
unbefohlen	NN	1	unbefohlen
dreimalten	RP	1	dreimal
25	CD	1	25
21	CD	1	21
Sprach	NN	1	Sprach
voran	RP	1	voran
Chevaliers	JJ	1	Chevaliers
Edelmütiger	NNP	1	Edelmütiger
widriger	NN	1	widriger
altes	NN	1	altes
Friedens	NN	1	Friedens
avantureux	NN	1	avantureux
Schreiberei	NN	1	Schreiberei
weitemen	VB	1	weitem
Vorschuss	NN	1	Vorschuß
Statten	NN	1	Statten
armselig	JJ	1	armselig
nachlässig	NN	1	nachlässige
nachgekommen	NN	1	nachgekommen
gelebt	NN	1	gelebt
Rad	NN	1	Rad
unerwartet	JJ	1	unerwartet
nennt	JJ	1	nennt
Nachfrage	NN	1	Nachfrage
faire	FW	1	faire
aiment	NN	1	aiment
Rat	NN	1	Rat
ankam	JJ	1	ankam
Bessers	NN	1	Bessers
errate	NN	1	errate
nötigen	VBN	1	nötig
verzweifelte	NN	1	verzweifelte
Schadenfreude	NN	1	Schadenfreude
Lippe	NNS	1	Lippen
stemme	NN	1	stemme
herholen	NN	1	herholen
très-humble	NN	1	très-humble
Weibe	NN	1	Weibe
hart	JJ	1	hart
quelque	NNP	1	quelque
ansehnlik	NN	1	ansehnlik
Kammerkätzch	JJ	1	Kammerkätzchen
ehrlichst	JJ	1	ehrlichste
winseln	NN	1	winseln
naget	NN	1	naget
Reden	NN	1	Reden
ansteckte	NN	1	ansteckte
Paradies	NNS	1	Paradiese
verlaufen	VB	1	verlaufen
Irrung	NN	1	Irrung
Vollblütigkeit	NN	1	Vollblütigkeit
geringste	NN	1	geringste
Fächer	NN	1	Fächer
abgedankte	NN	1	abgedankte
Juchhe	NN	1	Juchhe
vertrieben	NN	1	vertrieben
Kammer	NN	1	Kammer
ertragen	VB	1	ertragen
très-joli	NN	1	très-joli
versproch	VBN	1	versprochen
liaison	NN	1	liaison
zufrieden	JJ	1	zufriedener
Brod	NN	1	Brod
aufgehen	VB	1	aufgehen
Endlich	RB	1	Endlich
vollkomm	JJ	1	vollkommen
Handel	NN	1	Handel
fromm	JJ	1	fromm
höchst	JJ	1	höchst
donc	FW	1	donc
Familienname	NN	1	Familienname
Rossarzt	NN	1	Roßarzt
Dienerin	NN	1	Dienerin
herausgeben	VB	1	herausgeben
schelten	VB	1	schelten
unterstecken	VBN	1	untergesteckt
geantwortet	NN	1	geantwortet
Aufführung	NN	1	Aufführung
auszufragen	NN	1	auszufragen
Rechten	NN	1	Rechten
ruhik	NN	1	ruhik
unrechten	NN	1	unrechten
Zwanges	NN	1	Zwanges
Schlage	NN	1	Schlage
trouvoient	NN	1	trouvoient
Nahrung	NN	1	Nahrung
heissen	PRP$	1	heißen
Notwendiges	NN	1	Notwendiges
Oberst	NNP	1	Oberst
aussi	FW	1	aussi
karg	JJ	1	karg
Abzug	NN	1	Abzug
Katzenhäusern	NN	1	Katzenhäusern
Bediente	NN	1	Bediente
steht	VB	1	steht
Schaudern	NN	1	Schaudern
seln	VBN	1	selten
unbescholtenen	JJ	1	unbescholtenen
Mutter	NN	1	Mutter
tragisch	JJ	1	tragisch
hungrig	JJ	1	hungrig
maison	NNP	1	maison
Erfahrung	NN	1	Erfahrung
heitersten	NN	1	heitersten
Stabsrittmeisters	NN	1	Stabsrittmeisters
Zeigen	NN	1	Zeigen
aufzumutzen	NN	1	aufzumutzen
Berge	NN	1	Berge
Manns	NN	1	Manns
Iss	IN	1	Iß
bestellen	VB	1	bestellen
geruhen	NN	1	geruhen
vorige	NN	1	vorige
hitzig	JJ	1	hitzig
überlassen	VB	1	überlassen
geruhet	NN	1	geruhet
Rechtschaffenen	NN	1	Rechtschaffenen
tötet	NN	1	tötet
Achtung	NN	1	Achtung
explizier	NN	1	explizier
mach	JJ	1	machen
veritabler	NN	1	veritabler
Gespenster	NN	1	Gespenster
stürzte	NN	1	stürzte
unbeweglich	JJ	1	unbeweglich
tauert	NN	1	tauert
Verfahren	NN	1	Verfahren
Verbrechen	NN	1	Verbrechen
meint	JJ	1	meint
funfzehnhundert	JJ	1	funfzehnhundert
Vorschüsse	NN	1	Vorschüsse
infailliblement	NN	1	infailliblement
versage	NN	1	versage
Melde	NN	1	Melde
getrost	NN	1	getrost
Lazarette	NN	1	Lazarette
küssen	VB	1	küssen
hinwerfen	NN	1	hinwerfen
schlimmern	JJ	1	schlimmer
Heute	RB	1	Heute
Händel	NN	1	Händel
traue	NN	1	traue
koste	NN	1	koste
tapeziert	NN	1	tapeziert
Reich	NN	1	Reich
furchtsam	JJ	1	furchtsam
zweitenmale	NN	1	zweitenmale
Taschenbuch	NN	1	Taschenbuch
Hörst	NN	1	Hörst
Verabschiedet	NN	1	Verabschiedet
beruhiget	NN	1	beruhiget
vernünftigen	NN	1	vernünftigen
maniere	FW	1	maniere
Held	NNS	1	Helden
Kennst	NN	1	Kennst
Leicht	NN	1	Leicht
verunglückte	NN	1	verunglückte
Fleischerknecht	NN	1	Fleischerknecht
Zukunft	NN	1	Zukunft
rasseln	NN	1	rasseln
überreden	VB	1	überreden
elfte	CD	1	elfte
weggekommen	NN	1	weggekommen
eigner	NN	1	eigner
eignes	NN	1	eignes
hervorziehen	VB	1	hervorzieht
Denke	NN	1	Denke
muten	NN	1	muten
ritt	NN	1	ritt
Auftrag	NN	1	Auftrag
wos	NN	1	wos
verfliesst	NN	1	verfließt
Feldkriegskassen	NN	1	Feldkriegskassen
lenchainer	NN	1	lenchainer
richte	NN	1	richte
vexiert	NN	1	vexiert
Katze	NNS	1	Katzen
jedes	RB	1	jedes
unerzogene	NN	1	unerzogene
Bestehlen	NN	1	Bestehlen
Rachsucht	NN	1	Rachsucht
Sengen	PRP$	1	Sengen
Mauern	NN	1	Mauern
abnehmen	VB	1	abnehmen
garçon	NN	1	garçon
Rentmeister	NN	1	Rentmeister
Könikliken	NN	1	Könikliken
erwarb	NN	1	erwarb
Beschäftigung	NN	1	Beschäftigung
dadurch	RB	1	dadurch
gewisses	NN	1	gewisses
Schaden	NN	1	Schaden
verleihen	VB	1	verleihen
Bezahle	NN	1	Bezahle
neinen	RB	1	nein
etre	NN	1	etre
losgehen	NN	1	losgehen
Wenigkeit	NN	1	Wenigkeit
zusammen	RB	1	zusammen
frölik	NN	1	frölik
schenkt	NN	1	schenkt
militärisch	JJ	1	militärisch
Schranke	NNS	1	Schranken
Umsonst	NN	1	Umsonst
austreten	VB	1	austreten
Irrtum	NN	1	Irrtum
unschuldig	JJ	1	unschuldig
nehm	NN	1	nehm
erfährt	NN	1	erfährt
Ersten	NN	1	Ersten
verschafft	NN	1	verschafft
plumer	NN	1	plumer
schwinden	VB	1	schwinden
Übertreibung	NN	1	Übertreibung
Eilikheit	NN	1	Eilikheit
bild	NN	1	bild
Rücksicht	NN	1	Rücksicht
irgendwo	RB	1	irgendwo
malheur	NN	1	malheur
Unterredung	NN	1	Unterredung
Kostbarkeit	NN	1	Kostbarkeit
Schultern	NN	1	Schultern
Kommend	JJ	1	Kommend
möchten	RB	1	möchten
abzufinden	VB	1	abzufinden
sagit	FW	1	sagit
näher	JJ	1	nähere
geholfen	NN	1	geholfen
fürchterlicher	NN	1	fürchterlicher
hingeritten	NN	1	hingeritten
Winspel	NN	1	Winspel
wischte	NN	1	wischte
nützen	VB	1	nützen
Gehülfen	NN	1	Gehülfen
denjenig	DT	1	denjenigen
reuen	VB	1	reuen
gehend	JJ	1	gehend
bekomms	NN	1	bekomms
urteilen	VB	1	urteilen
eingelöset	NN	1	eingelöset
Handbrief	NN	1	Handbrief
vermuten	VB	1	vermuten
Einrichtung	NN	1	Einrichtung
verhärten	NN	1	verhärten
herausziehend	JJ	1	herausziehend
nähernd	NN	1	nähernd
erzogen	NN	1	erzogen
fliegend	NN	1	fliegenden
vernehmen	RP	1	vernommen
Schleifwege	NN	1	Schleifwege
Worin	NN	1	Worin
Vielmehr	IN	1	Vielmehr
moment	NN	1	moment
hingezogen	NN	1	hingezogen
Schwestern	NN	1	Schwestern
Geht	VB	1	Geht
vorsichtigen	NN	1	vorsichtigen
mot	NN	1	mot
allenfalls	IN	1	allenfalls
Zwanzig	JJ	1	Zwanzig
Liebhaberin	NN	1	Liebhaberin
nachgibt	NN	1	nachgibt
einzureichen	VB	1	einzureichen
lieblichste	NN	1	lieblichste
Vollkommenheiten	NN	1	Vollkommenheiten
Schreibt	NN	1	Schreibt
verdient	VB	1	verdient
Tous	NN	1	Tous
verweigert	NN	1	verweigert
veritablement	NNP	1	veritablement
antworteten	NN	1	antworteten
einsprengen	NN	1	einsprengen
propos	NN	1	propos
coup	NN	1	coup
Hindernis	NN	1	Hindernis
Eindruck	NN	1	Eindruck
Traume	NN	1	Traume
stärker	JJ	1	stärkere
beteuerte	NN	1	beteuerte
Glaub	NN	1	Glaub
ertrotzen	NN	1	ertrotzen
reizend	JJ	1	reizend
wage	NN	1	wage
Pforte	NN	1	Pforte
Sittenrichterin	NN	1	Sittenrichterin
Zeiten	NN	1	Zeiten
wollüstigen	MD	1	wollüstig
Provinz	NN	1	Provinz
joue	FW	1	joue
Marino	NNP	1	Marino
damalsen	VB	1	damals
uneigennützig	JJ	1	uneigennützig
zerreisst	NN	1	zerreißt
Bette	NN	1	Bette
Regiments	NN	1	Regiments
Geldeswert	NN	1	Geldeswert
Unbescheiden	NN	1	Unbescheiden
demande	NN	1	demande
Stürmen	PRP$	1	Stürmen
Wällen	NN	1	Wällen
Regimente	NN	1	Regimente
blutjung	NN	1	blutjung
Denken	NN	1	Denken
weinen	VBN	1	geweint
erste	VB	1	erste
Reeissen	VB	1	Reißt
Pferde	NN	1	Pferde
Geschlechtsnamen	NN	1	Geschlechtsnamen
verachtete	NN	1	verachtete
gemeinsten	NN	1	gemeinsten
hältst	WRB	1	hältst
denkst	NN	1	denkst
meinig	DT	1	meinige
Wunder	NN	1	Wunder
autres	FW	1	autres
dankbarer	RB	1	dankbarer
Bosheit	NN	1	Bosheit
Bestimmung	NN	1	Bestimmung
anspinnt	NN	1	anspinnt
Allerliebstes	NN	1	Allerliebstes
peu	NN	1	peu
Nachtwächter	NN	1	Nachtwächter
Disposition	NN	1	Disposition
abreisen	VB	1	abreisen
ungestüm	JJ	1	ungestümes
Antlitz	NN	1	Antlitz
spasshafte	NN	1	spaßhafte
schwatze	NN	1	schwatze
Tugenden	NN	1	Tugenden
Entschlossenheit	NN	1	Entschlossenheit
aufgekommen	NN	1	aufgekommen
einbildete	NN	1	einbildete
erschrak	NN	1	erschrak
Gefallen	NN	1	Gefallen
anrühren	NN	1	anrühren
juste	NN	1	juste
ausdrücklich	RB	1	ausdrücklich
zurückgebracht	NN	1	zurückgebracht
dulden	VB	1	dulden
räume	NN	1	räume
Beflissenheit	NN	1	Beflissenheit
verleugnet	NN	1	verleugnet
tout-à-fait	NN	1	tout-à-fait
Menge	NN	1	Menge
verderben	RP	1	verdorben
bittersten	NN	1	bittersten
Zurückhaltung	NN	1	Zurückhaltung
lachende	NN	1	lachende
meinetwegen	RB	1	meinetwegen
Dahin	RB	1	Dahin
Negligee	NN	1	Negligee
Korporals	NN	1	Korporals
stossen	VB	1	stoßen
wedelte	NN	1	wedelte
Euern	NN	1	Euern
Hartnäckigkeit	NN	1	Hartnäckigkeit
meiner	RB	1	meiner
verfahren	VB	1	verfahren
ratihabierende	NN	1	ratihabierende
verschwemmt	NN	1	verschwemmt
Wachtmeisterin	NN	1	Wachtmeisterin
Einfalspinse	NN	1	Einfalspinse
Schwanze	NN	1	Schwanze
gewähret	NN	1	gewähret
Kapital	NNS	1	Kapitale
sähe	NN	1	sähe
Hätten	NN	1	Hätten
tüchtig	JJ	1	tüchtige
vertrinken	NN	1	vertrinken
unbiegsamen	NN	1	unbiegsamen
darinen	VB	1	darin
erinnerst	NN	1	erinnerst
besorgen	VB	1	besorgte
herkomme	NN	1	herkomme
Betragen	JJ	1	Betragen
glücklichst	JJ	1	glücklichsten
Punkte	NN	1	Punkte
Grunde	NN	1	Grunde
ersticke	NN	1	ersticke
eifersüchtigen	VBN	1	eifersüchtig
Verlegenheit	NN	1	Verlegenheit
Frauenzimmers	NN	1	Frauenzimmers
Böse	NN	1	Böse
unebenes	NN	1	unebenes
zureicht	NN	1	zureicht
Tl	NN	1	Tl
schmeichelnde	NN	1	schmeichelnde
einzuwenden	NN	1	einzuwenden
bedacht	NN	1	bedacht
Neu	JJ	1	Neues
nak	NN	1	nak
Moräste	NN	1	Moräste
unterzukommen	NN	1	unterzukommen
Kapitulation	NN	1	Kapitulation
Spotten	NN	1	Spotten
rechtschaffenste	NN	1	rechtschaffenste
wüssten	NN	1	wüßten
Versicherung	NN	1	Versicherung
erfahre	NN	1	erfahre
Hu	NN	1	Hu
dringen	VB	1	drang
widerfährt	NN	1	widerfährt
Bursche	NN	1	Bursche
fehlende	NN	1	fehlende
ohnlängst	NN	1	ohnlängst
Hält	NN	1	Hält
Schurken	NN	1	Schurken
angewendet	NN	1	angewendet
eintrifft	NN	1	eintrifft
unverloren	NN	1	unverloren
ausschlagen	NN	1	ausschlagen
Triebfedern	NN	1	Triebfedern
Verweilen	NN	1	Verweilen
Leipzig	NNP	1	Leipzig
Ritter	NNP	1	Ritter
vierfache	NN	1	vierfache
Corriger	NNP	1	Corriger
Wallung	NN	1	Wallung
melancholischer	NN	1	melancholischer
Hoffentlichen	VBN	1	Hoffentlich
erzürnt	NN	1	erzürnt
unen	RB	1	unten
zankst	NN	1	zankst
ge	NN	1	ge
wiegt	JJ	1	wiegt
Ehrenstelle	NN	1	Ehrenstelle
zogen	NN	1	zogen
Nok	NN	1	Nok
steckst	NN	1	steckst
sieben	CD	1	sieben
sparsam	JJ	1	sparsam
Menschenhasses	NN	1	Menschenhasses
Lieb	NN	1	Lieber
Blendwerk	NN	1	Blendwerk
Mag	NN	1	Mag
anhören	VB	1	anhören
schlechtrer	NN	1	schlechtrer
Schreiber	NN	1	Schreiber
tuts	NNP	1	tuts
stier	JJ	1	stieres
beliebt	JJ	1	beliebt
Blitz	NN	1	Blitz
getanen	NN	1	getanen
car	NN	1	car
grossmütig	JJ	1	großmütig
unruhig	JJ	1	unruhig
nachbrauche	NN	1	nachbrauche
begnügen	VB	1	begnügen
Indes	NN	1	Indes
Pflicht	NN	1	Pflicht
eigensinnig	RB	1	eigensinnig
Flucht	NN	1	Flucht
übermorgen	RP	1	übermorgen
schrieben	NN	1	schrieben
Zeichnung	NN	1	Zeichnung
ausgemacht	NN	1	ausgemacht
Verwahrung	NN	1	Verwahrung
Dienstfertigkeit	JJ	1	Dienstfertigkeit
mengen	NN	1	mengen
krepieren	VB	1	krepieren
chose	FW	1	chose
bestrebe	NN	1	bestrebe
allzunachteilig	JJ	1	allzunachteiligen
Stolze	NN	1	Stolze
weicht	NN	1	weicht
marterst	NN	1	marterst
sûr	NNP	1	sûr
Seufzer	NN	1	Seufzer
39	CD	1	39
Meinetwegen	NN	1	Meinetwegen
darneben	RB	1	darneben
gens	NN	1	gens
Ausflüchte	NN	1	Ausflüchte
Treulosen	NN	1	Treulosen
bestehlen	NN	1	bestehlen
Lügen	NN	1	Lügen
wegbleiben	VB	1	wegbleiben
eigennützige	NN	1	eigennützige
confidence	NN	1	confidence
Inwärts	NN	1	Inwärts
Frankreich	NNP	1	Frankreich
erkläret	JJ	1	erkläret
Schnurre	NNP	1	Schnurre
Hut	NN	1	Hut
Oberstlieutenant	NN	1	Oberstlieutenant
lachend	JJ	1	lachend
dauren	VB	1	dauren
Narrn	NN	1	Narrn
Körpers	NN	1	Körpers
alsoen	VB	1	also
begierig	JJ	1	begierig
croyance	NN	1	croyance
heim	RB	1	heim
infame	NN	1	infame
Jammer	NN	1	Jammer
mauen	NN	1	mauen
gemakt	NN	1	gemakt
Nebel	NN	1	Nebel
pontes	NN	1	pontes
ersparte	NN	1	ersparte
neidisch	JJ	1	neidisch
pantomimisch	JJ	1	pantomimisch
Sonst	NN	1	Sonst
est-il	NN	1	est-il
votre	NN	1	votre
Uniform	NN	1	Uniform
Louisdoren	NN	1	Louisdoren
Avancement	NN	1	Avancement
wiederumen	VB	1	wiederum
Schlag	NNP	1	Schlag
heut	RB	1	heut
entladen	VB	1	entladen
liebenswürdig	NN	1	liebenswürdige
Rackers	NNP	1	Rackers
Veränderung	NN	1	Veränderung
plauderst	NN	1	plauderst
andersen	VBN	1	anders
herauswirft	NN	1	herauswirft
Trommel	NNS	1	Trommeln
waret	NN	1	waret
öftrer	NNP	1	öftrer
waren	VB	1	waren
hafte	NN	1	hafte
wirbeln	NN	1	wirbeln
gratuliere	NN	1	gratuliere
klar	JJ	1	klar
Neigung	NN	1	Neigung
vient	NN	1	vient
tief	JJ	1	tief
Rammsdorf	NN	1	Rammsdorf
swansik	NN	1	swansik
Stachel	NN	1	Stachel
rechtschaffner	NN	1	rechtschaffner
Cadet	NN	1	Cadet
betauere	NN	1	betauere
angeredt	NNP	1	angeredt
worin	RB	1	worin
necken	VB	1	necken
sprichst	NN	1	sprichst
hie	RB	1	hier
Krankenbette	NN	1	Krankenbette
Fehlers	NN	1	Fehlers
häufen	VB	1	häufen
scheinet	NN	1	scheinet
1	CD	1	1
wundern	VB	1	wundern
mündlich	JJ	1	mündlich
angewies	JJ	1	angewiesen
geschlagner	NN	1	geschlagner
Belohnung	NN	1	Belohnung
Fragen	NN	1	Fragen
choses	NNP	1	choses
Zeitungen	NN	1	Zeitungen
bedanke	NN	1	bedanke
gekränkten	NN	1	gekränkten
Beute	NN	1	Beute
Ausgelernt	NN	1	Ausgelernt
Car	NN	1	Car
Weigerung	NN	1	Weigerung
schenk	NN	1	schenk
Zunge	NN	1	Zunge
Tölpel	NN	1	Tölpel
sugesetzt	NN	1	sugesetzt
Kriegsdepartement	NN	1	Kriegsdepartement
par-là	NNP	1	par-là
hämisch	VB	1	hämischen
Sak	NN	1	Sak
Katz	NN	1	Katz
Blicken	NN	1	Blicken
durchprügelten	NN	1	durchprügelten
verknüpfen	NN	1	verknüpfen
ungeschliffene	NN	1	ungeschliffene
guignon	NN	1	guignon
abgegangen	NN	1	abgegangen
Generalkriegskasse	NNP	1	Generalkriegskasse
aufgekläret	NN	1	aufgekläret
kommt	JJ	1	kommt
Meinst	NN	1	Meinst
hereinen	VB	1	herein
Nachbar	JJ	1	Nachbar
voulés	NN	1	voulés
Vieh	NN	1	Vieh
verabschiedet	JJ	1	verabschiedeter
bewohnten	NN	1	bewohnten
Katzenbuckel	NN	1	Katzenbuckel
Mildtätigen	NN	1	Mildtätigen
kommend	JJ	1	kommend
befugt	JJ	1	befugt
Zimmers	NN	1	Zimmers
Falschen	NN	1	Falsche
cest	NN	1	cest
eigentlichsten	NN	1	eigentlichsten
zureichen	VB	1	zureichen
gutwilligen	VBN	1	gutwillig
vorschossen	NN	1	vorschossen
Würden	NN	1	Würden
Spandau	NN	1	Spandau
Anfang	NN	1	Anfang
geraten	VBN	1	geraten
Bekannten	NN	1	Bekannten
verächtlich	JJ	1	verächtlichen
arrivir	NN	1	arrivir
Point	NN	1	Point
ziemte	NN	1	ziemte
erfinden	VBN	1	erfunden
entflohen	NN	1	entflohen
belohnt	NN	1	belohnt
ansehend	JJ	1	ansehend
aufzubringen	NN	1	aufzubringen
Ertrotzen	NN	1	Ertrotzen
fürchte	NN	1	fürchte
umständlich	JJ	1	umständlich
herauf	NN	1	herauf
Blinden	NN	1	Blinden
Brieftragens	NN	1	Brieftragens
Vorrecht	NN	1	Vorrecht
suchten	VB	1	suchten
einnehmen	VB	1	einnehmen
Saal	NN	1	Saal
echt	VB	1	echter
wunderlich	JJ	1	wunderlich
Auslegung	NN	1	Auslegung
sonderlich	JJ	1	sonderlich
vertrau	NN	1	vertrau
einzuhändigen	NNP	1	einzuhändigen
bewirbt	NN	1	bewirbt
ehrlik	JJ	1	ehrlike
Leichtgläubiger	NNP	1	Leichtgläubiger
Mutwille	NN	1	Mutwille
Nächte	NN	1	Nächte
connoissés	FW	1	connoissés
Deutsch	NN	1	Deutsch
gehofft	NN	1	gehofft
Betrug	NN	1	Betrug
zugeben	VB	1	zugeben
aufgestanden	NN	1	aufgestanden
übler	NN	1	übler
gegebenes	NN	1	gegebenes
schurkisch	JJ	1	schurkischen
hundsföttsch	JJ	1	hundsföttsche
gefochten	NN	1	gefochten
Forderungen	NN	1	Forderungen
Blatt	NN	1	Blatt
arg	RB	1	arg
verspielen	VB	1	verspielen
wiederkomme	NN	1	wiederkomme
besinnen	VBN	1	besonnen
Begreifst	NN	1	Begreifst
Zorn	NN	1	Zorn
Subordination	NN	1	Subordination
allerschlechtesten	NN	1	allerschlechtesten
Kammerjungfer	NN	1	Kammerjungfer
herabreissen	NN	1	herabreißen
Diamanten	NN	1	Diamanten
melden	VB	1	melden
mis	NNP	1	mis
verschieben	VB	1	verschieben
Unterpfand	NN	1	Unterpfand
Ungnade	NN	1	Ungnade
bemerkte	NN	1	bemerkte
gelegensten	NN	1	gelegensten
verzogener	NNP	1	verzogener
plaudere	NN	1	plaudere
lordinaire	NN	1	lordinaire
Fusssteige	NN	1	Fußsteige
beziehen	VB	1	bezieht
aushalten	NN	1	aushalten
gelegentlich	JJ	1	gelegentlichen
se	NN	1	se
Heut	NN	1	Heut
aufhebt	NN	1	aufhebt
Kostbarers	NN	1	Kostbarers
ankleideten	NN	1	ankleideten
gerichtet	NN	1	gerichtet
Vormittage	NN	1	Vormittage
nien	VBN	1	nie
Bibel	NN	1	Bibel
Fuchtel	NN	1	Fuchtel
stehet	NN	1	stehet
weiten	PRP$	1	weiten
Füss	NNS	1	Füße
Stösst	NN	1	Stößt
Nimmt	NN	1	Nimmt
horchen	VB	1	horchen
Geschäften	NN	1	Geschäften
neugierig	JJ	1	neugierig
Läufers	JJ	1	Läufers
Kauf	NN	1	Kauf
Stiefeln	NN	1	Stiefeln
hernehmen	NN	1	hernehmen
widmen	VBN	1	gewidmet
Provinze	NNS	1	Provinzen
Glanze	NN	1	Glanze
widerwärtige	NN	1	widerwärtige
Grenzen	NN	1	Grenzen
Gebet	NN	1	Gebet
ungemein	NN	1	ungemein
Fröhlichkeit	JJ	1	Fröhlichkeit
verlorne	NN	1	verlorne
gram	JJ	1	gram
Hundert	NN	1	Hundert
stillsten	NN	1	stillsten
stärkste	NN	1	stärkste
Feldscher	NN	1	Feldscher
suchst	NN	1	suchst
wessen	WP	1	wessen
Minist	JJ	1	Minister
hiermit	RB	1	hiermit
schleichen	VBN	1	geschlichen
zerrüttet	NN	1	zerrüttet
wär	JJ	1	wäre
Schmerze	NN	1	Schmerze
Marloffin	NN	1	Marloffin
lui	NNP	1	lui
verhindern	VB	1	verhindern
Gefühl	NN	1	Gefühl
entsprang	NN	1	entsprang
pavé	FW	1	pavé
Swar	PRP$	1	Swar
a.c	FW	1	a.c
seid	NN	1	seid
glücklichen	VB	1	glücklichen
gelauert	NN	1	gelauert
certaines	NN	1	certaines
Kleide	NN	1	Kleide
Gewissens	NN	1	Gewissens
unterkommen	NN	1	unterkommen
Kennen	NN	1	Kennen
tiers	NNP	1	tiers
beschimpft	NN	1	beschimpft
wärs	NN	1	wärs
entbehren	VB	1	entbehren
zumuten	VB	1	zumuten
vergebens	RB	1	vergebens
volles	NN	1	volles
Knecht	NNP	1	Knecht
hefen	VB	1	heften
Heu	NN	1	Heu
liesest	NN	1	liesest
Christ	NNS	1	Christen
umarmend	JJ	1	umarmend
Schnur	NN	1	Schnur
durfte	VB	1	durfte
verschlagen	VB	1	verschlägt
wegfahren	NN	1	wegfahren
heimlich	JJ	1	heimlich
Nichte	NN	1	Nichte
Prozentch	JJ	1	Prozentchen
Eindrücken	NN	1	Eindrücken
kahl	JJ	1	kahl
ängstlich	JJ	1	ängstlich
quil	NN	1	quil
Rechthaber	NN	1	Rechthaber
ausgibt	NN	1	ausgibt
Magen	NN	1	Magen
comprenés	NN	1	comprenés
Gespräch	NN	1	Gespräch
geplündert	NN	1	geplünderten
depend	JJ	1	depend
Generalin	NN	1	Generalin
innerhalb	RP	1	innerhalb
Flasche	NN	1	Flasche
verzehrt	NN	1	verzehrt
Gesandten	NN	1	Gesandten
Sturm	NN	1	Sturm
entschuldiget	NN	1	entschuldiget
umgegangen	NN	1	umgegangen
Mores	NN	1	Mores
General	NN	1	General
chambre	NN	1	chambre
Erbin	NN	1	Erbin
Kompagnie	NN	1	Kompagnie
verbissene	NN	1	verbissene
Küchenzettel	NN	1	Küchenzettel
längst	IN	1	längst
Vorfahren	NN	1	Vorfahren
entdecken	VB	1	entdecken
Gespenst	NN	1	Gespenst
Bedenklichkeien	NN	1	Bedenklichkeit
galant-homme	NN	1	galant-homme
Posten	NN	1	Posten
Mäulern	NN	1	Mäulern
Hochachtung	NN	1	Hochachtung
sächsisch	JJ	1	sächsisches
Eiteln	NN	1	Eiteln
Resource	NN	1	Resource
kriegte	NN	1	kriegte
durchgegangen	NN	1	durchgegangen
boshafter	NN	1	boshafter
beih	DT	1	beiher
Verzweiflung	NN	1	Verzweiflung
Reiz	NNS	1	Reize
sauter	NN	1	sauter
retten	VB	1	retten
Winterquartieren	NN	1	Winterquartieren
beschenken	NN	1	beschenken
Beruhigen	NN	1	Beruhigen
soviel	IN	1	soviel
Vors	NN	1	Vors
Würdigste	NN	1	Würdigste
untersuchen	VBN	1	untersucht
Aufenthalts	NN	1	Aufenthalts
gedacht	VBN	1	gedacht
hülfe	NN	1	hülfe
zurücknehmen	VB	1	zurücknehmen
Stern	NNS	1	Sterne
Übermorgen	NN	1	Übermorgen
setz	NN	1	setz
zulangen	RP	1	zulangt
verscheuchten	NN	1	verscheuchten
Taubenschlage	NN	1	Taubenschlage
Bösewicht	NN	1	Bösewicht
kramen	NN	1	kramen
Lieset	NN	1	Lieset
Freischulzengerichte	NN	1	Freischulzengerichte
martern	NN	1	martern
Vorposten	NN	1	Vorposten
wes	NN	1	wes
vorzuspiegeln	VB	1	vorzuspiegeln
Gilt	NNP	1	Gilt
Glückes	NN	1	Glückes
beschwere	NN	1	beschwere
Stübch	JJ	1	Stübchen
Drum	NN	1	Drum
Karte	NN	1	Karte
Umständen	NN	1	Umständen
schwören	VB	1	schwören
Gabe	NN	1	Gabe
Hässlicher	NN	1	Häßlicher
Unbarmherzige	NN	1	Unbarmherzige
dennoch	RP	1	dennoch
Spötterei	NN	1	Spötterei
starren	PRP$	1	starren
vermutlich	JJ	1	vermutliche
losen	VBN	1	los
höflich	JJ	1	höflichen
schlage	NN	1	schlage
abzählen	NN	1	abzählen
Anverwandte	NN	1	Anverwandte
nächst	JJ	1	nächster
derweile	NN	1	derweile
eintragen	VB	1	eintragen
114	CD	1	114
Voilà	NN	1	Voilà
makte	NN	1	makte
Umarmen	NN	1	Umarmen
Geschick	NNS	1	Geschicke
Livres	NN	1	Livres
prügelte	NN	1	prügelte
vorzuwerfen	VB	1	vorzuwerfen
springt	VB	1	springt
vorfahren	NN	1	vorfahren
avoit	NNP	1	avoit
gleichfalls	RB	1	gleichfalls
Zähnen	NN	1	Zähnen
Rätsel	NN	1	Rätsel
unbekannt	JJ	1	unbekannten
Sehren	RB	1	Sehr
Foderungen	NN	1	Foderungen
vergehen	VBN	1	vergangen
verkehrt	JJ	1	verkehrt
bemühen	VBN	1	bemühet
hieb	NN	1	hieb
lindern	VB	1	lindern
ertappte	NN	1	ertappte
Taschenbuche	NN	1	Taschenbuche
heiligste	NN	1	heiligste
Sommer	NN	1	Sommer
Schöpfer	NN	1	Schöpfer
jammerte	NN	1	jammerte
wanden	VB	1	wandte
Gelder	NN	1	Gelder
merk	NN	1	merk
drein	NN	1	drein
gültig	JJ	1	gültig
Feder	NN	1	Feder
erstaune	NN	1	erstaune
Gläschen	VB	1	Gläschen
Rausch	NN	1	Rausch
hassen	VB	1	hassen
schmeckt	NN	1	schmeckt
Feldflasche	NN	1	Feldflasche
bedankest	NN	1	bedankest
davor	RP	1	davor
Kömmst	NN	1	Kömmst
weggingen	NNP	1	weggingen
klingelt	NN	1	klingelt
Winterquartier	NNP	1	Winterquartier
seit	IN	1	seit
Dauer	NN	1	Dauer
äusserste	NN	1	äußerste
Enterbung	NN	1	Enterbung
zweifeln	VB	1	gezweifelt
Potz	NN	1	Potz
Vorigen	NN	1	Vorigen
revanche	NN	1	revanche
überallhin	NN	1	überallhin
verschlossnen	JJ	1	verschloßnen
beleuchten	VB	1	beleuchten
Ehrenwort	NN	1	Ehrenwort
übergeb	RP	1	übergeben
Lettre	FW	1	Lettre
notwendik	NN	1	notwendik
Haut	NN	1	Haut
seul	NN	1	seul
gebebt	NN	1	gebebt
Briefschaften	NN	1	Briefschaften
gehört	VB	1	gehört
Kugel	NN	1	Kugel
envisager	NNP	1	envisager
versagen	RP	1	versagt
mächtigere	NN	1	mächtigere
Zeile	NN	1	Zeile
hierüber	NN	1	hierüber
Fusse	NN	1	Fuße
erlassen	VBN	1	erlassen
Damien	RB	1	Damit
verirren	VB	1	verirren
Ach	NN	1	Ach
rapportieren	NN	1	rapportieren
Nachbars	NN	1	Nachbars
spiele	NN	1	spiele
Reste	NN	1	Reste
vertreiben	VB	1	vertreiben
monter	NN	1	monter
unverzeihlicher	NN	1	unverzeihlicher
Lust	NN	1	Lust
Ziehen	VB	1	Zieht
venetianisch	JJ	1	venetianische
