Title: Der Freigeist
Number of all lemmas: 7521
Nummber of different lemmas: 2989

Lemma	POS	Frequency	Tokens
Adrast	NN, NNP	117	Adrast
sagen	VB, VBN, RP, RB	87	sagt, gesagt, sagen, sage, sagte
Theophan	NN, JJ, NNP, RP	86	Theophan
wohl	RB, IN, RP	83	wohl
Herr	NN, JJ, NNP	52	Herr
glauben	VB, VBN	51	glauben, geglaubt, glaube, glaubt, glaubte, glaubst
lieb	VB, JJ, NN	48	lieben, lieber, liebe, lieb
sehen	VB, RP, VBN, RB	44	gesehen, sehen, sieht, sah, seht
Juliane	NN, NNP	43	Juliane
weeissen	VB, JJ	38	weiß
eben	RB, VBN, IN, RP, VB	37	eben
gut	RB, JJ, VB	36	gut, gute, guten, guter, gutem
gewiss	JJ, NN	35	gewisse, gewiß, gewissen
Art	NN	33	Art
hören	VB	31	hören, höre, hörst
wissen	VB, RB, VBN	31	wissen
andern	NN, DT, JJ, VB	30	andere, andern
Schwester	NN, JJ	28	Schwester
Mann	NN	28	Mann
Wort	NNS, NN	27	Worte, Wort
Henriette	NN, NNP	25	Henriette
soen	VBN, RB, VB	25	so
Herz	NN, NNS	24	Herz, Herzen
finden	VB, RB, VBN	24	finden, findet, gefunden, fand
Lisette	NN	24	Lisette
nehmen	VB, VBN, RP	24	nehmen, nehme, genommen, nimmt
Freundschaft	NN	24	Freundschaft
Araspe	NN	23	Araspe
Vetter	NN, NNP	23	Vetter
Julianen	NN, JJ	23	Julianen
gar	RP, RB, IN	23	gar
klein	JJ	22	kleiner, kleinen, kleine, kleines, klein
wenig	IN, RB, NNP, RP	22	wenig
reden	VB, VBN	22	reden, redet, rede
erst	VB, JJ, IN, RB, RP	21	erste, ersten, erst, erstes
Recht	NN	21	Recht
Person	NN	20	Person
Ach	NN	20	Ach
sprechen	VB, VBN, RP	19	sprachen, spricht, gesprochen, sprechen, sprach
wahr	RP, JJ	19	wahr, wahre
lieben	VB, NN, JJ, RB	19	lieben, liebe
denken	VB	19	denken, denke, dachte, denkt
allein	RB, RP, WRB, IN	19	allein
Augen	NN	18	Augen
Glück	NN	18	Glück
Welt	NN	18	Welt
bald	RB, RP, IN, WRB	17	bald
ha	NN	17	ha
kömmen	MD	16	kömmt, kömmst
Wahrheit	NN	16	Wahrheit
Liebe	NN	16	Liebe
Seite	NN	15	Seite
Wechsel	NN	15	Wechsel
gross	JJ, RB	15	groß, großen, großer, großes, große
Mühe	NN	15	Mühe
Henrietten	NN	15	Henrietten
weit	JJ, RB	15	weit, weite
seiner	PRP$	15	seiner
stehen	VB	15	stehen, steht, stehe, stand
zwei	CD	15	zwei
Mamsell	NN, JJ	15	Mamsell
willst	WRB, RB, RP	14	willst
vielleicht	RB, IN, RP	14	vielleicht
Lisidor	NN	14	Lisidor
kennen	VB, RB	14	kennen, kennt, kenne
besser	RB, IN, RP, JJ	14	besser, bessere
einander	PRP	14	einander
Teufel	NN	14	Teufel
Mensch	NN	14	Mensch
genug	RB, RP	13	genug
Ha	NN	13	Ha
Rache	NN	12	Rache
Zeit	NN	12	Zeit
lange	RB, IN, RP	12	lange
Martin	NNP	12	Martin
sonst	RB, IN	12	sonst
unmöglich	JJ	12	unmöglich
Religion	NN	12	Religion
rechen	VB	12	recht, rechten
bitten	VB, VBN	11	bitte, bitten, gebeten
nunmehr	RP, RB, IN	11	nunmehr
schönste	NN, NNP, JJ	11	schönste
ehrlich	JJ	11	ehrlicher, ehrliche, ehrlichen
Leute	NN	11	Leute
Nu	NN	11	Nu
Menschen	NN, JJ	11	Menschen
Herrn	JJ, NN	11	Herrn
hast	NN, JJ	11	hast
nennen	VB, VBN	11	nennen, nenne, genannt, nannten, nennst, nennte, nennt
antworen	VB	11	antworten
Gott	NNP, NN	11	Gott
bös	JJ	11	böse
Leben	NN, JJ	11	Leben
Hause	NN	11	Hause
seines	PRP$	11	seines
setzen	VBN, VB	11	gesetzt, setzt, setzen
Freund	NN, NNS	11	Freund, Freunde
stellen	VB, VBN	10	stellen, gestellt, stellte, stellten
verstehen	VB, VBN	10	verstehe, verstanden, verstehen
gehören	VBN, VB	10	gehört, gehöret, gehören, gehöre
Umstand	NNS	10	Umstände
Feind	NNS, NN	10	Feinde, Feind
Seele	NN	10	Seele
zurück	IN, JJ, RP	10	zurück
oft	RB, IN	10	oft
vortrefflich	JJ	10	vortrefflich, vortreffliche
bezahlen	VBN, VB	9	bezahlt, bezahlen
Vergnügen	NN	9	Vergnügen
Absicht	NN, JJ	9	Absicht
Ihrem	NN	9	Ihrem
hoffen	VB, VBN	9	hoffen, hoffe
merken	VB, VBN	9	merke, gemerkt, merken
Atheist	NN	9	Atheist
einzig	JJ	9	einziger, einzigen, einzig, einzige
endlich	RB, IN	9	endlich
Mädchen	NN, NNP	9	Mädchen
suchen	VB, RP, VBN	9	sucht, suchen, gesucht
erfahren	VBN, VB, RP	9	erfahren
Gesichte	NN	9	Gesichte
bloss	RB, JJ, IN	9	bloß, bloße
Reden	NN	9	Reden
Ei	NN	9	Ei
hassen	VB, PRP$	9	hassen, hieß
lass	RB, NN, JJ	9	laß, lasse
wünschen	VB	9	wünschen, wünsche, wünscht
Pst	RB, RP	9	Pst
jemals	RB, IN	8	jemals
neu	JJ	8	neue, neuer, neuen
Zweifel	NN	8	Zweifel
Augenblick	NN, NNP	8	Augenblick
deinen	NN, JJ	8	deinen
wider	IN	8	wider
deswegen	RB, VB	8	deswegen
verliebt	JJ	8	verliebt
Tag	NN	8	Tag
Soen	RB, VBN	8	So
blind	JJ	8	blinden, blind, blinder, blinde
sehe	PRP$	8	sehe
Sache	NN	8	Sache
alsdann	NNP, NN	8	alsdann
lässen	VB	8	läßt
fallen	VB, VBN, RB	8	fallen
jen	DT, WDT	8	jene, jener, jenem, jenen
verlassen	VB	8	verlassen
fällen	VB, RP, VBN	8	fällt, fällen, gefällt
Frauenzimmer	NN	8	Frauenzimmer
gern	RP, RB	8	gern
verbinden	VB, VBN	8	verbunden, verbinden
Schmeichelei	NN, NNP	8	Schmeichelei
Geist	NN	8	Geist
Gewiss	UH	8	Gewiß
wahrhaftig	JJ	7	wahrhaftig
frei	JJ	7	frei
weniger	RB, RP, IN	7	weniger
Blicke	NN, NNP	7	Blicke
weiss	VB	7	weiß
läng	JJ	7	länger
Hand	NN	7	Hand
Dinge	NN	7	Dinge
kurz	JJ, RB	7	kurz
lernen	VBN, VB	7	gelernt, lernen
Munde	NN	7	Munde
Grunde	NN	7	Grunde
Erlauben	NN	7	Erlauben
fragen	RB, VB, RP, VBN	7	fragen, gefragt
Meinung	NNS, NN	7	Meinungen, Meinung
gleichwohl	RB, RP	7	gleichwohl
Exempel	NN	7	Exempel
unser	PRP$	7	unser
erlauben	VB, VBN	7	erlauben, erlaubt
Komm	NN	7	Komm
bekommen	VB, VBN	7	bekommen
heuen	VB, RB	7	heute
Theophans	NN, JJ	7	Theophans
Himmel	NN	7	Himmel
wenigstens	RB, WRB	7	wenigstens
gestehen	VB, RP	7	gestehen, gestanden
eifersüchtig	JJ	7	eifersüchtig
Rede	NN	7	Rede
Esel	NN	7	Esel
Vielleicht	RP, RB	7	Vielleicht
etwa	RP, RB	7	etwa
näh	JJ	7	näher
weg	RB, RP, IN	7	weg
heeissen	VB, VBN, RB	7	heißen, heißt, heiße
nuren	RB, RP, VB	7	nur
seid	NN	7	seid
voraus	JJ, RB, RP	6	voraus
vergessen	VB, VBN	6	vergessen
annehmen	VB, VBN	6	annimmt, angenommen, annehmen
Araspen	NN	6	Araspen
Hülfe	NN	6	Hülfe
Gedanke	NNS	6	Gedanken
Gesinnung	NNS, NN	6	Gesinnungen, Gesinnung
Streich	NN, JJ	6	Streich, Streiche
Vernunft	NN	6	Vernunft
schwach	JJ	6	schwachen, schwach
Schande	NN, NNS	6	Schande, Schanden
Sagen	NN	6	Sagen
Mannspersonen	NN	6	Mannspersonen
führen	VB, VBN	6	führen, führe, geführt
glücklich	JJ	6	glücklich, glücklichen, glückliche
Leuten	NN, NNP	6	Leuten
spielen	VB	6	spielen
Geduld	NN	6	Geduld
ansehen	VBN, VB, PRP$	6	angesehen, ansieht, ansehen
meines	NN	6	meines
nötig	JJ	6	nötig, nötige
stark	JJ	6	starker, stark
breit	JJ	6	breit
Daumen	NN	6	Daumen
treffen	VB	6	treffen, trifft
Unglück	NN	6	Unglück
Hölle	NN	6	Hölle
Mittel	NN	6	Mittel
zwingen	VBN, VB	6	gezwungen, zwingen
richten	VB	6	richten
Gelegenheit	NN	6	Gelegenheit
Gründe	NN	6	Gründe
letzt	JJ	6	letzten, letzte
verlangen	VB	6	verlangen, verlangt, verlangte
Allein	NN	6	Allein
lachen	VB	6	lacht, lache, lachen
heraus	RP, RB	6	heraus
vorhin	RB, RP	6	vorhin
Vertrauen	NN	6	Vertrauen
sollst	RP, WRB, RB	6	sollst
liebt	NNP, NN	6	liebt
Willen	NN, JJ	6	Willen
erstaune	NN	6	erstaune
Anbeter	NN, JJ	6	Anbeter
andre	NN	5	andre
schöne	NN, JJ	5	schöne
Adrasten	NN	5	Adrasten
welch	WDT, WP	5	welches, welche
Gewalt	NN	5	Gewalt
Verbindung	NN	5	Verbindung
vielmehr	RB, RP	5	vielmehr
Verachtung	NN	5	Verachtung
nie	RB	5	nie
jetzo	NN, NNP	5	jetzo
niemals	RB, IN, RP	5	niemals
Tugend	NN	5	Tugend
darausen	RB, VB	5	daraus
weiblich	JJ	5	weiblichen, weibliche
verdienen	VBN, RB, VB	5	verdient
mache	NN	5	mache
Summe	NN, JJ	5	Summe
Ihres	NN	5	Ihres
unsere	PRP$	5	unsere
unsern	PRP$	5	unsern
Sage	NN	5	Sage
Verdacht	NN, NNS	5	Verdacht, Verdachte
Probe	NN	5	Probe
Buch	NN	5	Buch
Sachen	NN	5	Sachen
gehe	NN	5	gehe
fassen	VBN, VB	5	gefaßt, fassen
dazuen	VB	5	dazu
geh	NN	5	geh
Mund	NN	5	Mund
ach	UH	5	ach
dabeien	VB	5	dabei
Ehre	NN	5	Ehre
Stellen	NN	5	Stellen
Verdruss	JJ, NN	5	Verdruß
Stille	NN	5	Stille
übel	JJ	5	übel
Kleinigkeit	NN, JJ	5	Kleinigkeit
Wein	NN, NNS	5	Wein, Weine
drohen	VB	5	drohe, drohen
vollkomm	JJ	5	vollkommen
fromm	JJ	5	fromme, frommen, fromm
weisst	NN	5	weißt
überall	IN, RB	5	überall
Hören	NN	5	Hören
Händen	NN	5	Händen
Freude	NN	5	Freude
Fehler	NN	5	Fehler
dadurch	RB	5	dadurch
habt	NN	5	habt
beweisen	VB, VBN	5	beweisen, bewiesen, beweiset
Namen	NN	5	Namen
künftig	JJ	5	künftiger, künftigen, künftig
Vater	NN	5	Vater
hinter	IN	5	hinter
Gesicht	NN	5	Gesicht
erklären	VB	5	erklären
unschuldigen	PRP$	5	unschuldigen
Begierde	NN	5	Begierde
Nacht	NN	5	Nacht
Hände	NN, JJ	5	Hände
Anmerkung	NN	5	Anmerkung
Kredit	NN	5	Kredit
Verstand	NN	5	Verstand
einerlei	IN, RB	5	einerlei
dasjenig	DT	5	dasjenige
welchem	WP	5	welchem
zufried	JJ	5	zufrieden
Pöbel	NN	5	Pöbel
leben	VB	5	leben, lebt
zeigen	VB, VBN	5	zeigen, zeigt
niemanden	NN, NNP	5	niemanden
gefallen	VB, VBN, RP	5	gefallen
allezeit	RB, IN, NN	5	allezeit
wild	JJ	5	wilde, wilder, wilden, wildes
Zierde	NN	5	Zierde
ziehen	VB	5	ziehen, zieht
Hochachtung	NN	5	Hochachtung
freilich	RB	5	freilich
selb	DT	5	selber
Charakter	NN	4	Charakter
Richter	NN	4	Richter
Lärm	NN	4	Lärm
Miene	NN	4	Miene
überzeugen	VB	4	überzeugt, überzeugen
derjenig	DT	4	derjenigen, derjenige
A	NN	4	A
Aufrichtigkeit	NN	4	Aufrichtigkeit
Gesichter	NN	4	Gesichter
deines	NN, NNP, JJ	4	deines
brauchen	VB	4	brauchen, braucht
gehabt	NN	4	gehabt
ihrem	PRP$	4	ihrem
Erklärung	NN	4	Erklärung
wirst	WRB, RB	4	wirst
sieh	NN	4	sieh
Schwören	NN	4	Schwören
schämen	VB	4	schämen
freuen	VB	4	freuen
grausam	JJ	4	grausames, grausame, grausam
Fromme	NN	4	Fromme
Erlaubnis	NN	4	Erlaubnis
unglücklich	JJ	4	unglücklich, unglückliche, unglückliches
Eigenschaft	NNS	4	Eigenschaften
Ho	NNP, NN	4	Ho
ankömmt	NN	4	ankömmt
leiden	VB	4	leiden
fort	RP	4	fort
nu	UH	4	nu
verlange	NN	4	verlange
Schuldner	NN	4	Schuldner
behaupten	VB	4	behauptet, behaupten
liebern	VB, NN	4	lieber
Pflichten	NN	4	Pflichten
Johann	NNP	4	Johann
beschliessen	VB, RP, VBN	4	beschlossen
davonen	VB	4	davon
Larve	NN	4	Larve
halb	JJ, CD	4	halben, halb
erweisen	VBN, VB	4	erwiesen, erweisen
Wollten	NN	4	Wollten
Ansehen	NN	4	Ansehen
Vorwürfe	NN	4	Vorwürfe
behalten	VB, RP, VBN	4	behalte, behalten
schlecht	JJ	4	schlechte, schlecht
Einfall	NN, NNS	4	Einfall, Einfälle
Weg	NN	4	Weg
betrachten	VBN, VB	4	betrachtet, betrachten
kosen	VB	4	kosten, kostet
unsre	PRP$	4	unsre
Güte	NN	4	Güte
Büchern	NN	4	Büchern
Lustige	NN	4	Lustige
Spitzbube	NN	4	Spitzbube
begegnen	VB	4	begegnet, begegnen
hieher	NN	4	hieher
entgegen	RP, IN	4	entgegen
Ermahnung	NN	4	Ermahnung
empfinden	VBN, VB	4	empfunden, empfinden
Schönheit	NN	4	Schönheit
erinnern	VB	4	erinnern, erinnere
Wissen	NN	4	Wissen
alt	JJ	4	alter, alte, alten
liebste	NN, NNP	4	liebste
laut	JJ	4	lauter, laut
verlieren	VB	4	verlieren
Hast	NN	4	Hast
nimmermehr	NN	4	nimmermehr
Dingen	NN	4	Dingen
ruhig	JJ	4	ruhige, ruhig
Ursache	NN	4	Ursache
Vollkommenheiten	NN	4	Vollkommenheiten
Streitigkeit	NN	4	Streitigkeit
Töchter	NN	4	Töchter
unserer	PRP$	4	unserer
Stande	NN	4	Stande
Einbildungen	NN	4	Einbildungen
dumm	JJ	4	dumm, dummer, dummen
fähig	JJ	4	fähig
klug	JJ	4	klug
finde	NN	4	finde
weder	CC, RB	4	weder
Natur	NN	4	Natur
abern	JJ, VBN, RB	4	aber
fühlen	VB	4	fühlte, fühle, fühlen
gelingen	PRP$, VB	4	gelingen
Lass	NN	4	Laß
Herren	NN, NNP	4	Herren
derselben	NN	4	derselben
Lobrede	NN	4	Lobrede
anhören	VB	4	anhören
Pflicht	NN	4	Pflicht
Wohl	RB, IN	4	Wohl
Gut	NN, VB	4	Gut, Gute
Hochzeit	NN, JJ	4	Hochzeit
schmeicheln	VB	4	schmeicheln
zwischen	IN	4	zwischen
klar	JJ	4	klarer, klar
fröhlich	JJ	4	fröhlichen, fröhliche
Kompliment	NN	4	Kompliment
heilig	JJ	4	heilige, heilig, heiligen
verächtlich	JJ	4	verächtlich
Paar	NN	4	Paar
umsonst	RB, JJ, RP	4	umsonst
eingebildet	NN	4	eingebildet
Wolle	NNS	4	Wollen
schöner	NN	4	schöner
bessern	VB, PRP$	4	bessern, besser
spotten	VB	4	spotten
Schwierigkeit	NN	4	Schwierigkeit
überlegen	VB	4	überlegen
morgen	VBN, RB	4	morgen
längst	RB, RP, IN	4	längst
ists	NN	4	ists
unterbrechen	VB	4	unterbrechen
erkennen	VB	4	erkennen
hasse	NNP	4	hasse
ho	NN	4	ho
anfange	NN	4	anfange
seit	IN	4	seit
Lust	NN	4	Lust
Indemen	RB	3	Indem
Sprache	NN	3	Sprache
pflegen	VB	3	pflegt, pflegen
Misstrauen	NN	3	Mißtrauen
schiehen	VB	3	geschieht
spät	RB, JJ	3	spät
Taten	NN	3	Taten
versprechen	VBN, VB	3	versprochen, versprechen
Winkel	NN	3	Winkel
scheine	NN	3	scheine
höchste	NN	3	höchste
Weise	NN	3	Weise
Bäcker	NN	3	Bäcker
deinem	NN	3	deinem
geschehen	VB, VBN, RP	3	geschehen
Verzeihen	NN	3	Verzeihen
überladen	NN, JJ	3	überladen
daraufen	VB, RB	3	darauf
unterscheiden	VB	3	unterscheiden, unterschieden
Worten	NN	3	Worten
deutsch	JJ	3	deutsch
Gang	NN	3	Gang
entschuldigen	VB	3	entschuldigen
angenehm	JJ	3	angenehme, angenehm
Empfindung	NNS, NN	3	Empfindungen, Empfindung
Tochter	NN, JJ	3	Tochter
besen	VB	3	beste, besten
best	JJ	3	beste, besten
irr	JJ	3	irre
Überzeugung	NN	3	Überzeugung
Schweig	JJ	3	Schweig
Grund	NN	3	Grund
mehren	VBN	3	mehr
Verstandes	NN	3	Verstandes
Sieh	NN	3	Sieh
legen	VBN, VB	3	gelegt, legen
wärest	WRB, RB, RP	3	wärest
Beweis	NN, NNS	3	Beweis, Beweise
gewinnen	VB	3	gewinnen
jaten	RP, RB, VB	3	ja
gönnen	VB	3	gönnen
widerfahren	NN	3	widerfahren
Punkt	NN	3	Punkt
stecken	VB	3	stecken
Fuss	NN	3	Fuß
nunen	RB	3	nun
aufnehmen	VB	3	aufnimmt, aufnehmen
Geständnis	NN	3	Geständnis
Stücken	NN	3	Stücken
Erstaunen	NN	3	Erstaunen
fehlen	VB	3	fehlt, fehlte
Eben	NN	3	Eben
Ding	NN	3	Ding
handeln	VB	3	handeln
Falschheit	NN	3	Falschheit
Grossmut	NN	3	Großmut
Schwachheiten	NN	3	Schwachheiten
Schluss	NN	3	Schluß
Tat	NN	3	Tat
streng	JJ	3	strenge
Vermögen	NN	3	Vermögen
Lachen	NN	3	Lachen
vorsichtig	JJ	3	vorsichtig
vermehren	VB	3	vermehren
Freundlichkeit	NN	3	Freundlichkeit
beurteilen	VB	3	beurteilen
Begriffen	NN	3	Begriffen
Gliedern	NN	3	Gliedern
Lisidors	NN	3	Lisidors
Mamsells	RP, RB	3	Mamsells
menschlich	JJ	3	menschlichen, menschliche
fasen	VB, VBN	3	fast
Begreifen	VB, VBN	3	Begriffe
Gerechtigkeit	NN	3	Gerechtigkeit
List	NN	3	List
ähnlich	JJ	3	ähnlicher, ähnlichen
Ihrige	NN	3	Ihrige
ewig	JJ	3	ewig
Kurz	NN	3	Kurz
wert	RB, JJ	3	wert
sau	JJ	3	sauer
Bitte	NN	3	Bitte
Lernen	NN	3	Lernen
Wohltaten	NN	3	Wohltaten
liebster	NN	3	liebster
Mädel	NN	3	Mädel
tue	NN	3	tue
Glücke	NN	3	Glücke
Wahrheiten	NN	3	Wahrheiten
Nunmehr	NN	3	Nunmehr
rächen	VB	3	rächen
falsch	JJ	3	falsche, falschen
herum	IN	3	herum
eig	JJ	3	eigen
zugleich	IN, RB	3	zugleich
Ungeheuer	NN	3	Ungeheuer
seufzen	RP, VB	3	geseufzt, seufzen
wessen	WP	3	wessen
Frömmigkeit	NN	3	Frömmigkeit
vernünftiges	NN	3	vernünftiges
Geister	NN	3	Geister
erzeigen	NN	3	erzeigen
tausendmal	RB, IN	3	tausendmal
fein	JJ	3	feine, fein
Neigung	NN	3	Neigung
ehe	CC	3	ehe
zanken	NN	3	zanken
schätzen	VBN, VB	3	geschätzt, schätzen
verrät	NN	3	verrät
gibts	NN	3	gibts
heftig	JJ	3	heftig, heftigen
notwendig	JJ	3	notwendigen, notwendig
empfindlich	JJ	3	empfindlicher, empfindlich
diejenig	DT, WDT, JJ	3	diejenigen, diejenige
ersparen	VB	3	ersparen
Liebhaber	NN	3	Liebhaber
Türe	NN	3	Türe
Körper	NN	3	Körper
Bezahlung	NN	3	Bezahlung
aufs	NN	3	aufs
darum	RB	3	darum
grösst	JJ	3	größte
gegenwärtig	RB, JJ	3	gegenwärtig, gegenwärtige
edel	JJ	3	edel
Viert	JJ	3	Vierten
ablegen	VB, VBN	3	ablegen, abgelegt
Bedenklichkeiten	NN	3	Bedenklichkeiten
deutlich	JJ	3	deutlich
Schlingel	NNP, NN	3	Schlingel
bestimmen	VB, VBN	3	bestimmte, bestimmt
Tausch	JJ, NN	3	Tausche, Tausch
Anblick	NN, NNS	3	Anblick, Anblicke
tausend	CD	3	tausend
Rat	NN	3	Rat
Schritt	NN	3	Schritt
irren	VB	3	irren
Kanne	NN	3	Kanne
Atomis	NN	3	Atomis
getrost	NN	3	getrost
Henriettens	NN, JJ	3	Henriettens
eignen	VB	3	eignen
Dank	IN	3	Dank
zusammen	RP, RB	3	zusammen
durchaus	RB	3	durchaus
Umsonst	NN	3	Umsonst
Heirat	NN	3	Heirat
näher	JJ	3	nähere
bekomme	NN	3	bekomme
eingenommen	NN	3	eingenommen
Bitterkeit	NN	3	Bitterkeit
recht	NN, RB	3	recht
Manne	NN	3	Manne
ungewiss	JJ	3	ungewiß
Dienst	NN	3	Dienst
danke	RP, IN	3	danke
schlimm	NN, JJ	3	schlimmer, schlimm, schlimme
seinetwegen	NN	3	seinetwegen
Seit	IN	3	Seit
meinetwegen	IN, RB	3	meinetwegen
Papa	NN	3	Papa
darinen	VB	3	darin
erteilen	VB	3	erteilen, erteilt
Schurke	NN	3	Schurke
verfallen	VB	3	verfallen
werfen	VB	3	werfen, wirft
Siehst	NN	3	Siehst
rauben	VB, VBN	3	rauben, geraubt
Weib	NN	3	Weib
Ruhm	NN	3	Ruhm
beliebt	JJ	3	beliebt
Streichen	VB	3	Streiche, Streichen
Aberglauben	NN	3	Aberglauben
gütig	JJ	3	gütig
Seeln	VB	3	Seelen
schön	JJ	3	schön
treffe	NN	3	treffe
danken	VB, PRP$	3	danken
Beleidigungen	NN	3	Beleidigungen
dochen	VB	3	doch
Notwendigkeit	NN	3	Notwendigkeit
Teil	NN	3	Teil
auszudrücken	NN	3	auszudrücken
gedenken	VB, VBN	3	gedenken, gedacht
dahin	RB	3	dahin
einbilden	NN	3	einbilden
äussern	VB, VBN	3	äußern, geäußert
fangen	VB	3	fängt, fange, fangen
verdriesslich	JJ	3	verdrießlich, verdrießlichen
verlor	JJ	3	verloren
dawider	RB	3	dawider
Stelle	NN	3	Stelle
Vettern	NN	3	Vettern
Kennen	NN	3	Kennen
scherzen	VB	3	scherzen
Überlegung	NN	3	Überlegung
Versicherungen	NN	3	Versicherungen
Geiste	NNP, NN	3	Geiste
Entfernung	NN	3	Entfernung
Schwager	NN	3	Schwager
Welch	JJ, NN	3	Welcher, Welch, Welches
Umständen	NN	3	Umständen
Hassen	NN, RB	3	Hassen
Spöttereien	NN	3	Spöttereien
Personen	NN	3	Personen
oben	IN, RB	3	oben
geringsten	NN	3	geringsten
eins	CD	3	eins
Geliebte	NN	3	Geliebte
drein	NN	3	drein
erstaunt	NN	3	erstaunt
übrig	JJ	3	übrigen, übrig
ins	IN	3	ins
fest	JJ, RB	3	fest
Verstande	NN	3	Verstande
wären	RB, VB	2	wären
würde	RB	2	würde
Tausend	NN	2	Tausend
Grundsätzen	NN	2	Grundsätzen
Aberglaubens	NN	2	Aberglaubens
Bürgschaft	NN	2	Bürgschaft
Ehe	NN	2	Ehe
Wörtchen	NN	2	Wörtchen
versprach	NN	2	versprach
verfolgen	RB, VB	2	verfolgt
angefangen	NN	2	angefangen
allzuwohl	CC	2	allzuwohl
liebenswürdige	NN	2	liebenswürdige
darübern	VB	2	darüber
reichen	PRP$, VB	2	reichen, reicht
anzusehen	VB	2	anzusehen
hieren	VBN, RB	2	hier
vorzuschreiben	VB	2	vorzuschreiben
sicher	RB	2	sicher
zuwider	NN	2	zuwider
Stube	NN	2	Stube
gewaltig	JJ	2	gewaltig
springen	VB	2	springen, springe
Würde	NN	2	Würde
hundert	CD	2	hundert
Gegenstand	NN	2	Gegenstand
schwesterlich	JJ	2	schwesterliche
gebietet	NN	2	gebietet
vorigen	NN, JJ	2	vorigen
bösen	NN	2	bösen
stössen	VB	2	stößt
eigen	JJ	2	eigenen
Gestalt	NN	2	Gestalt
gönne	NN	2	gönne
Anverwandten	NN	2	Anverwandten
anlegen	VBN, VB	2	angelegt, anlegen
geweissen	VB	2	gewiß
Brüdern	NN	2	Brüdern
schweig	JJ	2	schweig
Widerspruch	NN	2	Widerspruch
durchgebracht	NN	2	durchgebracht
Horn	NNS	2	Hörner
bewogen	NN	2	bewogen
mürrisch	JJ	2	mürrisches, mürrischen
Freigeisterei	NN	2	Freigeisterei
raten	VB	2	raten
Herzens	NN	2	Herzens
Mannes	NN	2	Mannes
herkommen	VB	2	herkommen
Bedienten	NN	2	Bedienten
albern	JJ	2	albern
nahe	IN	2	nahe
Grossmama	NN	2	Großmama
vorzustellen	VB	2	vorzustellen
eile	NN	2	eile
Unmöglichkeit	NN	2	Unmöglichkeit
Anschlag	NN	2	Anschlag
balden	RB, VBN	2	bald
herauskommen	VB	2	herauskommen
Gegenteil	NN	2	Gegenteil
anderm	NN	2	anderm
verteidiget	NN	2	verteidiget
de	FW	2	de
gehn	NN	2	gehn
Freilich	JJ	2	Freilich
Mademoisell	NN	2	Mademoisell
Zins	NNS	2	Zinsen
abbrechen	VB, JJ	2	abbrechen, abgebrochen
Zeug	NN	2	Zeug
machst	WRB	2	machst
schreiben	VB	2	schreiben
versuchen	VB	2	versuchen
gelass	JJ	2	gelassen
Überlegungen	NN	2	Überlegungen
erhalten	VB	2	erhalten, erhält
enthalten	VB	2	enthalten, enthält
brav	JJ	2	brave, braver
elenden	NN	2	elenden
Wendung	NN	2	Wendung
Eifersucht	NN	2	Eifersucht
wohlen	VB	2	wohl
Platze	NN	2	Platze
erkenne	NN	2	erkenne
freundlich	JJ	2	freundlichen, freundlich
Lobrednerin	NN	2	Lobrednerin
Vorurteil	NN, NNS	2	Vorurteil, Vorurteile
Trinken	NN	2	Trinken
Krankheit	NN	2	Krankheit
erzählen	VB	2	erzählen
brenne	NN	2	brenne
zuschwören	NN	2	zuschwören
ausser	IN	2	außer
ankommen	VBN, VB	2	ankommen
Unternehmen	NN	2	Unternehmen
Adrasts	NNP, NN	2	Adrasts
Verwandtschaft	NN	2	Verwandtschaft
Narren	NN	2	Narren
Betrachtung	NN	2	Betrachtung
ihres	PRP$	2	ihres
ohngefähr	NN	2	ohngefähr
Wollte	NN	2	Wollte
schämt	NN	2	schämt
Lächeln	NN	2	Lächeln
Leidenschaft	NNS	2	Leidenschaften
hierher	RB, RP	2	hierher
Proselyten	NN	2	Proselyten
Julch	JJ, VB	2	Julchen
männlich	JJ	2	männliche
bereit	RP	2	bereit
ersetzen	VB	2	ersetzen
Versprechen	NN	2	Versprechen
Grad	NN	2	Grad
jemand	DT	2	jemand
Nachsicht	NN	2	Nachsicht
missbrauchen	VB	2	mißbrauchen
Beste	NN	2	Beste
Billigkeit	NN	2	Billigkeit
beizubringen	NN	2	beizubringen
überwinden	VBN	2	überwunden
liesse	NN	2	ließe
schweigen	VB	2	schweigen
artige	NN, JJ	2	artige
geschwind	RB, RP	2	geschwind
schönsten	NN	2	schönsten
gelangen	VB, VBN	2	gelangen, gelangt
entfallen	VB	2	entfielen, entfallen
Verstellung	NN	2	Verstellung
scharf	JJ	2	scharf, scharfe
Wid	JJ	2	Wider
nachsagen	NN	2	nachsagen
entdeckt	NN	2	entdeckt
Juchhei	NN	2	Juchhei
entzücken	NN	2	entzücken
schwerlich	JJ	2	schwerlich
gestraft	NN	2	gestraft
sogar	IN, RB	2	sogar
schrecklich	JJ	2	schreckliches, schrecklich
Unrecht	JJ, NN	2	Unrecht
Verächter	NN	2	Verächter
Wahrhaftig	JJ, RB	2	Wahrhaftig
Ihret	NN	2	Ihret
Französisch	NN	2	Französisch
Zwei	CD	2	Zwei
Sehen	NN, VBN	2	Sehen, Seht
würdigen	VB, PRP$	2	würdigen
Wirkung	NN	2	Wirkung
neugierig	JJ	2	neugierig
bestreben	VB	2	bestreben
Fremden	NN	2	Fremden
Narre	NN	2	Narre
stolz	JJ	2	stolz
Vieh	NN	2	Vieh
Gesellschaft	NN	2	Gesellschaft
Stärke	NN	2	Stärke
richtigen	VBN	2	richtig
still	JJ	2	still, stille
Geistlichen	VB	2	Geistlichen
ehrwürdige	NN	2	ehrwürdige
reeissen	VB	2	reißt, reißen
rieche	NN	2	rieche
drücken	VB	2	gedrückt, drücken
Ordnung	NN	2	Ordnung
Abschied	NN	2	Abschied
liebte	NN	2	liebte
Keines	NN	2	Keines
Dummkopf	NN	2	Dummkopf
zweit	JJ	2	zweiten, zweite
Keinen	NN	2	Keinen
umsehen	VB	2	umsieht
Stellung	NN	2	Stellung
schlagen	VB	2	schlagen
Ränke	NN	2	Ränke
bemerken	VBN	2	bemerkt
Auge	NN	2	Auge
Stehen	NN	2	Stehen
verwirrt	JJ	2	verwirrt
Erklären	VB, NN	2	Erkläre, Erklären
Halt	NNS, NN	2	Halte, Halt
Bescheidenheit	NN	2	Bescheidenheit
abzulegen	VB	2	abzulegen
Sonderbar	JJ, VB	2	Sonderbare
gekannt	NN	2	gekannt
Kerl	NN	2	Kerl
erregen	RP, VBN	2	erregt
manch	JJ, DT	2	manche, manches
Wohin	NN	2	Wohin
vielweniger	NNP	2	vielweniger
bekümmern	JJ, NN	2	bekümmern
verachten	VB	2	verachten
Heuchler	NN	2	Heuchler
verachtet	NN, JJ	2	verachtet, verachteten
vergess	VB, VBN	2	vergessen
schickte	NN	2	schickte
fremden	PRP$	2	fremden
Ecke	NN	2	Ecke
Wert	NN	2	Wert
denselb	DT	2	denselben
aufsuchen	VB	2	aufsuchen
Werk	NN	2	Werk
bezahle	NN	2	bezahle
gehörig	JJ	2	gehörige
wohlweiser	NN	2	wohlweiser
Armut	NN	2	Armut
Verteidiger	NN	2	Verteidiger
Kannst	NN	2	Kannst
Unmöglich	JJ	2	Unmögliche, Unmögliches
Unterdessen	NN	2	Unterdessen
glaube	VB	2	glaube
Anstiften	NN	2	Anstiften
krank	JJ	2	krank
Liebst	JJ	2	Liebster
Fuchs	NN	2	Fuchs
Verteidigung	NN	2	Verteidigung
niederträchtigen	NN	2	niederträchtigen
Kömmt	NN	2	Kömmt
entstehen	VB, RB	2	entstehen
Abend	NN	2	Abend
ungerecht	JJ	2	ungerecht
Geistes	NN	2	Geistes
Geschäfte	NN	2	Geschäfte
Falle	NN	2	Falle
kennet	NN	2	kennet
verachte	NN	2	verachte
Knieen	NN	2	Knieen
garen	RB, RP	2	gar
Kinder	NN	2	Kinder
zittern	VB, VBN	2	zittern, gezittert
destoweniger	NNP	2	destoweniger
Beschaffenheit	NN	2	Beschaffenheit
liegend	JJ	2	liegende
Übereinstimmung	NN	2	Übereinstimmung
nötigen	PRP$, VBN	2	nötigen, nötig
gebrauchen	VB	2	gebrauchen
Gutes	NN	2	Gutes
langsam	JJ	2	langsam
euer	PRP$	2	euer
fodern	NN	2	fodern
schönen	JJ, PRP$	2	schön, schönen
Füss	NNS	2	Füße
beibehalten	VB	2	beibehalten
jenes	NN	2	jenes
pfui	UH	2	pfui
sagst	NN	2	sagst
Spiel	NN	2	Spiel
anzuhören	VB	2	anzuhören
Gründlichkeit	NN	2	Gründlichkeit
Freigeistes	NN	2	Freigeistes
lach	NN	2	lach
Pünktch	JJ	2	Pünktchen
leichtsinniger	NNP	2	leichtsinniger
redlich	JJ	2	redlichen, redlich
dienen	VB	2	dienen
müsste	VB	2	müßte
wohin	WRB, RP	2	wohin
billig	JJ	2	billig
vorhinen	VB	2	vorhin
begleiten	VB	2	begleiten
hervor	RB, JJ	2	hervor
viere	NN	2	viere
Freimütigkeit	NN	2	Freimütigkeit
armseligen	NN	2	armseligen
lustig	JJ	2	lustig
gewachsen	NN	2	gewachsen
Wut	NN	2	Wut
besitzen	VB	2	besitzen
eilen	VB	2	eilen
gernen	RB, VB	2	gerne
Lebens	NN	2	Lebens
Gewissen	NN	2	Gewissen
St	PRP$	2	St
halte	NN	2	halte
Lauterkeit	NN	2	Lauterkeit
herunter	RP	2	herunter
Bedacht	NN	2	Bedacht
betauren	NN	2	betauren
Augenblicke	NN	2	Augenblicke
widersprechen	VB	2	widersprechen
Knoten	NN	2	Knoten
rasend	JJ	2	rasend
übergehen	VBN, RP	2	übergangen
Ernste	NN	2	Ernste
zehnmal	IN, RB	2	zehnmal
Schwesterchen	NN	2	Schwesterchen
Schwiegersöhne	NN	2	Schwiegersöhne
Grossmutter	NN	2	Großmutter
heiraten	VB	2	heiraten
gleichsam	RB, RP	2	gleichsam
Wechsler	NN	2	Wechsler
Ordens	NN	2	Ordens
entfernt	JJ	2	entfernt
würden	RB	2	würden
Julianens	NN	2	Julianens
Vaters	NN	2	Vaters
Kopfe	NN	2	Kopfe
dirs	NN	2	dirs
Muster	NN	2	Muster
kriegen	VBN, VB	2	gekriegt, kriegen
geringste	NN	2	geringste
Unterscheid	NN	2	Unterscheid
unruhig	JJ	2	unruhig, unruhiger
Haar	NN, NNS	2	Haar, Haare
irret	NN	2	irret
erbarmte	NN	2	erbarmte
Überladung	NN	2	Überladung
Henker	NN	2	Henker
Handel	NN	2	Handel
wofür	WRB	2	wofür
Verliebten	NN, NNP	2	Verliebten
aufdringen	NN	2	aufdringen
Feiertag	NN	2	Feiertag
Fast	NN	2	Fast
überreden	VB	2	überreden
urteilen	VB	2	urteilen
Wege	NN	2	Wege
unterdrücken	VB	2	unterdrücken
Gründen	NN	2	Gründen
sprachst	RB	2	sprachst
lehren	VB	2	lehren
Freiheit	NN	2	Freiheit
gewusst	NN	2	gewußt
leugnen	VBN, VB	2	geleugnet, leugnen
einmalten	JJ, VB	2	einmal
musst	VB	2	mußt
Harmonie	NN	2	Harmonie
scheinet	NN	2	scheinet
treiben	VB	2	treiben
Geschlechts	NN	2	Geschlechts
Mama	NN	2	Mama
arm	JJ	2	armen, armer
Kind	NN, NNP	2	Kind
Stolze	NN	2	Stolze
gewisses	NN	2	gewisses
Fall	NN	2	Fall
Jungfer	NN	2	Jungfer
Irrtum	NN	2	Irrtum
nähern	PRP$	2	nähern
Gegenwart	NN	2	Gegenwart
sicherer	NN	2	sicherer
fortgehen	NN	2	fortgehen
gesetzte	NN	2	gesetzte
räche	NN	2	räche
Entdeckung	NN	2	Entdeckung
Versuch	NN	2	Versuch
Schwestern	NN	2	Schwestern
Liebhaberin	NN	2	Liebhaberin
nachhängen	NN	2	nachhängen
beschäftigen	VB, VBN	2	beschäftiget, beschäftigten
ansiehst	NN	2	ansiehst
erschaffen	VB	2	erschaffen
aufwachsen	NN	2	aufwachsen
vermuten	PRP$, VB	2	vermuten
Last	FW	2	Last
Heftigkeit	NN	2	Heftigkeit
Zufall	NN	2	Zufall
Nehmen	VB	2	Nehmen
Schade	NN	2	Schade
Szene	NN	2	Szene
Geschwätze	NN	2	Geschwätze
Tugenden	NN	2	Tugenden
Gefallen	NN	2	Gefallen
ausdrücklich	RB	2	ausdrücklich
verleugnen	NN	2	verleugnen
gehorsam	JJ	2	gehorsam
Schicksal	NN	2	Schicksal
fast	VB, JJ	2	fast
betrogen	NN	2	betrogen
sähe	NN	2	sähe
helfen	VB	2	helfen, hilft
Betragen	NN	2	Betragen
leicht	JJ	2	leicht
Unterschrift	NN	2	Unterschrift
aussetzen	RP, VBN	2	ausgesetzt
kürzer	NN	2	kürzer
wozu	WRB	2	wozu
sucht	VB	2	sucht
tauscht	NN	2	tauscht
holen	VB	2	hole, holen
verwirren	VB	2	verwirren
liebten	NN	2	liebten
dadurchen	VB	2	dadurch
aufgeräumt	NN	2	aufgeräumt
lenken	VB	2	lenken
Holland	NNP	2	Holland
Natürlichste	NN	2	Natürlichste
suche	NN	2	suche
neigen	VB	2	neigen
Triumph	NN	2	Triumph
behorchen	VB	2	behorchen
reich	JJ	2	reich
grossmütig	JJ	2	großmütig
Vorsatz	NN	2	Vorsatz
möglichstes	NN	2	möglichstes
Bedenken	NN	2	Bedenken
kannst	JJ	2	kannst
Alles	NN	2	Alles
Frankreich	NNP	2	Frankreich
befehlen	VBN, VB	2	befohlen, befehlen
Geringste	NN	2	Geringste
Land	NN	2	Land
zureden	NN	2	zureden
genassen	VB	2	genießen
begreifen	VBN	2	begriffen
dafüren	VB	2	dafür
wette	NN	2	wette
darumen	RB, VB	2	darum
nochen	VBN	2	noch
sprichst	NN	2	sprichst
hie	JJ, RB	2	hier
Folge	NN	2	Folge
umgehen	VB	2	umgehen
spöttisch	JJ	2	spöttischen, spöttisch
siehst	NN	2	siehst
demselben	NN	2	demselben
unsrigen	PRP$	2	unsrigen
gutes	NN	2	gutes
beruhigen	VB	2	beruhigen
werdet	NN	2	werdet
Philosoph	NN	2	Philosoph
geheim	JJ	2	geheim
kaum	IN, RB	2	kaum
hinderlich	JJ	2	hinderlich
Bestimmung	NN	2	Bestimmung
starken	NN	2	starken
wunderlich	JJ	2	wunderlich, wunderliches
hässlich	JJ	2	häßlich, häßlichen
Frau	NN	2	Frau
lebendig	JJ	2	lebendig
hättest	IN, WRB	2	hättest
Glas	NN	2	Glas
solle	NN	2	solle
Überlegen	NN	2	Überlegen
geleg	JJ	2	gelegen
Aufzuges	NN	2	Aufzuges
Werkzeug	NNS, NN	2	Werkzeuge, Werkzeug
vorstellen	VB	2	vorstellen
unwürdig	JJ	2	unwürdig
Nachttisch	VB, JJ	2	Nachttische, Nachttischen
ichs	NN	2	ichs
Schelm	NN	2	Schelm
ganzes	NN	2	ganzes
wichtig	JJ	2	wichtigen, wichtige
schärfer	NN	2	schärfer
auseinander	IN, RP	2	auseinander
Irrtümer	NN	2	Irrtümer
Höre	NN	2	Höre
besinnen	VB	2	besinnen
gebe	NN	2	gebe
entziehen	PRP$, VB	2	entziehen
Bürgschaften	NN	2	Bürgschaften
entdecken	VB	2	entdecken
Schwäger	NN	2	Schwäger
Verzweiflung	NN	2	Verzweiflung
Zunge	NN	2	Zunge
Wohltat	NN	2	Wohltat
gleichgültig	JJ	2	gleichgültig
überwerfen	NN	2	überwerfen
Schwiegervater	NN	2	Schwiegervater
England	NNP	2	England
Spötterei	NN	2	Spötterei
höflich	JJ	2	höflich, höfliche
verkennen	PRP$, VB	2	verkennen
nächst	JJ	2	nächsten, nächster
Geld	NN	2	Geld
Maul	NN	2	Maul
langen	VB, VBN	2	langt, lange
Segen	NN	2	Segen
Bald	NN	2	Bald
Vorzüge	NN	2	Vorzüge
schmeckt	NN	2	schmeckt
zeitig	JJ	2	zeitig
Blick	NN	2	Blick
treten	VB	2	treten
Nachricht	NN	2	Nachricht
Alsdann	NNP, NN	2	Alsdann
Fusse	NN	2	Fuße
spielt	NN	2	spielt
schäme	NN	2	schäme
alleinen	VB, RB	2	allein
ehrbares	NNP	1	ehrbares
fragst	NN	1	fragst
verhungert	NN	1	verhungert
Abgeborgen	VBN	1	Abgeborgt
wäret	NN	1	wäret
lassende	NN	1	lassende
steigen	VBN	1	steigen
verdross	NN	1	verdroß
ausgesproch	JJ	1	ausgesprochen
reissen	VBN	1	gerissen
könnt	VB	1	könnten
Schlosse	NN	1	Schlosse
niederträchtig	JJ	1	niederträchtig
hinterbracht	NN	1	hinterbracht
vorgefassten	NN	1	vorgefaßten
Schimpfworts	NN	1	Schimpfworts
staubigten	NN	1	staubigten
Schimpfworte	NN	1	Schimpfworte
träumen	VB	1	träumen
Denkungsart	NNP	1	Denkungsart
herumschweifen	NN	1	herumschweifen
Umgang	NN	1	Umgang
Tue	NN	1	Tue
leichte	NN	1	leichte
zuletzt	RB	1	zuletzt
Ärmel	NN	1	Ärmel
dennen	RB	1	denn
mehrern	NN	1	mehrere
Kapitel	NN	1	Kapitel
unwissenden	JJ	1	unwissenden
zurücke	NN	1	zurücke
Flattergeist	NNP	1	Flattergeist
riechst	NN	1	riechst
verwahren	NN	1	verwahren
Überfluss	NN	1	Überfluß
edlere	NN	1	edlere
rechtschaff	JJ	1	rechtschaffen
Urheber	NN	1	Urheber
Stecken	NN	1	Stecken
Sprunge	NN	1	Sprunge
Zeugen	NN	1	Zeugen
ungefähr	RB	1	ungefähr
liebenswürdig	JJ	1	liebenswürdig
Anerbietens	NN	1	Anerbietens
Vorteil	NN	1	Vorteil
Mangel	NN	1	Mangel
mitleidiges	NN	1	mitleidiges
ungezwungene	NN	1	ungezwungene
desselben	NN	1	desselben
Gefälligkeit	NN	1	Gefälligkeit
Priestern	NN	1	Priestern
Satan	NNP	1	Satan
bedächtig	JJ	1	bedächtig
grossmütiger	NN	1	großmütiger
Schön	NN	1	Schön
Acht	NN	1	Acht
Erziehung	NN	1	Erziehung
Licht	NN	1	Licht
vermögen	VB	1	vermögen
Aufopferung	NN	1	Aufopferung
los	RP	1	los
beleidigend	JJ	1	beleidigende
nichtswürdig	JJ	1	nichtswürdig
ausschreien	NN	1	ausschreien
Deutschland	NNP	1	Deutschland
herabstürzen	NN	1	herabstürzen
bringe	VB	1	bringe
hintergehen	VB	1	hintergehen
Grade	NN	1	Grade
verliessen	NN	1	verließen
garstige	NN	1	garstige
Le	NN	1	Le
unmenschlicher	NN	1	unmenschlicher
ficht	JJ	1	ficht
Uneigennützigkeit	NN	1	Uneigennützigkeit
anstehen	NN	1	anstehen
Hübsch	NN	1	Hübsch
Sähe	NN	1	Sähe
niemand	DT	1	niemand
nachteilig	JJ	1	nachteilige
eng	JJ	1	engen
verächtlicher	NN	1	verächtlicher
höre	VB	1	höre
Neugierde	NN	1	Neugierde
Vorschriften	NN	1	Vorschriften
hört	VB	1	hört
erstemal	RP	1	erstemal
Futter	NN	1	Futter
herumhudeln	NN	1	herumhudeln
Bestehet	NN	1	Bestehet
Linken	NN	1	Linken
hüten	VB	1	hüten
Himmels	NN	1	Himmels
Scham	NN	1	Scham
Feindes	NN	1	Feindes
Ganzes	NN	1	Ganzes
persönlich	JJ	1	persönlichen
Empfindlichkeit	NN	1	Empfindlichkeit
schneiden	VB	1	geschnitten
Alt	JJ	1	Alte
Dorn	NN	1	Dorn
Atheisten	NN	1	Atheisten
gemäss	RP	1	gemäß
sorglosesten	NN	1	sorglosesten
Weiss	NN	1	Weiß
vernünftig	JJ	1	vernünftig
Blut	NN	1	Blut
Äusseres	NN	1	Äußeres
einzuschränken	NN	1	einzuschränken
Vorstellung	NN	1	Vorstellung
Verlieret	NN	1	Verlieret
Antwort	NN	1	Antwort
fix	JJ	1	fix
tragen	VB	1	trägt
nahen	PRP$	1	nahen
Hie	RB	1	Hier
Grundsätze	NN	1	Grundsätze
ungetreuer	NN	1	ungetreuer
plötzlich	JJ	1	plötzliche
Annehmlichkeiten	NN	1	Annehmlichkeiten
Fingst	NN	1	Fingst
unzüchtig	JJ	1	unzüchtigen
gewahr	NN	1	gewahr
zerriss	JJ	1	zerrissen
unzuerklärenden	NN	1	unzuerklärenden
Brocken	NN	1	Brocken
vernehmen	VB	1	vernehmen
Exempeln	NN	1	Exempeln
Holz	NN	1	Holz
Geschwind	NN	1	Geschwind
verleitet	NN	1	verleitet
Rindvieh	NN	1	Rindvieh
erziehen	VBN	1	erzogen
letztern	NN	1	letztern
täte	NN	1	täte
Bemühung	NN	1	Bemühung
verlornen	NN	1	verlornen
Maulaffe	NN	1	Maulaffe
unendlich	JJ	1	unendlich
Nötigers	NN	1	Nötigers
dahinreeissen	VB	1	dahinreißt
Bequemlichkeit	NN	1	Bequemlichkeit
Urteil	NN	1	Urteil
vergilt	NN	1	vergilt
unversöhnlich	JJ	1	unversöhnlich
Gefährten	NN	1	Gefährten
Bekenntnis	NN	1	Bekenntnis
gemächlich	JJ	1	gemächlichen
verschone	NN	1	verschone
widerrufen	VB	1	widerrufen
konnt	JJ	1	konnte
geliebet	NN	1	geliebet
höchstbegierig	JJ	1	höchstbegierig
Besseres	NN	1	Besseres
schmälern	NN	1	schmälern
Wortes	NN	1	Wortes
nichtswürdiges	NN	1	nichtswürdiges
Erschrecken	NN	1	Erschrecken
darnach	RB	1	darnach
Erbschaft	NN	1	Erbschaft
Staates	NN	1	Staates
gesonnen	NN	1	gesonnen
Hinderung	NN	1	Hinderung
gefährlich	JJ	1	gefährliche
drunter	NN	1	drunter
Geldes	NN	1	Geldes
lege	NN	1	lege
Freigeist	NN	1	Freigeist
sprengen	VB	1	sprengen
traktieren	NN	1	traktieren
laufen	VB	1	läuft
erreichen	RP	1	erreicht
verbieten	VB	1	verbieten
Wunderbarer	NN	1	Wunderbarer
lüderlicher	NN	1	lüderlicher
Verlangen	NN	1	Verlangen
vorausgesetzen	VBN	1	vorausgesetzt
sonen	VB	1	sonst
Schein	NNS	1	Scheine
Nichtswürdiger	NNP	1	Nichtswürdiger
bedanken	VB	1	bedanken
reifen	VBN	1	reif
Gleichgültigkeit	NN	1	Gleichgültigkeit
verraten	VB	1	verraten
Geschlechte	NN	1	Geschlechte
Schwude	NN	1	Schwude
Seh	PRP$	1	Seh
aufmutzen	NN	1	aufmutzen
leugnet	NN	1	leugnet
anwendest	NN	1	anwendest
ausmacht	NN	1	ausmacht
vorziehen	VB	1	vorzöge
Eigennutz	NN	1	Eigennutz
Wildfang	NN	1	Wildfang
Mine	NN	1	Mine
anständigere	NN	1	anständigere
Reizen	NN	1	Reizen
Hundsfott	NN	1	Hundsfott
hingehen	NN	1	hingehen
Einfalt	NN	1	Einfalt
herbei	RP	1	herbei
angewandt	JJ	1	angewandte
Tausendste	JJ	1	Tausendste
Trauung	NN	1	Trauung
Weltweisheit	NN	1	Weltweisheit
einladen	VBN	1	eingeladen
Heitern	NN	1	Heitern
erleuchtet	JJ	1	erleuchtet
unbeantwortet	NN	1	unbeantwortet
bemerkter	NN	1	bemerkter
Kurtisieren	NN	1	Kurtisieren
beschämt	JJ	1	beschämt
geschlagen	NN	1	geschlagen
Wand	NN	1	Wand
Bürschchen	VB	1	Bürschchen
Zanks	NN	1	Zanks
Abschilderungen	NN	1	Abschilderungen
unterdrückte	NN	1	unterdrückte
Sinne	NN	1	Sinne
singen	VB	1	singt
verweilen	VB	1	verweilen
mitten	RB	1	mitten
liess	VB	1	ließ
sage	VB	1	sage
beratschlagen	NN	1	beratschlagen
ausgeben	VB	1	ausgeben
sagt	VB	1	sagt
höchstens	RB	1	höchstens
Brand	NN	1	Brand
verdriessen	NN	1	verdrießen
Reisen	NN	1	Reisen
Knie	NN	1	Knie
Neubegierde	NN	1	Neubegierde
Unbiegsamer	NN	1	Unbiegsamer
Gemüter	NN	1	Gemüter
Bestreben	NN	1	Bestreben
christlich	JJ	1	christliche
gefällig	JJ	1	gefällige
Lehre	NN	1	Lehre
verteidigen	VB	1	verteidigen
nichte	NN	1	nichte
ruchlos	NN	1	ruchlose
Anhänger	NN	1	Anhänger
taubes	NN	1	taubes
mitteilet	NN	1	mitteilet
schimpflich	JJ	1	schimpflichen
erfinden	VBN	1	erfunden
auslassen	VB	1	auslassen
blicken	VB	1	blickt
ledig	JJ	1	ledig
Bockshorn	NN	1	Bockshorn
Revansch	JJ	1	Revansche
hiesig	JJ	1	hiesigen
Pen	RB	1	Pst
wohlbedächtig	JJ	1	wohlbedächtig
aussprechen	VB	1	aussprechen
Ehrgeiz	NN	1	Ehrgeiz
Verschonen	NN	1	Verschonen
Blödsinnigsten	NN	1	Blödsinnigsten
unterdessen	NN	1	unterdessen
Geschicklichkeit	NN	1	Geschicklichkeit
genugen	VBN	1	genug
fürchten	VB	1	fürchten
Lobsprüche	NN	1	Lobsprüche
Entschuldigung	NNS	1	Entschuldigungen
parteiisch	JJ	1	parteiisch
Ehemann	NN	1	Ehemann
Nichtswürdigkeit	NN	1	Nichtswürdigkeit
kriechend	NN	1	kriechenden
beschloss	VBN	1	beschlossen
elendes	NN	1	elendes
Wenigstens	NN	1	Wenigstens
Abscheu	NN	1	Abscheu
begreiflich	JJ	1	begreiflich
une	NN	1	une
Zwingen	NN	1	Zwingen
daranen	VB	1	daran
Kunstgriff	NN	1	Kunstgriff
Anmerkungen	NN	1	Anmerkungen
Ausdrücke	NN	1	Ausdrücke
anflehen	NNP	1	anflehen
Wichtigesen	JJ	1	Wichtiges
derentwegen	NN	1	derentwegen
Allernichtswürdigste	NN	1	Allernichtswürdigste
vornehmen	VBN	1	vorgenommen
Beispiele	NN	1	Beispiele
Gesichts	NN	1	Gesichts
abzusagen	VB	1	abzusagen
Lustig	JJ	1	Lustig
müsse	VB	1	müsse
vornehmlich	RB	1	vornehmlich
dahintern	RB	1	dahinter
absprechen	VB	1	absprechen
Schule	NN	1	Schule
abgeleget	NN	1	abgeleget
belehre	NN	1	belehre
Hälfte	NN	1	Hälfte
artiges	NN	1	artiges
Zürne	NN	1	Zürne
Vorwitz	NN	1	Vorwitz
Verdienst	NN	1	Verdienst
Besorgung	NN	1	Besorgung
vorzubringen	VB	1	vorzubringen
zugestossener	NN	1	zugestoßener
servir	NN	1	servir
artigen	NN	1	artigen
Sag	NN	1	Sag
scheinende	NN	1	scheinende
verletzen	VB	1	verletzen
entehren	VB	1	entehren
strengern	NN	1	strengern
wenden	VB	1	wenden
ordentlich	JJ	1	ordentlich
Dolch	NN	1	Dolch
allzugern	NN	1	allzugern
seichten	NN	1	seichten
vornehmsten	NN	1	vornehmsten
geirret	NN	1	geirret
wendet	JJ	1	wendet
Reichtum	NN	1	Reichtum
meinern	VB	1	meiner
wüsste	NN	1	wüßte
hierinne	NN	1	hierinne
annähme	NN	1	annähme
Töchtern	NN	1	Töchtern
dankbar	JJ	1	dankbar
eigennützig	JJ	1	eigennützig
wankendem	RB	1	wankendem
Anherkunft	NN	1	Anherkunft
anrechnen	NN	1	anrechnen
Schmeichlerin	NN	1	Schmeichlerin
Untier	NN	1	Untier
Verschieb	NN	1	Verschieb
verdienten	NN	1	verdienten
dürren	NN	1	dürren
kalt	JJ	1	kaltem
erwarte	NN	1	erwarte
Kopien	NN	1	Kopien
eindrückt	NN	1	eindrückt
dieselb	DT	1	dieselben
Karnevalserfahrung	NN	1	Karnevalserfahrung
Geheimes	NN	1	Geheimes
richterlich	JJ	1	richterliche
frage	NN	1	frage
Tor	NNS	1	Toren
stampfen	VB	1	stampfen
dächte	NN	1	dächte
Geschlecht	NN	1	Geschlecht
verlangt	JJ	1	verlangte
lästerlich	JJ	1	lästerliches
borgen	VB	1	borgen
prahlenden	NN	1	prahlenden
Mädchens	NN	1	Mädchens
allerfeinste	NN	1	allerfeinste
beunruhiget	NN	1	beunruhiget
Geier	NN	1	Geier
Wind	NN	1	Wind
erstenmale	NN	1	erstenmale
Stolz	NN	1	Stolz
füllen	VB	1	füllen
Ton	NN	1	Ton
Arm	NN	1	Arm
darzu	RB	1	darzu
kosten	RB	1	kosten
feien	VBN	1	fein
Anstand	NN	1	Anstand
Freuden	NN	1	Freuden
abzielen	VB	1	abzielen
misstrauisch	JJ	1	mißtrauisch
Handschriften	NN	1	Handschriften
Beschäftigung	NN	1	Beschäftigung
Baue	NN	1	Baue
Bediente	NN	1	Bediente
Gläubiger	NN	1	Gläubiger
besinnst	NN	1	besinnst
klatschen	RP	1	geklatscht
Verschwenden	NN	1	Verschwenden
hundertmal	RB	1	hundertmal
He	NN	1	He
Prezeln	NN	1	Prezeln
könn	JJ	1	könne
bricht	NN	1	bricht
binden	VB	1	binden
sahe	NN	1	sahe
wachsend	JJ	1	wachsende
niedrigsten	NN	1	niedrigsten
Formalität	NN	1	Formalität
Setzen	NN	1	Setzen
Dochen	RB	1	Doch
abgekartetes	NN	1	abgekartetes
Bürge	NN	1	Bürge
Still	NN	1	Still
Gegenstande	NN	1	Gegenstande
woran	DT	1	woran
gezürnt	NN	1	gezürnt
liebet	NNP	1	liebet
drüber	NN	1	drüber
fern	JJ	1	ferne
Unmensch	NN	1	Unmensch
Schwiegersohn	NN	1	Schwiegersohn
Verändrung	NN	1	Verändrung
dürfte	VB	1	dürfte
beleidigten	NN	1	beleidigten
geschieht	VB	1	geschieht
blöde	NN	1	blöde
gib	NNP	1	gib
Schulden	NN	1	Schulden
Vorstellungen	NN	1	Vorstellungen
demütigen	VB	1	demütigen
Richterin	NN	1	Richterin
erheben	VBN	1	erhoben
leidet	NN	1	leidet
Verleugner	NN	1	Verleugner
Fehl	NN	1	Fehl
abermal	RP	1	abermal
ehrwürdigen	NN	1	ehrwürdigen
Tone	NN	1	Tone
erspare	NN	1	erspare
la	NN	1	la
lösen	VB	1	löset
übereilen	NN	1	übereilen
Plaudern	NN	1	Plaudern
Hundertste	NN	1	Hundertste
unwert	NN	1	unwert
geliebten	NN	1	geliebten
Vermittelung	NN	1	Vermittelung
wisst	NN	1	wißt
treuherziges	NN	1	treuherziges
bekehren	VB	1	bekehren
verschwendet	NN	1	verschwendet
erholen	VB	1	erholen
Gegenteile	NN	1	Gegenteile
Umkehr	NN	1	Umkehr
gewürzt	NN	1	gewürzt
Wohlstande	NN	1	Wohlstande
Hund	NN	1	Hund
beschrieben	NN	1	beschrieben
anbete	NN	1	anbete
Schmerz	NNS	1	Schmerzen
Pferd	NN	1	Pferd
unbequemen	NN	1	unbequemen
verdächtig	JJ	1	verdächtig
hässlicher	NN	1	häßlicher
bearbeiten	VBN	1	bearbeitet
anhaltend	JJ	1	anhaltendes
Glauben	NN	1	Glauben
vorbringe	NN	1	vorbringe
Bär	NN	1	Bär
dringender	NN	1	dringender
überlegt	JJ	1	überlegt
Abschlag	NN	1	Abschlag
Katzenkopf	NN	1	Katzenkopf
unsichtbar	JJ	1	unsichtbare
Julianch	VB	1	Julianchen
hurtig	JJ	1	hurtig
Blutsfreunde	NN	1	Blutsfreunde
stiften	VB	1	stiften
Stilleschweigen	NN	1	Stilleschweigen
wählen	VB	1	wählen
Grausamkeit	NN	1	Grausamkeit
hinunter	NN	1	hinunter
übergeben	VBN	1	übergeben
bezeugen	RP	1	bezeugt
Wohlstand	NN	1	Wohlstand
beredtern	NN	1	beredtern
hämtückisch	JJ	1	hämtückischen
Wahn	NN	1	Wahn
Bibel	NN	1	Bibel
warst	RB	1	warst
Lächelnd	NN	1	Lächelnd
selben	VBN	1	selbst
liebenswürdigere	NN	1	liebenswürdigere
Schluckern	NN	1	Schlucker
Wiederholung	NN	1	Wiederholung
verblinden	NN	1	verblinden
beurlauben	NN	1	beurlauben
aufbringen	JJ	1	aufgebracht
Sachte	PRP$	1	Sachte
Groll	NN	1	Groll
verstecken	VB	1	verstecken
bezeugte	NN	1	bezeugte
wiederholen	VB	1	wiederholen
Pfaffen	NN	1	Pfaffen
Franzose	NNS	1	Franzosen
einzigen	VB	1	einzige
zuziehen	NN	1	zuziehen
einziges	NN	1	einziges
Freuen	NN	1	Freuen
fliehen	VB	1	fliehen
stehet	NN	1	stehet
Fort	NN	1	Fort
höhnisch	JJ	1	höhnisch
Knien	NN	1	Knien
Pest	NN	1	Pest
schlucken	VB	1	schlucken
Streitköpfe	NN	1	Streitköpfe
ausliefern	VB	1	ausliefern
bereden	NN	1	bereden
Kahle	NN	1	Kahle
verbergen	VB	1	verbergen
geblendet	NN	1	geblendet
belustigen	NN	1	belustigen
stören	VB	1	stören
richtig	JJ	1	richtig
Wirst	WRB	1	Wirst
glückseligem	NN	1	glückseligem
ehrlicher	RB	1	ehrlicher
unbeschreiblich	JJ	1	unbeschreibliche
gewinnt	NNP	1	gewinnt
lesen	RP	1	gelesen
unparteiisch	JJ	1	unparteiisches
pere	NN	1	pere
Mamsellchen	VB	1	Mamsellchen
Hoffe	NN	1	Hoffe
lächerlich	JJ	1	lächerlich
tyrannisieren	VB	1	tyrannisieren
andr	JJ	1	andre
vous	JJ	1	vous
erkannten	NN	1	erkannten
worüber	WRB	1	worüber
versetze	NN	1	versetze
ihrigen	PRP$	1	ihrigen
gelehrter	NN	1	gelehrter
Schüler	NN	1	Schüler
kriechende	NN	1	kriechende
unserm	PRP$	1	unserm
pathetischer	NN	1	pathetischer
Längern	VB	1	Länger
Backofen	NN	1	Backofen
Bösewichter	NN	1	Bösewichter
würdig	JJ	1	würdig
Schwiegersohne	NN	1	Schwiegersohne
Unsre	NN	1	Unsre
Zweiflerin	NN	1	Zweiflerin
bestrebet	NN	1	bestrebet
zeither	NN	1	zeither
ungläubig	JJ	1	ungläubig
geschwatzt	NN	1	geschwatzt
Balthasarn	NN	1	Balthasarn
Rodomontade	NN	1	Rodomontade
Ansehens	NN	1	Ansehens
schieben	VB	1	schieben
eingefleischten	NN	1	eingefleischten
abgekühlt	NN	1	abgekühlt
Liseten	NN	1	Lisette
kritisch	JJ	1	kritischen
Unnatürlichste	NN	1	Unnatürlichste
Verklagung	NN	1	Verklagung
Mässigung	NN	1	Mäßigung
entkleiden	NN	1	entkleiden
umarmen	VB	1	umarmen
Trotze	NN	1	Trotze
erträglich	JJ	1	erträglich
grob	JJ	1	grob
Glaube	NN	1	Glaube
strittest	NN	1	strittest
verhehlte	NN	1	verhehlte
mag	VB	1	mag
Glaubt	NN	1	Glaubt
ausgegangen	NN	1	ausgegangen
zerrissenen	NN	1	zerrissenen
kennten	NN	1	kennten
brennt	NN	1	brennt
innern	VB	1	innern
Urteilen	NN	1	Urteilen
Gunst	NN	1	Gunst
Blumen	NN	1	Blumen
Unbesonnenheit	NN	1	Unbesonnenheit
berechtiget	NN	1	berechtiget
Verleumder	NN	1	Verleumder
spielst	NN	1	spielst
anbieten	VB	1	angeboten
Jenes	RB	1	Jenes
Jener	NNP	1	Jener
entschuldige	NN	1	entschuldige
Verdienste	NN	1	Verdienste
entbehren	VB	1	entbehren
Länge	NN	1	Länge
meiste	NN	1	meiste
Schlaue	NN	1	Schlaue
Lacht	NN	1	Lacht
Meisterstück	NN	1	Meisterstück
Fahren	NN	1	Fahren
bunt	JJ	1	bunt
ausgekundschaftet	NN	1	ausgekundschaftet
erteile	NN	1	erteile
halt	VB	1	halten
vergeblich	JJ	1	vergeblichen
beih	DT	1	beiher
Äusserste	NN	1	Äußerste
Nötiges	NN	1	Nötiges
vorbei	IN	1	vorbei
ruhen	VB	1	ruhen
Rühmlich	JJ	1	Rühmliches
gequälet	NN	1	gequälet
erwerben	VB	1	erwerben
Überlege	NN	1	Überlege
Gebet	NN	1	Gebet
Klasse	NN	1	Klasse
Kette	NN	1	Kette
itzt	DT	1	itzt
ungeheu	JJ	1	ungeheuer
Bestätigung	NN	1	Bestätigung
Gelassenheit	NN	1	Gelassenheit
ungestalteten	NN	1	ungestalteten
deinigen	NN	1	deinigen
auftragen	NN	1	auftragen
fremdern	VB	1	fremder
et	NN	1	et
Danksagung	NN	1	Danksagung
bekömmt	NN	1	bekömmt
zurückkommen	VB	1	zurückkommen
ernstlich	JJ	1	ernstlich
Edelste	NN	1	Edelste
allerkleinste	NN	1	allerkleinste
Beteurung	NN	1	Beteurung
Halssach	JJ	1	Halssachen
ungeschimpft	NN	1	ungeschimpft
unanständig	JJ	1	unanständig
kühnern	JJ	1	kühnern
peinigen	NN	1	peinigen
Wesen	NN	1	Wesen
Schöps	NNP	1	Schöps
schuldig	JJ	1	schuldig
zärtlichste	NN	1	zärtlichste
Ursachen	VB	1	Ursachen
hinhängen	VBN	1	hinhängt
Stand	NN	1	Stand
zugetrauet	NN	1	zugetrauet
Blind	NN	1	Blind
wetterwendisch	JJ	1	wetterwendischen
Begriff	NN	1	Begriff
wirken	VB	1	wirkt
Heiligkeit	NN	1	Heiligkeit
Nase	NN	1	Nase
Wem	NN	1	Wem
Standes	NN	1	Standes
zweien	NN	1	zweien
unvernünftigen	NN	1	unvernünftigen
unterm	NN	1	unterm
freundschaftlichste	NN	1	freundschaftlichste
Engländsch	NN	1	Engländsch
nachsehend	JJ	1	nachsehend
dünkt	NN	1	dünkt
vorfallen	NN	1	vorfallen
Atem	NN	1	Atem
beklage	NN	1	beklage
Lohn	NN	1	Lohn
Münze	NN	1	Münze
vermengen	VB	1	vermengen
Post	NN	1	Post
bitt	JJ	1	bitter
Märtyrer	NN	1	Märtyrer
Feuer	NN	1	Feuer
stolzen	NN	1	stolzen
unterlassen	VB	1	unterlassen
Ersen	NN	1	Erste
lacht	VB	1	lacht
einzeln	JJ	1	einzelnen
erkundigte	NN	1	erkundigte
beschämen	VB	1	beschämen
aufwallende	NN	1	aufwallende
geht	VB	1	geht
stärk	JJ	1	stärker
Entschluss	NN	1	Entschluß
Puppe	NN	1	Puppe
sag	JJ	1	sagen
ans	IN	1	ans
wesentlichst	JJ	1	wesentlichste
Allzugütige	NN	1	Allzugütige
Hals	NN	1	Hals
antworten	VB	1	antworten
Helfen	NN	1	Helfen
Spotte	NN	1	Spotte
fertig	JJ	1	fertig
Verlust	NN	1	Verlust
bezauberte	NN	1	bezauberte
gegenseitigen	JJ	1	gegenseitigen
Gemütsart	NNP	1	Gemütsart
Name	NN	1	Name
flüchtigen	NN	1	flüchtigen
boshaft	JJ	1	boshaft
carogne	NN	1	carogne
Mitleiden	NN	1	Mitleiden
Notwendig	JJ	1	Notwendig
ohnedem	RB	1	ohnedem
Verbindlich	JJ	1	Verbindliches
rückgängige	NN	1	rückgängige
erbt	NN	1	erbt
fille	FW	1	fille
Nuren	VBN	1	Nur
bewahre	NN	1	bewahre
herauszieht	RB	1	herauszieht
einsehen	VB	1	einsehen
Gesetzt	NN	1	Gesetzt
ernähren	VB	1	ernähren
Rocke	NN	1	Rocke
liebenswürdigst	JJ	1	liebenswürdigste
Trost	NN	1	Trost
schassen	VB	1	schießen
auszuhalten	NN	1	auszuhalten
Brocke	NN	1	Brocke
scheusslichsten	NN	1	scheußlichsten
abjagen	VBN	1	abgejagt
vorzüglich	JJ	1	vorzügliche
hörte	RB	1	hörte
getraue	NN	1	getraue
erzürnen	NN	1	erzürnen
munt	JJ	1	munter
unverschämter	JJ	1	unverschämter
Krank	NN	1	Krank
nachdrücklichste	NN	1	nachdrücklichste
beschwöre	NN	1	beschwöre
Männern	NN	1	Männern
schwer	JJ	1	schwerer
Punkte	NN	1	Punkte
Fragst	NN	1	Fragst
Niederträchtige	NN	1	Niederträchtige
solltet	NN	1	solltet
Joch	NN	1	Joch
vielmalten	VBN	1	vielmal
Religiös	JJ	1	Religiöse
hungriger	NN	1	hungriger
Schwanz	NN	1	Schwanz
Volk	NN	1	Volk
Hieren	VBN	1	Hier
Achen	NN	1	Ach
stärkern	NN	1	stärkern
lebhaft	JJ	1	lebhaftes
schreien	VB	1	schreit
Lineamente	NN	1	Lineamente
Kröte	NN	1	Kröte
Bewegung	NN	1	Bewegung
Verzieh	NN	1	Verzieh
barmherzige	NN	1	barmherzige
Bewundern	NN	1	Bewundern
weiden	NN	1	weiden
Sagte	NN	1	Sagte
versichert	NN	1	versichert
gottlose	NN	1	gottlose
fängt	VB	1	fängt
verzeihen	VB	1	verzeihen
vernichte	NN	1	vernichte
darin	RB	1	darin
beklagen	VB	1	beklagen
Partei	NN	1	Partei
versäumen	VB	1	versäumen
Zwang	JJ	1	Zwang
stimmt	RB	1	stimmt
wahrern	NN	1	wahrern
damals	RB	1	damals
Jahr	NN	1	Jahr
beissenden	NN	1	beißenden
verdammen	VB	1	verdammen
hitzig	JJ	1	hitzig
Grobheit	NN	1	Grobheit
Kreatur	NN	1	Kreatur
verachtenden	NN	1	verachtenden
Hässlichkeit	NN	1	Häßlichkeit
befriediget	NN	1	befriediget
coups	FW	1	coups
Kaum	NN	1	Kaum
Eigensinn	NN	1	Eigensinn
Deist	NN	1	Deist
Taler	NN	1	Taler
Haaren	NN	1	Haaren
dergleichen	PRP	1	dergleichen
hernach	NN	1	hernach
Väter	NN	1	Väter
eingezogener	NNP	1	eingezogener
verkleideten	NN	1	verkleideten
übersehen	VB	1	übersehen
grossmütigsten	NN	1	großmütigsten
sogleich	RB	1	sogleich
muntern	VB	1	muntern
Bettel	NN	1	Bettel
unbeständiger	NN	1	unbeständiger
behutsamer	NN	1	behutsamer
flüchtige	NN	1	flüchtige
Antichrist	NN	1	Antichrist
bring	JJ	1	bringe
samt	NN	1	samt
marternd	JJ	1	marternde
zittert	NN	1	zittert
schad	JJ	1	schaden
Schwiegervaters	NN	1	Schwiegervaters
zittere	NN	1	zittere
Dämmerung	NN	1	Dämmerung
sinnen	VB	1	sinnen
brüderlicher	NN	1	brüderlicher
ausstellen	VB	1	ausstellen
antut	NN	1	antut
glücklichen	VBN	1	glücklich
Schwäche	NN	1	Schwäche
Gehst	NN	1	Gehst
schnurrig	NN	1	schnurrige
erwäge	NN	1	erwäge
erzeugen	VBN	1	erzeugt
jemanden	NN	1	jemanden
unvorsichtigen	VBN	1	unvorsichtig
beredet	NN	1	beredet
gering	JJ	1	gering
Nochen	VBN	1	Noch
erstenmal	RB	1	erstenmal
gestossen	VBN	1	gestoßen
anwenden	VB	1	anwenden
scherzt	NN	1	scherzt
auslachen	VB	1	auslachen
Trinkgeld	NN	1	Trinkgeld
verbiete	NN	1	verbiete
Bravo	NN	1	Bravo
verstehe	VB	1	verstehe
eigne	NN	1	eigne
kriechen	VB	1	kriechen
versteht	JJ	1	versteht
Einfältiger	NNP	1	Einfältiger
aufzusuchen	VB	1	aufzusuchen
ohnmächtig	JJ	1	ohnmächtig
wahres	NN	1	wahres
Dummheit	NN	1	Dummheit
rückgängig	JJ	1	rückgängig
Kur	NN	1	Kur
Luft	NN	1	Luft
Engel	NN	1	Engel
wahren	PRP$	1	wahren
sann	NNP	1	sann
Gebieterin	NN	1	Gebieterin
befördern	VB	1	befördern
Allgemeinheit	NN	1	Allgemeinheit
solltest	RP	1	solltest
meiner	RB	1	meiner
gespielt	NN	1	gespielt
vergeben	VBN	1	vergeben
scherze	NN	1	scherze
fürchtest	NN	1	fürchtest
Verächtlich	JJ	1	Verächtliche
Höflichkeit	NN	1	Höflichkeit
finsterm	NN	1	finsterm
Postwagen	NN	1	Postwagen
jagen	VB	1	jagen
englisch	JJ	1	englisch
Schwest	JJ	1	Schwester
tanzt	NN	1	tanzt
ausreden	NN	1	ausreden
befriedigen	VB	1	befriedigen
waret	NN	1	waret
widerlegte	NN	1	widerlegte
unschuldige	PRP$	1	unschuldige
Mut	NN	1	Mut
verknüpfet	NN	1	verknüpfet
verbeisse	NN	1	verbeiße
prellen	NN	1	prellen
Widersprüche	NN	1	Widersprüche
Beruhigung	NN	1	Beruhigung
Predigen	NN	1	Predigen
zürnen	VB	1	zürnen
ausklagen	NN	1	ausklagen
eingelassen	NN	1	eingelassen
heucheln	VB	1	heucheln
unschmackhaft	PRP$	1	unschmackhaft
Prediger	NN	1	Prediger
zugehöre	NN	1	zugehöre
gezankt	NN	1	gezankt
Kleine	NN	1	Kleine
Liebkosung	NN	1	Liebkosung
wohlgefällt	NN	1	wohlgefällt
schönes	NN	1	schönes
lockrer	NN	1	lockrer
schickt	NN	1	schickt
Gewissheit	NN	1	Gewißheit
gehört	JJ	1	gehört
bereichere	NN	1	bereichere
grössre	JJ	1	größre
Aussöhnung	NN	1	Aussöhnung
Tropfen	NN	1	Tropfen
Rolle	NN	1	Rolle
Bekehrung	NN	1	Bekehrung
kleiden	VB	1	kleiden
Lüsten	NN	1	Lüsten
Kurzen	NN	1	Kurz
angehörst	NN	1	angehörst
Magen	NN	1	Magen
verderbter	NN	1	verderbter
Bücher	NN	1	Bücher
Töne	NN	1	Töne
Summ	JJ	1	Summe
woraus	WRB	1	woraus
Erst	RB	1	Erst
allmählig	JJ	1	allmählig
hölzern	JJ	1	hölzern
wackern	NN	1	wackern
Stücke	NN	1	Stücke
Madame	NN	1	Madame
leisten	VB	1	leisten
schleppte	NN	1	schleppte
Warte	NN	1	Warte
Stadt	NN	1	Stadt
gebot	JJ	1	geboten
Jüngling	NN	1	Jüngling
vergeissen	VB	1	vergißt
unsrer	PRP$	1	unsrer
Gelde	NN	1	Gelde
leichtsinnigen	NN	1	leichtsinnigen
selten	RB	1	selten
verleiten	VB	1	verleiten
vorschiessen	NN	1	vorschießen
Dingerchen	VB	1	Dingerchen
fressen	VB	1	fressen
Vorzug	NN	1	Vorzug
Anfälle	NN	1	Anfälle
verliesse	NN	1	verließe
Betragens	NN	1	Betragens
einbilde	NN	1	einbilde
Wesentlichsten	NN	1	Wesentlichsten
Fein	NN	1	Fein
baton	FW	1	baton
verlästert	NN	1	verlästert
Sohn	NN	1	Sohn
hinein	RP	1	hinein
Rabenaas	NN	1	Rabenaas
elend	JJ	1	elend
Verachtungen	NN	1	Verachtungen
könnten	RB	1	könnten
drehen	VB	1	drehen
geschmissen	NN	1	geschmissen
Reise	NN	1	Reise
hoffentlich	RB	1	hoffentlich
Breite	NN	1	Breite
Bürgern	NN	1	Bürgern
Schreck	NN	1	Schreck
viert	JJ	1	vierten
wiedergekommen	NN	1	wiedergekommen
rate	NN	1	rate
vielleichen	VB	1	vielleicht
Strafe	NN	1	Strafe
wiederkommen	NN	1	wiederkommen
beständige	NN	1	beständige
ausstellten	NN	1	ausstellten
hinaus	IN	1	hinaus
leibhafte	JJ	1	leibhafte
berühmt	JJ	1	berühmter
anschwatzen	NN	1	anschwatzen
hinreichet	NN	1	hinreichet
Freunden	NN	1	Freunden
leid	JJ	1	leid
Schönheiten	NN	1	Schönheiten
nenn	VB	1	nennen
heben	VB	1	hebe
vernichtet	NN	1	vernichtet
arg	RB	1	arg
Kannibal	NN	1	Kannibal
bürden	NN	1	bürden
vernichten	VB	1	vernichten
hass	JJ	1	hassen
ungestört	JJ	1	ungestört
Gehts	NN	1	Gehts
ausmachen	VB	1	ausmachen
versauerst	NN	1	versauerst
Fröhliches	NN	1	Fröhliches
französisch	JJ	1	französisch
wohnen	VB	1	wohnen
Auchen	RB	1	Auch
Neckereien	NN	1	Neckereien
Pfui	NN	1	Pfui
auszulach	JJ	1	auszulachen
Grillenfänger	NN	1	Grillenfänger
ungläubigen	NN	1	ungläubigen
endigen	VBN	1	geendigt
Schminke	NN	1	Schminke
Mosjeu	NN	1	Mosjeu
verdrungen	NN	1	verdrungen
allerwenigsten	NN	1	allerwenigsten
Darinen	RB	1	Darin
Brunnen	NN	1	Brunnen
streitet	NN	1	streitet
alsdenn	RB	1	alsdenn
streiten	VB	1	gestritten
Elemente	NN	1	Elemente
wohlgemachtesten	NN	1	wohlgemachtesten
Genüge	NN	1	Genüge
allzuvorsichtig	JJ	1	allzuvorsichtig
Privilegium	NN	1	Privilegium
natürlichen	IN	1	natürlichen
Not	NN	1	Not
Verziehen	NN	1	Verziehen
Dreustigkeit	NN	1	Dreustigkeit
Adel	NN	1	Adel
antworte	NN	1	antworte
komm	NN	1	komm
Vermögens	NN	1	Vermögens
klagen	VBN	1	klagt
damien	IN	1	damit
Absatze	NN	1	Absatze
klimpertst	NN	1	klimpertst
male	NN	1	male
Falten	NN	1	Falten
Ruhig	JJ	1	Ruhig
Annehmung	NN	1	Annehmung
herab	NN	1	herab
überlästigen	NN	1	überlästigen
Streiten	NN	1	Streiten
Musst	WRB	1	Mußt
à	NN	1	à
anbringen	VBN	1	angebracht
Schlechtere	NN	1	Schlechtere
prophezeien	VB	1	prophezeien
Geblüte	NN	1	Geblüte
Spare	NN	1	Spare
Stoss	NN	1	Stoß
Stimme	NN	1	Stimme
Elende	NN	1	Elende
Anständigkeit	NN	1	Anständigkeit
angehen	VB	1	angehen
Erde	NN	1	Erde
Laus	NN	1	Laus
abscheulich	JJ	1	abscheuliche
Vorschlag	NN	1	Vorschlag
versehen	VB	1	versehen
beschlassen	VB	1	beschließen
vollends	NN	1	vollends
Ekel	NN	1	Ekel
Schwarzrocke	NN	1	Schwarzrocke
Ungewissheit	NN	1	Ungewißheit
gesprächig	JJ	1	gesprächig
Alten	VB	1	Alte
kämen	NN	1	kämen
allerliebstes	NN	1	allerliebstes
nachteiligen	NN	1	nachteiligen
erstaunlichste	JJ	1	erstaunlichste
Besorgen	NN	1	Besorgen
heiratet	NN	1	heiratet
abhalten	VB	1	abhalten
Rechtfertigung	NNS	1	Rechtfertigungen
Welchem	NN	1	Welchem
Leid	NN	1	Leid
alten	VB	1	alt
Konkurs	NNS	1	Konkurse
Stein	NNS	1	Steine
voran	RP	1	voran
närrisch	JJ	1	närrische
gekitzelt	NN	1	gekitzelt
dichten	VB	1	dichte
altes	NN	1	altes
Hauptsache	NN	1	Hauptsache
aufzuziehen	NN	1	aufzuziehen
Derjenig	DT	1	Derjenige
entferne	NN	1	entferne
zerstreut	NN	1	zerstreut
aufrichten	NN	1	aufrichten
tritt	VB	1	tritt
würdet	NN	1	würdet
Freite	NN	1	Freite
Mutmassungen	NN	1	Mutmaßungen
erstern	NN	1	erstern
Holunke	NN	1	Holunke
Anliegen	NN	1	Anliegen
Spotten	NN	1	Spotten
Lumpenhund	NN	1	Lumpenhund
verschieden	JJ	1	verschiedenen
unverdient	JJ	1	unverdienten
Fahne	NN	1	Fahne
artigste	NN	1	artigste
stillen	PRP$	1	stillen
ernsthaft	JJ	1	ernsthaften
bedeuten	VBN	1	bedeuten
Adieu	NN	1	Adieu
Zeugnis	NN	1	Zeugnis
Verkehr	NN	1	Verkehr
missen	NN	1	missen
fehlt	VB	1	fehlt
verweise	NN	1	verweise
zugestehet	NN	1	zugestehet
abscheulicher	NN	1	abscheulicher
gedungen	NN	1	gedungen
ungeschickt	JJ	1	ungeschickt
Ungereimtheiten	NN	1	Ungereimtheiten
ausgehen	VB	1	ausgehen
Fähigkeit	NN	1	Fähigkeit
backen	VB	1	backen
brüderlich	JJ	1	brüderlichen
vorzuzählen	VB	1	vorzuzählen
versteh	NN	1	versteh
Theolog	NN	1	Theolog
geschworne	NN	1	geschworne
natürlicher	IN	1	natürlicher
wagen	VB	1	wagen
Imm	JJ	1	Immer
Wechselbalg	NN	1	Wechselbalg
fischen	VB	1	fische
Topp	NN	1	Topp
nachteiliger	NNP	1	nachteiliger
Sonnenstrahlen	NN	1	Sonnenstrahlen
vorteilhaft	JJ	1	vorteilhaft
Ansprüche	NN	1	Ansprüche
Vorrechte	NN	1	Vorrechte
Raub	NN	1	Raub
abgesondert	NN	1	abgesondert
passen	VB	1	passen
ausgedrückt	NN	1	ausgedrückt
angenommene	NN	1	angenommene
bestellen	PRP$	1	bestellen
Aufführung	NN	1	Aufführung
gereiset	NN	1	gereiset
Rechten	NN	1	Rechten
schmachtendes	NN	1	schmachtendes
schob	NN	1	schob
inbrünstiger	NNP	1	inbrünstiger
Schlüssel	NN	1	Schlüssel
vollkommen	JJ	1	vollkommene
Theophane	NN	1	Theophane
Entzückungen	NN	1	Entzückungen
jetzig	JJ	1	jetzigen
hineingebracht	NN	1	hineingebracht
Närrin	NN	1	Närrin
Ohrenbläser	NN	1	Ohrenbläser
Schäkerinnen	NN	1	Schäkerinnen
worüb	RB	1	worüber
Vergehungen	NN	1	Vergehungen
ungehalten	NN	1	ungehalten
karg	JJ	1	karg
gefährlichste	NN	1	gefährlichste
Hurtig	JJ	1	Hurtig
spintisiert	NN	1	spintisiert
Gekitzelt	NN	1	Gekitzelt
abholen	VB	1	abholen
Witz	NN	1	Witz
Vornehmste	NN	1	Vornehmste
Erfahrung	NN	1	Erfahrung
Seiten	NN	1	Seiten
denkst	NN	1	denkst
wiedersehen	VB	1	wiedersehen
biegen	VBN	1	biegt
unrecht	JJ	1	unrecht
Neuigkeit	NN	1	Neuigkeit
Beschuldigungen	NN	1	Beschuldigungen
Verdachts	NN	1	Verdachts
schwatze	NN	1	schwatze
Allerboshafteste	NN	1	Allerboshafteste
überlassen	VB	1	überlassen
Vorzuge	NN	1	Vorzuge
schwatzt	NNP	1	schwatzt
kostbar	JJ	1	kostbarer
schwatz	NN	1	schwatzen
todsterbenskrank	NN	1	todsterbenskrank
Verbrecher	NN	1	Verbrecher
abtreten	NN	1	abtreten
rechtschaffener	NN	1	rechtschaffener
edles	NN	1	edles
Hassenswürdigste	NN	1	Hassenswürdigste
Verbrechen	NN	1	Verbrechen
meint	JJ	1	meint
Lumpen	NN	1	Lumpen
Fischbeinröcken	NN	1	Fischbeinröcken
Zipfel	NN	1	Zipfel
verzweifle	NN	1	verzweifle
blendet	NN	1	blendet
küssen	VB	1	küssen
Nutze	NN	1	Nutze
Heiligste	NN	1	Heiligste
besonn	VBN	1	besonnen
irgend	JJ	1	irgend
nehmt	NN	1	nehmt
anzunehmen	VB	1	anzunehmen
traue	NN	1	traue
Narrheit	NN	1	Narrheit
vergnügt	JJ	1	vergnügt
aufstösst	NN	1	aufstößt
Frankreichsch	NN	1	Frankreichsch
Taschenbuch	NN	1	Taschenbuch
Spass	NN	1	Spaß
Widerrede	NN	1	Widerrede
Saufen	NN	1	Saufen
ersen	VB	1	erste
Kennst	NN	1	Kennst
Viertelstunde	NNS	1	Viertelstunden
Gehorsam	NN	1	Gehorsam
durchgerannt	NN	1	durchgerannt
Vermuten	NN	1	Vermuten
zwanzigmal	RB	1	zwanzigmal
Beobachtung	NN	1	Beobachtung
auskommen	VB	1	auskommen
manchmal	RB	1	manchmal
herstellen	VB	1	herstellen
seh	PRP$	1	seh
abzirkeln	NN	1	abzirkeln
auchen	VB	1	auch
egales	NN	1	egales
schuldigen	VBN	1	schuldig
setze	NN	1	setze
Ausspruch	NNS	1	Aussprüche
Ursach	JJ	1	Ursachen
ausgelassen	NN	1	ausgelassen
Abscheulich	JJ	1	Abscheuliches
unparteiischer	NN	1	unparteiischer
deucht	NN	1	deucht
erriet	NN	1	erriet
erbte	NN	1	erbte
Gescheutes	NN	1	Gescheutes
Tode	NN	1	Tode
tauern	NN	1	tauern
versichern	VB	1	versichern
Unruhe	NN	1	Unruhe
Hundsfötter	NN	1	Hundsfötter
geringschätzig	JJ	1	geringschätzig
Zank	NN	1	Zank
Collin	NN	1	Collin
Bündeln	NN	1	Bündeln
vergangene	NN	1	vergangene
herschrieben	NN	1	herschrieben
rücken	RP	1	gerückt
stürzen	VB	1	stürzen
Blute	NN	1	Blute
verwandeln	VB	1	verwandeln
verziehst	NN	1	verziehst
Urteils	NN	1	Urteils
Ergebenheit	NN	1	Ergebenheit
Ruchlosen	NN	1	Ruchlosen
erhaben	NN	1	erhaben
unschuldig	JJ	1	unschuldig
bliebe	NN	1	bliebe
Lisettch	VB	1	Lisettchen
Fällen	VB	1	Fällt
schlimmsten	NN	1	schlimmsten
Schlimmste	NN	1	Schlimmste
erraten	NN	1	erraten
richtige	NN	1	richtige
beständig	JJ	1	beständig
Verdammt	NN	1	Verdammt
beleidigen	VB	1	beleidigen
Schimmer	NN	1	Schimmer
gewöhnlich	JJ	1	gewöhnlich
hegen	NN	1	hegen
Beischlaf	NN	1	Beischlaf
möchten	VB	1	möchten
Frauenzimmerauge	NN	1	Frauenzimmerauge
pack	NN	1	pack
ärger	NN	1	ärger
Ruin	NN	1	Ruin
ausrechnen	VB	1	ausrechnen
herein	RP	1	herein
Pfaffengeschmeiss	NN	1	Pfaffengeschmeiß
Verschweigung	NN	1	Verschweigung
Widriges	NN	1	Widriges
könne	VB	1	könne
Falte	NN	1	Falte
Uph	NN	1	Uph
Übereilung	NN	1	Übereilung
untergraben	NN	1	untergraben
andermal	RB	1	andermal
Gehe	NN	1	Gehe
Anschein	NN	1	Anschein
eure	NN	1	eure
sittsam	JJ	1	sittsame
Ernsthaftigkeit	NN	1	Ernsthaftigkeit
versäufst	NN	1	versäufst
geringschätzige	NN	1	geringschätzige
erfuhr	VB	1	erfuhr
Kenntnis	NN	1	Kenntnis
beteuern	NN	1	beteuern
Lobspruch	NN	1	Lobspruch
rechte	NN	1	rechte
glänzenden	NN	1	glänzenden
Schleicher	NN	1	Schleicher
Weide	NN	1	Weide
reizend	JJ	1	reizend
Monaten	NN	1	Monaten
fesseln	VB	1	fesseln
Beispielen	VB	1	Beispielen
sanft	JJ	1	sanften
erschrecken	VB	1	erschrecken
läge	NN	1	läge
verändern	VB	1	verändert
Poete	NN	1	Poete
angelangen	VBN	1	angelangt
Adraten	NNP	1	Adrast
Besitz	NN	1	Besitz
verschont	NN	1	verschont
Benennungen	NN	1	Benennungen
womit	WRB	1	womit
eitles	NN	1	eitles
fürchte	NN	1	fürchte
Augapfel	NN	1	Augapfel
erwarten	VB	1	erwarten
unfruchtbaren	NN	1	unfruchtbaren
Erbe	NN	1	Erbe
Denken	NN	1	Denken
weinen	VB	1	weinen
Würfe	NN	1	Würfe
herrscht	NN	1	herrscht
Nachmittagspredigen	VB	1	Nachmittagspredigt
entspringt	RP	1	entspringt
Ziele	NN	1	Ziele
Ehemänner	NN	1	Ehemänner
Wehe	NN	1	Wehe
meinig	DT	1	meinige
liebe	NN	1	liebe
Bosheit	NN	1	Bosheit
Herrschaft	NN	1	Herrschaft
allzu	RB	1	allzu
Ohren	NN	1	Ohren
Tages	NN	1	Tages
erhielte	NN	1	erhielte
bleibe	NN	1	bleibe
Jenen	VBN	1	Jenen
verziehen	VB	1	verziehen
Sammelplatz	NN	1	Sammelplatz
Jungfern	NN	1	Jungfern
unleugbar	JJ	1	unleugbar
predigen	VB	1	predigen
verkaufen	VB	1	verkaufen
Finde	NN	1	Finde
Drohend	JJ	1	Drohend
hergekommen	NN	1	hergekommen
Bilder	NN	1	Bilder
Pulver	NN	1	Pulver
Comment	NN	1	Comment
pfeifen	VB	1	pfeifen
verdeckt	JJ	1	verdeckten
abzulenken	VB	1	abzulenken
schwatzen	NN	1	schwatzen
stückweise	NN	1	stückweise
verleugnet	NN	1	verleugnet
Sicherheit	NN	1	Sicherheit
schaffen	VB	1	schafft
armselige	NN	1	armselige
Seid	NN	1	Seid
Galgendieb	NNP	1	Galgendieb
Korb	NN	1	Korb
vorzupredigen	VB	1	vorzupredigen
weggehen	VB	1	weggehen
Bedünkens	NNP	1	Bedünkens
Beunruhigen	NN	1	Beunruhigen
Geheimnis	NN	1	Geheimnis
Temperament	NNS	1	Temperamente
Französischen	NN	1	Französische
vorweisen	VBN	1	vorgewiesen
diesesmal	DT	1	diesesmal
Plunder	NN	1	Plunder
spielend	JJ	1	spielendes
besorgen	VB	1	besorgen
Schwachheien	NN	1	Schwachheit
erlangen	VB	1	erlangen
glücklichst	JJ	1	glücklichste
vorstellten	NN	1	vorstellten
Glückes	NN	1	Glückes
unschuldiges	PRP$	1	unschuldiges
maraut	NN	1	maraut
Überflusse	NN	1	Überflusse
Nachdruck	NN	1	Nachdruck
Verlegenheit	NN	1	Verlegenheit
Körpers	NN	1	Körpers
Abschreckungen	NN	1	Abschreckungen
Infamer	NN	1	Infamer
Vorwerk	NN	1	Vorwerk
Gemahl	NN	1	Gemahl
Morgen	NN	1	Morgen
endlichen	VB	1	endlich
angeborne	NN	1	angeborne
Männerchen	VB	1	Männerchen
Stuhl	NN	1	Stuhl
Versicherung	NN	1	Versicherung
dringen	VB	1	dringt
einigermassen	IN	1	einigermaßen
Höllenbrand	NN	1	Höllenbrand
Schwarzröcke	NN	1	Schwarzröcke
Zug	NN	1	Zug
Spöttisch	JJ	1	Spöttisch
dran	RB	1	dran
Gebotes	NN	1	Gebotes
lang	JJ	1	lang
argwöhnisch	JJ	1	argwöhnisch
Abwesenheit	NN	1	Abwesenheit
Kaltsinn	NN	1	Kaltsinn
strafbar	JJ	1	strafbar
Besonder	JJ	1	Besondere
verholfen	NN	1	verholfen
unverzüglich	JJ	1	unverzüglich
Werken	NN	1	Werken
Errettung	NN	1	Errettung
witzig	JJ	1	witzig
allerfrömmsten	NN	1	allerfrömmsten
trüben	NN	1	trüben
Nachdenken	NN	1	Nachdenken
Schöpfer	NN	1	Schöpfer
Verzweifeltste	NN	1	Verzweifeltste
Klügerm	NN	1	Klügerm
beilegten	NN	1	beilegten
Erhebung	NN	1	Erhebung
Leber	NN	1	Leber
Glase	JJ	1	Glase
Irrtümern	NN	1	Irrtümern
lenket	NN	1	lenket
sparsam	JJ	1	sparsamer
zuhören	VB	1	zuhören
Augenblicken	NN	1	Augenblicken
begierig	JJ	1	begierig
Wollust	NN	1	Wollust
Ruhe	NN	1	Ruhe
Schlange	NN	1	Schlange
verrichten	VB	1	verrichten
ungerechte	NN	1	ungerechte
fühlt	VB	1	fühlt
gemein	JJ	1	gemein
Ende	NN	1	Ende
gefärbte	NN	1	gefärbte
umzechig	JJ	1	umzechig
nachdrücklicher	RB	1	nachdrücklicher
Blitz	NN	1	Blitz
Fassen	NN	1	Fassen
angenehmst	NN	1	angenehmste
Wäldern	NN	1	Wäldern
Hierauf	NN	1	Hierauf
Findest	NN	1	Findest
ältest	JJ	1	ältesten
Ochse	NN	1	Ochse
begnügen	VB	1	begnügen
betäuben	NN	1	betäuben
süssen	NN	1	süßen
übermorgen	RP	1	übermorgen
Liebste	NN	1	Liebste
betaure	NN	1	betaure
Zaume	NN	1	Zaume
Blutsfreund	NN	1	Blutsfreund
Einwilligung	NN	1	Einwilligung
weitre	NN	1	weitre
leb	VB	1	leben
aufschlagen	VB	1	aufschlägt
Wunsch	NN	1	Wunsch
Seufzen	NN	1	Seufzen
Revers	NN	1	Revers
hierzu	NN	1	hierzu
wolltsen	MD	1	wollts
dürft	VB	1	dürfte
Tiere	NN	1	Tiere
ergeben	VB	1	ergeben
Verführung	NN	1	Verführung
vernünftige	NN	1	vernünftige
gehts	NN	1	gehts
anhalten	VB	1	anhalten
redt	NNP	1	redt
voll	JJ	1	voller
überführet	NN	1	überführet
Niederträchtigen	NN	1	Niederträchtigen
überführen	NN	1	überführen
rede	VB	1	rede
verdammter	JJ	1	verdammter
liebenswerter	NNP	1	liebenswerter
geliehen	NN	1	geliehen
Menschheit	NN	1	Menschheit
übeln	NN	1	übeln
nackend	JJ	1	nackend
nötigsten	NN	1	nötigsten
Hum	NN	1	Hum
widerstehen	VB	1	widerstehen
sachte	PRP$	1	sachte
göttlich	JJ	1	göttlichen
Aufmerksamkeit	NN	1	Aufmerksamkeit
künftiges	NN	1	künftiges
zornig	JJ	1	zornig
herausjagen	VB	1	herausgejagt
Lehrer	NN	1	Lehrer
Abermals	RB	1	Abermals
Betschwester	NN	1	Betschwester
Hanges	NN	1	Hanges
verschonen	VB	1	verschonen
Jugend	NN	1	Jugend
stechen	VBN	1	stechen
herumschleicht	NN	1	herumschleicht
Geschlechtern	NN	1	Geschlechtern
listiger	NN	1	listiger
nötigten	NN	1	nötigten
läuft	VB	1	läuft
est-il	NN	1	est-il
nachzufolgen	NN	1	nachzufolgen
Zahn	NN	1	Zahn
Quelle	NN	1	Quelle
gründlich	JJ	1	gründlichen
kenne	VB	1	kenne
Unordnung	NN	1	Unordnung
Schwur	NN	1	Schwur
vergnügen	NN	1	vergnügen
Veränderung	NN	1	Veränderung
widerrufst	NN	1	widerrufst
hindert	NN	1	hindert
andersen	VBN	1	anders
Schnippchen	NN	1	Schnippchen
Lösungswort	NN	1	Lösungswort
gewärtig	JJ	1	gewärtig
Verzweifelt	NN	1	Verzweifelt
beneide	NN	1	beneide
diejenige	RB	1	diejenige
Aufenthalt	NN	1	Aufenthalt
Einlenkungen	NN	1	Einlenkungen
beilegen	VB	1	beigelegt
Priesterfrau	NN	1	Priesterfrau
umkehrt	NN	1	umkehrt
rechtschaffnen	NN	1	rechtschaffnen
Wovon	NN	1	Wovon
beiss	IN	1	beiß
verlasse	NNP	1	verlasse
heure	NN	1	heure
merklich	JJ	1	merkliche
gereuet	NN	1	gereuet
Pfarr	NN	1	Pfarr
worin	RB	1	worin
wohinter	RB	1	wohinter
isst	NN	1	ißt
unterscheide	NN	1	unterscheide
zernichten	NN	1	zernichten
erkannte	NN	1	erkannte
anbeissen	NN	1	anbeißen
Aufschub	NN	1	Aufschub
Fehlern	NN	1	Fehlern
wundern	VB	1	wundern
aufhört	NN	1	aufhört
Trinkgelder	NN	1	Trinkgelder
Wen	NN	1	Wen
Endzwecke	NN	1	Endzwecke
gesund	JJ	1	gesunder
abzuzwingen	VB	1	abzuzwingen
streitig	JJ	1	streitig
Geschöpfchen	VB	1	Geschöpfchen
Fragen	NN	1	Fragen
Bocke	NN	1	Bocke
Strahl	NNS	1	Strahlen
erträglicher	NN	1	erträglicher
ausrichten	VB	1	ausrichten
überladene	NN	1	überladene
einlassen	VB	1	einlassen
Posthause	NN	1	Posthause
Schuss	NN	1	Schuß
schnakisch	JJ	1	schnakisch
Geistlichkeit	NN	1	Geistlichkeit
empfindet	NN	1	empfindet
sichersten	NN	1	sichersten
Führen	NN	1	Führen
Mannsperson	NN	1	Mannsperson
Vortrefflich	JJ	1	Vortrefflich
wollenden	MD	1	wollende
Höh	NN	1	Höhe
rennen	VB	1	rennen
Nachrede	NN	1	Nachrede
hochbefehlenden	NN	1	hochbefehlenden
gedenke	NN	1	gedenke
ungerechen	VBN	1	ungerecht
Pfeife	NN	1	Pfeife
Umfange	NN	1	Umfange
verwechseln	PRP$	1	verwechseln
Hör	NN	1	Hör
gesetztes	NN	1	gesetztes
Summen	NN	1	Summen
gedenkt	NN	1	gedenkt
bewussten	NN	1	bewußten
warten	VB	1	warten
Gesetzes	NN	1	Gesetzes
schlicht	VB	1	schlichte
anfangen	VB	1	anfangen
Gefahr	NN	1	Gefahr
Vers	NN	1	Vers
bitte	VB	1	bitte
gegeneinander	RB	1	gegeneinander
Zeisig	JJ	1	Zeisig
schönern	NN	1	schönern
bekennen	VBN	1	bekannt
reg	JJ	1	rege
plagst	NN	1	plagst
ofen	VBN	1	oft
suchte	NN	1	suchte
bestätigen	VB	1	bestätigen
vermute	NN	1	vermute
bilden	VB	1	bilden
Anfang	NN	1	Anfang
geraten	VBN	1	geraten
Geständnisse	NN	1	Geständnisse
überfallen	VB	1	überfallen
bestärkten	NN	1	bestärkten
Flitterwochen	NN	1	Flitterwochen
gemeinen	VBN	1	gemein
vorhergehen	NN	1	vorhergehen
Skrupel	NN	1	Skrupel
herauf	NN	1	herauf
Widerwillen	NN	1	Widerwillen
befohl	VB	1	befohlen
erhabenern	NN	1	erhabenern
Narr	NN	1	Narr
Hasse	NN	1	Hasse
abgemalt	NN	1	abgemalt
Auslegung	NNS	1	Auslegungen
erstaunen	VB	1	erstaunen
aufgeben	VB	1	aufgeben
verwünscht	NN	1	verwünscht
verjüngt	JJ	1	verjüngte
Orakel	NN	1	Orakel
gefalle	NN	1	gefalle
Gleichem	NN	1	Gleichem
Meilen	NN	1	Meilen
Warten	NN	1	Warten
Leere	NN	1	Leere
Reife	NN	1	Reife
Lieblingsmeinung	NN	1	Lieblingsmeinung
Entzückende	NN	1	Entzückende
überdrüssig	JJ	1	überdrüssig
Seelenkannibal	NN	1	Seelenkannibal
Unartige	NN	1	Unartige
geschmolzen	NN	1	geschmolzen
aufrichtig	JJ	1	aufrichtig
gegebenes	NN	1	gegebenes
bet	JJ	1	bete
Unfall	NNS	1	Unfälle
wiederhole	NN	1	wiederhole
Gereist	NN	1	Gereist
Brut	NN	1	Brut
überraschen	VB	1	überraschen
sein.ende	NN	1	sein.Ende
bess	JJ	1	besser
Pah	NN	1	Pah
Zorn	NN	1	Zorn
Wahre	NN	1	Wahre
unhöflich	JJ	1	unhöflich
solls	RB	1	solls
Zuflucht	NN	1	Zuflucht
vorgegangen	NN	1	vorgegangen
Studierstube	NN	1	Studierstube
rein	JJ	1	reinen
Gleichgültig	JJ	1	Gleichgültig
aufgebrachte	NN	1	aufgebrachte
melden	VB	1	melden
fliegen	VB	1	fliegen
anzufangen	VB	1	anzufangen
Wahrscheinlichkeit	NN	1	Wahrscheinlichkeit
Mode	NN	1	Mode
Wohnung	NN	1	Wohnung
Ernst	NNP	1	Ernst
verantworten	VB	1	verantworten
Ohngefähr	NN	1	Ohngefähr
verderbt	NN	1	verderbt
Hierseins	NN	1	Hierseins
erwecket	NN	1	erwecket
bekomm	JJ	1	bekommen
verbot	JJ	1	verboten
nien	VBN	1	nie
Einwurf	NN	1	Einwurf
rechnen	VB	1	rechnen
mächtige	JJ	1	mächtige
ehrlichsten	NN	1	ehrlichsten
ankäme	NN	1	ankäme
denkende	NN	1	denkende
Labsal	NN	1	Labsal
rufen	VB	1	gerufen
begehen	VB	1	begehen
Gesichtszüge	NN	1	Gesichtszüge
dunkler	NN	1	dunkler
he	NN	1	he
jederzeien	VB	1	jederzeit
Umganges	NN	1	Umganges
allerweitesten	NN	1	allerweitesten
aufgedeckt	NN	1	aufgedeckt
stürmisch	JJ	1	stürmisch
gewürdiget	NN	1	gewürdiget
gebunden	JJ	1	gebundenen
willkürlich	VB	1	willkürliche
ganzem	NN	1	ganzem
ganzen	VB	1	ganzen
geborne	NN	1	geborne
Lieber	NN	1	Lieber
verlorne	NN	1	verlorne
vier	CD	1	vier
Aufs	NN	1	Aufs
Zwaren	VBN	1	Zwar
regelmässig	JJ	1	regelmäßig
ebe	JJ	1	eben
herausspringen	VBN	1	herausspringt
bessere	NN	1	bessere
spottet	NN	1	spottet
Völkern	NN	1	Völkern
packen	VB	1	packen
desperate	NN	1	desperate
Bösewicht	NN	1	Bösewicht
suchst	NN	1	suchst
Irrungen	NN	1	Irrungen
allzusehr	NN	1	allzusehr
kindisch	JJ	1	kindischen
abgeborgen	VBN	1	abgeborgt
wirs	NN	1	wirs
verhindern	VB	1	verhindert
Ausflucht	NN	1	Ausflucht
Minute	NN	1	Minute
Wische	RB	1	Wische
sparen	VBN	1	gespart
Stütze	NN	1	Stütze
dargegen	VBN	1	dargegen
vergebens	IN	1	vergebens
allerliebste	NN	1	allerliebste
Anlage	NN	1	Anlage
Hervor	NN	1	Hervor
vortrefflichsten	NN	1	vortrefflichsten
Verloren	NN	1	Verloren
Weisheit	NN	1	Weisheit
Wünschen	VB	1	Wünschen
Heu	NN	1	Heu
verdienst	NN	1	verdienst
Drohen	NN	1	Drohen
Haupt	NN	1	Haupt
schmeichle	NN	1	schmeichle
geplaudert	NN	1	geplaudert
heimlich	JJ	1	heimliche
Schwätzerin	NN	1	Schwätzerin
Gründlich	JJ	1	Gründliches
Nähzeuge	NN	1	Nähzeuge
abgestiegen	NN	1	abgestiegen
Geh	NN	1	Geh
ungerechtes	NN	1	ungerechtes
Geräte	NN	1	Geräte
Munterkeit	NN	1	Munterkeit
Trinkgeldern	NN	1	Trinkgeldern
Anmut	NN	1	Anmut
wütenden	NN	1	wütenden
loben	VB	1	loben
schmackhaft	JJ	1	schmackhaft
Verwirrung	NN	1	Verwirrung
Hoffnung	NN	1	Hoffnung
sagte	RB	1	sagte
glaubten	VB	1	glaubten
bestürzen	NN	1	bestürzen
schenkte	NN	1	schenkte
ändern	VB	1	ändert
Unkosten	NN	1	Unkosten
Kopf	NN	1	Kopf
greifen	VB	1	greift
hervorbringen	VB	1	hervorbringen
beschreiben	VB	1	beschreiben
Fallstricke	NN	1	Fallstricke
verstellen	NN	1	verstellen
leichtfertig	JJ	1	leichtfertig
Reiz	NNS	1	Reize
siebenmal	RB	1	siebenmal
bewundere	NN	1	bewundere
entfärben	VB	1	entfärben
anmelden	VB	1	anmelden
Zweifeln	NN	1	Zweifeln
retten	VB	1	rettete
schelten	VB	1	schalten
schw	JJ	1	schwer
fetten	NN	1	fetten
Tasche	NN	1	Tasche
untersuchen	VB	1	untersuchen
Ziehen	VB	1	Zieht
schriftlich	JJ	1	schriftliche
Mundwerk	NN	1	Mundwerk
Stern	NN	1	Stern
Bocksfüsse	NN	1	Bocksfüße
siehts	NN	1	siehts
Unabhängigkeit	NN	1	Unabhängigkeit
Worauf	NN	1	Worauf
worauf	RB	1	worauf
scheuen	VBN	1	gescheut
Freidenker	NN	1	Freidenker
abwarten	VB	1	abwarten
kleinst	JJ	1	kleinste
aufhören	VB	1	aufhören
martern	NN	1	martern
vorschlagen	VB	1	vorschlagen
wen	WP	1	wen
wem	WP	1	wem
Woche	NN	1	Woche
Brauchen	VB	1	Brauchen
Bluts	NN	1	Bluts
Männchen	NN	1	Männchen
Erschrecklich	VB	1	Erschreckliches
Eigentum	NN	1	Eigentum
vertrautesten	NN	1	vertrautesten
Drum	NN	1	Drum
niederträchtige	NN	1	niederträchtige
verhärten	NN	1	verhärten
Geschmack	NN	1	Geschmack
wehmütigen	NN	1	wehmütigen
Blitzmädel	NN	1	Blitzmädel
aufrichtigern	NN	1	aufrichtigern
ersuchen	PRP$	1	ersuchen
Gabe	NN	1	Gabe
Fallen	NN	1	Fallen
Schwarzröcken	NN	1	Schwarzröcken
erzählen.ende	NN	1	erzählen.Ende
dennoch	RB	1	dennoch
Dingern	VB	1	Dinger
Fortgehen	NN	1	Fortgehen
losen	VB	1	los
unterbreche	NN	1	unterbreche
leere	NN	1	leere
getreuern	NN	1	getreuern
Freigeists	NN	1	Freigeists
Gesetzgeber	NN	1	Gesetzgeber
Ausnahmen	NN	1	Ausnahmen
Nennen	NN	1	Nennen
Freigeiste	NN	1	Freigeiste
spielende	NN	1	spielende
Beleidigung	NN	1	Beleidigungen
Geschick	NN	1	Geschick
Diantre	NN	1	Diantre
vorzuwerfen	VB	1	vorzuwerfen
wünschet	VB	1	wünschet
nachgeben	VB	1	nachgeben
verderblich	JJ	1	verderbliche
dahinter	RB	1	dahinter
Rätsel	NN	1	Rätsel
Wunderlicher	NN	1	Wunderlicher
erheiratet	NN	1	erheiratet
fahren	VB	1	gefahren
darreicht	RB	1	darreicht
rechtfertigen	VB	1	rechtfertigen
angeseh	VBN	1	angesehen
neidisch	JJ	1	neidisch
schimpflichsten	NN	1	schimpflichsten
betauern	NN	1	betauern
geringstes	NN	1	geringstes
hetzen	VB	1	hetzen
aufstehen	VB	1	aufsteht
Hauch	NN	1	Hauch
gescholten	NN	1	gescholten
erhob	NN	1	erhob
mere	NN	1	mere
unverrichteter	NN	1	unverrichteter
verwandt	JJ	1	verwandt
mehrer	JJ	1	mehrere
inner	JJ	1	innere
Leibe	NN	1	Leibe
murre	NN	1	murre
diable	NN	1	diable
ehemals	IN	1	ehemals
Geplärre	NN	1	Geplärre
auszusetzen	NN	1	auszusetzen
verwünsch	JJ	1	verwünschen
verweisen	VBN	1	verwiesen
austeilen	NN	1	austeilen
abgeschmackte	NN	1	abgeschmackte
zweifelt	NN	1	zweifelt
Geistlich	JJ	1	Geistlichen
davor	JJ	1	davor
Diener	NNP	1	Diener
wär	JJ	1	wäre
zweifeln	VB	1	zweifeln
Potz	NN	1	Potz
braucht	VB	1	braucht
ärgerlich	JJ	1	ärgerlich
Stunden	NN	1	Stunden
coquin	NN	1	coquin
vorsätzlich	JJ	1	vorsätzlich
Philosophen	NN	1	Philosophen
Heuchelei	NN	1	Heuchelei
Anfänge	NN	1	Anfänge
Haus	NN	1	Haus
Rasendes	NN	1	Rasendes
umgesehen	NN	1	umgesehen
Schuld	NN	1	Schuld
stundenlang	JJ	1	stundenlanges
barmherzig	JJ	1	barmherzig
Aushalten	NN	1	Aushalten
niemalsen	VBN	1	niemals
jung	JJ	1	junger
reinigen	VB	1	reinigen
Verwünschungen	NN	1	Verwünschungen
Vorsorge	NN	1	Vorsorge
verstorben	JJ	1	verstorbenen
Freigeister	NN	1	Freigeister
Kitzelung	NN	1	Kitzelung
