Title: Die alte Jungfer
Number of all lemmas: 3539
Nummber of different lemmas: 1632

Lemma	POS	Frequency	Tokens
Herr	JJ, NN, NNP	71	Herr, Herren
Capitaine	NN, NNP	41	Capitaine
Ach	NN	35	Ach
Schlag	NNP, NN	34	Schlag
sagen	VB, VBN, PRP$, RP	34	sagen, gesagt, sagte, sagt, sage
wohl	RP, RB, IN	30	wohl
Jahr	NN	25	Jahr
Mann	NN	25	Mann
nehmen	RB, VB, VBN	22	nimmt, nehme, nehmen, genommen
lieb	JJ	21	lieber, liebe, lieb, lieben
Jungfer	NN, JJ	21	Jungfer
gar	RB, IN, RP	21	gar
heiraten	VB, RP, VBN	20	heiraten, geheiratet
gut	JJ	19	gut, guten, gute, guter
Lelio	NN, NNP	19	Lelio
wenig	IN, RB, RP	18	wenig
wahr	RP, RB	18	wahr
Nu	NN	18	Nu
alt	JJ	18	alt, alten, alte
Gott	NN	17	Gott
ha	NN, NNP	17	ha
gewiss	NN, JJ	15	gewiß
schuldig	JJ	15	schuldig
Lisette	NN, NNP	15	Lisette
Muhme	NN	15	Muhme
glauben	VB, VBN	15	glauben, glaube, glaubst, geglaubt
Mademoiselle	NN	14	Mademoiselle
Heirat	NNS, NN	14	Heiraten, Heirat
weeissen	VB	14	weiß
Ohldin	NN, NNP	13	Ohldin
reden	VB, VBN	12	reden, geredet, rede, redet, redest
Frau	JJ, NN	12	Frau
Peter	NNP, NN	12	Peter
erst	RB, JJ, NN, RP	11	erst, ersten, erste
Ha	NN	11	Ha
Bräutigam	NN	11	Bräutigam
denken	VB	11	denke, denkt, denken
itzo	NN, RB	11	itzo
Herrn	NN, JJ	11	Herrn
Braut	NN, NNP, JJ	11	Braut
sonst	RB, IN	11	sonst
kömmen	MD	10	kömmt, kömmst
Poete	NN	10	Poete
hören	VB	10	hört, hören, höre, hörte
Schneider	NN, NNP	10	Schneider
Ei	NN	10	Ei
Henker	NN	10	Henker
rechen	VB, VBN	10	recht
Wort	NN, NNS	9	Wort, Worte, Wörter
sehen	VB, VBN	9	sehen, sieht, gesehen
nu	UH	9	nu
Vetter	NN, JJ	9	Vetter
Kerl	NN	9	Kerl
etwan	NN	9	etwan
heeissen	VB, VBN	9	heißt, heißen
Lass	NN	9	Laß
Poeten	NN	9	Poeten
bald	RB, RP, WRB, IN	9	bald
bezahlen	VB, VBN	8	bezahlen, bezahlt
willst	RP, WRB	8	willst
Augenblick	NNP, NN	8	Augenblick
Zeit	NN	8	Zeit
wissen	VB, VBN	8	wissen
fort	RP, JJ	8	fort
Kinder	NN	8	Kinder
närrisch	JJ	8	närrische, närrisch
Kind	NN	8	Kind
Gut	NN	8	Gut
Oronte	NN, NNP	8	Oronte
sehn	NN	8	sehn
bitten	VB	7	bitten, bitte
soen	VBN, RB, VB	7	so
genug	RB, JJ, RP	7	genug
ehrlich	JJ	7	ehrlichen, ehrliches, ehrliche, ehrlicher
lange	RB, IN	7	lange
schicken	RP, VB	7	geschickt, schicken, schickt
Teufel	NN	7	Teufel
heuen	VB, VBN	7	heute
Namen	NN	7	Namen
Weib	NN	7	Weib
Freund	NN, NNS	7	Freund, Freunde
Geld	NN	7	Geld
vortrefflich	JJ	7	vortrefflich, vortrefflichen, vortreffliche
andre	NN, JJ	6	andre
Erbschaft	NN	6	Erbschaft
klein	JJ	6	kleine, kleinen, kleiner
best	JJ	6	besten, beste
sprechen	VB	6	spricht, sprechen, sprach
andern	JJ, DT	6	andern
weiss	VB, RB	6	weiß
Art	NN	6	Art
vielleicht	IN, RB	6	vielleicht
Hochzeit	NN	6	Hochzeit
Tat	NN	6	Tat
Sachen	NN	6	Sachen
unsre	PRP$	6	unsre
Sache	NN	6	Sache
gross	JJ	6	großer, großen, groß
übel	JJ	6	übel
24	CD	6	24
bekommen	RB, VB	6	bekommen
weit	JJ	6	weit
Korb	NN	6	Korb
34	CD	6	34
Narre	NN	6	Narre
Hause	NN, JJ	6	Hause
Glück	NN	6	Glück
sehe	PRP$	6	sehe
weg	RP, RB	6	weg
versprechen	VB	5	verspricht, versprechen
Seite	NN	5	Seite
gehn	NN	5	gehn
Sies	RB	5	Sies
Narren	NN, JJ	5	Narren
unglücklich	JJ	5	unglücklich, unglückliche
Taler	NN	5	Taler
Hund	NN, NNP	5	Hund
Vermögen	NN	5	Vermögen
Ihrem	NN	5	Ihrem
ansehen	VB	5	ansieht, ansehen
dergleichen	PRP	5	dergleichen
richtig	JJ	5	richtig
Jahren	NN	5	Jahren
kaufen	VB, VBN	5	kauft, kaufte, kaufe, gekauft
Kopfe	NN	5	Kopfe
lachen	VB	5	lachst, lachen, lacht
recht	RB, NN, JJ	5	recht, rechter
Jungfern	NN	5	Jungfern
Soen	VBN, RB	5	So
Frauenzimmer	NN	5	Frauenzimmer
zehn	CD	5	zehn
eben	RB, IN	5	eben
Paar	NN, JJ	5	Paar
zwei	CD	5	zwei
adlich	JJ	4	adliches, adlichen
drei	CD	4	drei
Teufels	NN	4	Teufels
Stube	NN	4	Stube
niemand	DT	4	niemand
Gedanke	NNS	4	Gedanken
Gedicht	NN, NNS	4	Gedicht, Gedichte
dächte	NN	4	dächte
Geschlecht	NN	4	Geschlecht
läng	JJ	4	länger
Wechsel	NN	4	Wechsel
Sachte	PRP$	4	Sachte
glücklich	JJ	4	glücklichen, glücklich, glückliche
Stelle	NN	4	Stelle
Standes	NN	4	Standes
wert	RP	4	wert
fertig	JJ	4	fertig
dazuen	RB, VB	4	dazu
Makronen	NN	4	Makronen
einzig	NN, JJ	4	einzige, einzigen, einziger, einzig
zwanzig	CD	4	zwanzig
Menschen	NN	4	Menschen
einander	PRP	4	einander
Ehre	NN	4	Ehre
hast	NN	4	hast
900	CD	4	900
Unglück	NN	4	Unglück
Hölle	NN	4	Hölle
Adieu	NN	4	Adieu
lässen	VB	4	läßt
versteh	NN	4	versteh
bürgerlich	JJ	4	bürgerlichen
Händen	NN	4	Händen
dumm	JJ	4	dumme, dumm
Dank	IN, RP	4	Dank
Fehler	NN	4	Fehler
Manne	NN	4	Manne
allzu	RB	4	allzu
Hände	NN	4	Hände
gern	RB	4	gern
nochen	VBN, VB	4	noch
heisst	JJ, VB	4	heißt
Wolle	NNS	4	Wollen
Vertrauen	NN	4	Vertrauen
Stadt	NN	4	Stadt
Carmen	NN, NNP	4	Carmen
wünschen	VB	4	wünschen
et	NN	4	et
Schritte	NN, NNP	3	Schritte
neu	JJ	3	neue
verspreche	NN	3	verspreche
Person	JJ, NN	3	Person
hundert	CD	3	hundert
kehren	VB	3	kehren
erstemal	WRB, RB	3	erstemal
Gassenlied	NN	3	Gassenlied
Meister	NN, NNP	3	Meister
deiner	PRP$	3	deiner
Strasse	NN	3	Straße
laufen	VB	3	laufen, läuft
ihrem	PRP$	3	ihrem
Vergnügen	NN	3	Vergnügen
Hundsfott	NN	3	Hundsfott
Streich	NN, JJ	3	Streich, Streiche
Einfall	NN	3	Einfall
machst	RB, RP	3	machst
artigen	NN, VBN	3	artigen, artig
Zweifel	NN	3	Zweifel
borgen	VB	3	borgen, geborgt
Clitander	NNP, NN	3	Clitander
stecken	VB	3	stecken, steckt
Schulden	NN	3	Schulden
Willst	WRB	3	Willst
verstehen	VB, VBN	3	verstehen, verstanden
Pas	NN	3	Pas
sterben	VB	3	stirbt, sterben
kurz	JJ	3	kurz
spielen	VB	3	spielen
wirds	NN	3	wirds
Hand	NN	3	Hand
führen	VB	3	führen, führe
kosen	VB, VBN	3	kosten
Neuesen	VB, NN	3	Neues
fremden	PRP$, VB	3	fremden
25	CD	3	25
verzeihen	VB	3	verzeihen
herum	IN	3	herum
pap	NN	3	pap
Münzen	NN	3	Münzen
kennen	VB	3	kennen, kennt
besser	RP, RB	3	besser
Rock	NN	3	Rock
entsprossen	NN	3	entsprossen
breit	JJ	3	breiten, breit
Verzeihen	NN	3	Verzeihen
nachlaufen	NN	3	nachlaufen
Gesichte	NN	3	Gesichte
mirs	NN, JJ	3	mirs
alten	JJ, VB, NN	3	alt
Hast	NN	3	Hast
Rat	NN	3	Rat
nimmermehr	NN	3	nimmermehr
Komm	NN	3	Komm
Reden	NN	3	Reden
Haar	NNS, NN	3	Haare, Haar
stehn	NN	3	stehn
Neuigkeit	NN	3	Neuigkeit
gehören	RP, VBN, VB	3	gehört, gehöre
Hochwohlgeborne	NN	3	Hochwohlgeborne
wem	WP	3	wem
Tage	NN	3	Tage
Zimmer	NN	3	Zimmer
Schade	NN	3	Schade
Treppe	NNS, NN	3	Treppen, Treppe
helfen	VB	3	hilft, helfen
Himmel	NN	3	Himmel
weder	CC	3	weder
Leute	NN	3	Leute
Leben	NN	3	Leben
Runzeln	NN	3	Runzeln
gütig	JJ	3	gütig
Seele	NN	3	Seele
sachte	PRP$	3	sachte
erklären	VBN, RP	3	erklärt
befehlen	VB, VBN	3	befehlen, befohlen
genassen	VB	3	genießen
Krafttörtch	VB	3	Krafttörtchen
Sonst	NN	3	Sonst
verlangen	VB	3	verlangen
Höh	NN	3	Höh
besinne	NN	3	besinne
warten	VB	3	warten
Kompliment	NN	3	Kompliment
heraus	JJ, RP, RB	3	heraus
hinderlich	JJ	3	hinderlich
Dukaten	NN	3	Dukaten
arg	JJ	3	arg
setzen	VB	3	setzt
Rechnung	NN	3	Rechnung
sollst	WRB, RB	3	sollst
ziehen	VB	3	zieht, ziehn
Kopf	NN, NNS	3	Kopf, Köpfe
hintertreiben	VB	3	hintertreiben
Zuckerbretzeln	NN	3	Zuckerbretzeln
langen	VB, VBN	3	lange
etlich	DT, WDT	3	etliche
48	CD	3	48
46	CD	3	46
47	CD	3	47
44	CD	3	44
45	CD	3	45
jung	JJ	3	jung, jungen
uralt	JJ	3	uralten
Ehe	NN	2	Ehe
Galgenschwengel	NNP	2	Galgenschwengel
gesteh	NN	2	gesteh
voraus	RB, JJ	2	voraus
träumen	VB	2	träumen
versprach	NN	2	versprach
deutsch	JJ	2	deutsch, deutschen
toll	JJ	2	toll, tollen
Unglücke	NN	2	Unglücke
Freuden	NN	2	Freuden
Quodlibet	NN	2	Quodlibet
spät	JJ	2	spät
heirate	NN	2	heirate
anstehen	VB	2	ansteht
Ehestands	NN	2	Ehestands
höre	VB	2	höre
Stunde	NN	2	Stunde
Frage	NN	2	Frage
Weiss	NN	2	Weiß
deinem	NN	2	deinem
deinen	NN	2	deinen
Rechte	NN	2	Rechte
Stelzfuss	NN	2	Stelzfuß
Ware	NN, NNS	2	Ware, Waren
Corinna	NNP, NN	2	Corinna
stets	RB	2	stets
heissen	VB	2	heißen
Gebackensherumträger	NN	2	Gebackensherumträger
abgeschmackt	JJ	2	abgeschmackt
Geschlechte	NN	2	Geschlechte
Gemahlin	NN	2	Gemahlin
Spritzkuch	JJ, VB	2	Spritzkuchen
erdrossle	NN	2	erdroßle
Mache	NN	2	Mache
wirst	WRB	2	wirst
besen	VB	2	besten
Possen	NN	2	Possen
christlich	JJ	2	christlich, christlichen
schreiben	RP	2	geschrieben
weisst	NN	2	weißt
Wählen	NN	2	Wählen
fürchten	VB	2	fürchten
Wenigstens	NN	2	Wenigstens
Behüts	NN	2	Behüts
Abscheu	NN	2	Abscheu
Behüte	NN	2	Behüte
wider	TO, IN	2	wider
Schweig	JJ, RB	2	Schweig
Schuld	NN	2	Schuld
anzusehnen	VB	2	anzusehn
erzählen	VB	2	erzählen, erzähle
legen	VB, RP	2	legen, gelegt
ankommen	VBN, VB	2	ankommen
Bein	NN	2	Bein
ohngefähr	NN	2	ohngefähr
Spiegel	NN	2	Spiegel
Mägdgen	NN	2	Mägdgen
54	CD	2	54
50	CD	2	50
jaten	RP	2	ja
darausen	VB, RB	2	daraus
verdenken	NN	2	verdenken
Ho	NN	2	Ho
hundertmal	IN, RB	2	hundertmal
Orten	NN, JJ	2	Orten
Fuss	NN	2	Fuß
Rtlr	NN	2	Rtlr
zählen	VB	2	zählen
Nuren	RP, VBN	2	Nur
artige	NN	2	artige
verdammte	NN	2	verdammte
Stück	NN	2	Stück
Freundin	NN, NNS	2	Freundin, Freundinnen
Verhaft	NN	2	Verhaft
unbesonnen	NN	2	unbesonnen
Eben	NN	2	Eben
möglichen	VB	2	möglichen
Glauben	NN	2	Glauben
alleweile	NN	2	alleweile
verliebt	JJ, NN	2	verliebt, verliebte
schalkhaft	NN	2	schalkhaftem, schalkhaft
schwerlich	JJ	2	schwerlich
würdest	IN, WRB	2	würdest
anmutig	JJ	2	anmutig
darzuen	VB	2	darzu
liebern	VB	2	lieber
gestern	RB, IN	2	gestern
Sage	NN	2	Sage
beantworten	VB	2	beantworten
gewohnt	JJ	2	gewohnt
Leuten	NN	2	Leuten
missbrauchen	VB	2	mißbrauchen
Gesellschaft	NN	2	Gesellschaft
ärgern	VB	2	ärgern
halt	RP, VB	2	halt, halten
Torheit	NN	2	Torheit
halb	JJ	2	halbe, halben
versichre	NN	2	versichre
Schmaus	NN	2	Schmaus, Schmause
wollensen	MD	2	wollens
Inhalte	NN	2	Inhalte
behalten	VB, VBN	2	behalte, behalten
schlecht	JJ	2	schlecht
Kurz	NN	2	Kurz
nachzusagen	NN	2	nachzusagen
12	CD	2	12
Hals	NN	2	Hals
Halt	NN	2	Halt
Zähle	NN	2	Zähle
gekannt	NN	2	gekannt
Gedult	NN	2	Gedult
erstlich	JJ	2	erstlich
Herren	NN	2	Herren
Punkte	NN	2	Punkte
Weise	NN, NNP	2	Weise
dachts	RB	2	dachts
altem	NN	2	altem
1724	CD	2	1724
besorge	NN	2	besorge
verdammt	JJ	2	verdammter, verdammte
sichs	NN	2	sichs
trotzen	VB	2	trotzen
plötzlich	JJ	2	plötzlich
lehren	VB	2	lehren
vernünftigen	NN	2	vernünftigen
Ausdrückungen	NN	2	Ausdrückungen
verstehn	NN	2	verstehn
Thesin	NN	2	Thesin
unschuldiges	PRP$	2	unschuldiges
Neu	JJ, NN	2	Neues
besondre	NN	2	besondre
wärst	NN	2	wärst
nötigen	VBN, VB	2	nötig, nötigen
fein	JJ	2	feinen, fein
abfinden	VB	2	abfinden
ehe	CC	2	ehe
behüte	NN	2	behüte
Pfennig	NN	2	Pfennig
Exempel	NN	2	Exempel
Gelde	NN	2	Gelde
dreissig	CD	2	dreißig
antragen	NN	2	antragen
leid	JJ	2	leid
Gnade	NNS	2	Gnaden
stelle	NN	2	stelle
Bezahlung	NN	2	Bezahlung
alsdann	NNP	2	alsdann
aufs	NN, JJ	2	aufs
Habseligkeit	NN	2	Habseligkeit
widersprechen	VB	2	widersprechen
deutlich	JJ	2	deutlich
fünfzig	CD	2	fünfzig
wohnt	NN	2	wohnt
Leib	NN	2	Leib
26	CD	2	26
dirs	NN	2	dirs
kriegen	VB	2	kriegen
geringste	NN	2	geringste
Füssen	NNP	2	Füßen
Mannes	NN	2	Mannes
wagen	VB	2	wagen
Dienerin	NN	2	Dienerin
jen	DT, WDT	2	jenem, jener
Schlage	NN	2	Schlage
Mittel	NN	2	Mittel
werter	NN	2	werter
Wege	NN	2	Wege
notwendig	JJ	2	notwendig
Freiheit	NN	2	Freiheit
Hören	NN	2	Hören
Stande	NN	2	Stande
hie	JJ	2	hier
ersen	VB	2	erste
List	NN	2	List
Sorge	NN	2	Sorge
Irrtum	NN	2	Irrtum
Antworte	NN	2	Antworte
sehren	VB	2	sehr
Beistand	NN	2	Beistand
künftig	JJ	2	künftig, künftigen
tanzen	VB	2	tanzen
finden	VB	2	finden, gefunden
fürchte	NN	2	fürchte
Schämen	NN	2	Schämen
rechten	NN	2	rechten
bös	JJ	2	böse
Ohren	NN	2	Ohren
acht	CD	2	acht
funfzig	JJ	2	funfzig
Bart	NN, NNP	2	Bart
Gesicht	NN	2	Gesicht
schaffen	VB	2	schafft, schaffen
Verfluchter	NN	2	Verfluchter
Schicksal	NN	2	Schicksal
Nacht	NN	2	Nacht
holen	VB	2	holen
Nachdenken	NN	2	Nachdenken
Wein	NN	2	Wein
hintenraus	NN	2	hintenraus
stünde	NN	2	stünde
Augen	NN	2	Augen
entgegen	IN, RP	2	entgegen
Freier	NN	2	Freier
verstehens	NN	2	verstehens
schön	JJ	2	schönes, schön
Nase	NN	2	Nase
Beschreibung	NN	2	Beschreibung
Verstand	NN	2	Verstand
tief	JJ	2	tief, tiefer
ausdrücken	VB	2	ausdrücken
dreifach	JJ	2	dreifachen
bins	NN	2	bins
Hypothesin	NN	2	Hypothesin
Cabinet	NN	2	Cabinet
Vers	NN	2	Vers
bekennen	VB	2	bekannt, bekennen
reizende	NN	2	reizende
Narr	NN	2	Narr
Rede	NN, JJ	2	Rede
Stärke	NN	2	Stärke
hättest	WRB	2	hättest
seiner	PRP$	2	seiner
vorhin	RB	2	vorhin
ists	NN	2	ists
Gebackens	NN	2	Gebackens
stehen	VB	2	steht, stehe
verfluchte	NN	2	verfluchte
Vielleicht	RB	2	Vielleicht
leben	VB	2	lebe, leben
zeigen	VB	2	zeigen
vier	CD	2	vier
rechtschaffene	NN	2	rechtschaffene
gefallen	VB, VBN	2	gefallen
Billard	NN	2	Billard
allerliebste	NN	2	allerliebste
suchen	VB	2	suchen
gebe	NN, NNP	2	gebe
Geh	NN	2	Geh
Überlegung	NN	2	Überlegung
Tanzen	NN	2	Tanzen
zanken	NN	2	zanken
alleine	NN	2	alleine
schw	JJ	2	schwer
oft	RB	2	oft
unterschiedene	NN	2	unterschiedene
Gelegenheit	NN	2	Gelegenheit
Gabe	NN	2	Gabe
Spötterei	NN	2	Spötterei
fahren	VB	2	fahren, gefahren
Jugend	NN	2	Jugend
freilich	RP, RB	2	freilich
schmeckt	NN	2	schmeckt
nuren	VB	2	nur
Gewiss	UH	2	Gewiß
treten	VB	2	treten
beisammen	NN	2	beisammen
ins	IN, RB	2	ins
Schimpf	NN	2	Schimpf
Mensch	NN	2	Mensch
höchste	NN, NNP	2	höchste
allein	RB	2	allein
hats	NN	1	hats
schöne	NN	1	schöne
könnt	JJ	1	könnte
Kleid	NNS	1	Kleider
drauf	RB	1	drauf
Eure	NN	1	Eure
Könntest	NN	1	Könntest
draus	NN	1	draus
Platz	NN	1	Platz
vergessen	VBN	1	vergessen
jemals	RB	1	jemals
vertraut	JJ	1	vertraut
Wörtchen	NN	1	Wörtchen
desperat	NN	1	desperat
angewanden	VBN	1	angewandt
entschliessen	VB	1	entschließen
Frisch	JJ	1	Frisch
dennen	RB	1	denn
Figur	NN	1	Figur
zuzuhören	NNP	1	zuzuhören
irrst	NN	1	irrst
Wasser	NN	1	Wasser
annehmen	VB	1	annehmen
Bräutigams	NN	1	Bräutigams
vollens	NN	1	vollens
allzuwohl	CC	1	allzuwohl
steckt	VB	1	steckt
gottlos	NN	1	gottlos
Erzürne	NN	1	Erzürne
Länder	NN	1	Länder
desselben	NNP	1	desselben
Gefälligkeit	NN	1	Gefälligkeit
wertesten	NN	1	wertesten
hartnäckig	JJ	1	hartnäckig
hieren	RB	1	hier
glühende	NN	1	glühende
wertester	NN	1	wertester
arme	JJ	1	arme
verflossen	NN	1	verflossen
holt	VB	1	holte
90	CD	1	90
bissgen	NN	1	bißgen
bringe	VB	1	bringe
gewaltig	JJ	1	gewaltig
Text	NN	1	Text
Sara	NNP	1	Sara
Würde	NN	1	Würde
anstehet	NN	1	anstehet
Zuckerlecken	NN	1	Zuckerlecken
Feinden	NN	1	Feinden
verfertiget	NNP	1	verfertiget
Kätz	NN	1	Kätz
Feindes	NN	1	Feindes
antreffen	NN	1	antreffen
hölzerne	NN	1	hölzerne
böses	NN	1	böses
verstellt	NN	1	verstellt
Alt	JJ	1	Alte
stössen	VB	1	stößt
Nachbarschaft	NN	1	Nachbarschaft
gütige	NN	1	gütige
Trost	NN	1	Trost
Blut	NN	1	Blut
Gutheit	NN	1	Gutheit
Wille	NN	1	Wille
Nichtswitz	NN	1	Nichtswitz
Antwort	NN	1	Antwort
Anstalt	NN	1	Anstalt
gönne	NN	1	gönne
tragen	PRP$	1	tragen
Herz	NNS	1	Herzen
Hie	RB	1	Hier
Motion	NN	1	Motion
Wette	NNS	1	Wetten
Annehmlichkeiten	NN	1	Annehmlichkeiten
Gerichtsherr	NN	1	Gerichtsherr
geweissen	VB	1	gewiß
Tändelei	JJ	1	Tändelei
Dero	NN	1	Dero
Behalten	NN	1	Behalten
Dutzend	NN	1	Dutzend
Spitzenmanne	NN	1	Spitzenmanne
Schande	NN	1	Schande
probiert	NN	1	probiert
Unvergleichlicher	NN	1	Unvergleichlicher
Madame	NN	1	Madame
Fenstern	NN	1	Fenstern
entschloss	JJ	1	entschlossen
Köpfchen	NN	1	Köpfchen
feurige	NN	1	feurige
frei	JJ	1	frei
Bauch	NN	1	Bauch
brauchen	VB	1	brauchen
weniger	RP	1	weniger
verruckt	NN	1	verruckt
verschont	NN	1	verschont
versöhnen	VB	1	versöhnen
angehen	VB	1	angeht
Seiner	PRP$	1	Seiner
vorgehen	VB	1	vorgeht
allenfalls	RB	1	allenfalls
lege	NN	1	lege
Verkleidung	NN	1	Verkleidung
herkommen	VB	1	herkommen
Darfst	NN	1	Darfst
Närrin	NN	1	Närrin
Prügel	NN	1	Prügel
Bedienten	NN	1	Bedienten
nahe	IN	1	nahe
nutzen	VB	1	nutzen
vielem	NN	1	vielem
sonen	VBN	1	sonst
Nichtswürdiger	NNP	1	Nichtswürdiger
verraten	VB	1	verraten
Gang	NN	1	Gang
Sei	NN	1	Sei
Holla	NN	1	Holla
galante	NN	1	galante
Säkulumen	NN	1	Säkulum
leugnen	VB	1	leugnen
hingehen	NNP	1	hingehen
Miseriam	JJ	1	Miseriam
Tochter	JJ	1	Tochter
Unwillen	NN	1	Unwillen
Seid	NN	1	Seid
zerplatzen	NN	1	zerplatzen
Sinne	JJ	1	Sinne
singen	VBN	1	gesungen
Jahre	NN	1	Jahre
Spritzkuchen	VB	1	Spritzkuchen
liest	NN	1	liest
Verbindung	NN	1	Verbindung
sollens	NN	1	sollens
schenken	VBN	1	geschenkt
sagt	RB	1	sagt
Plunder	NN	1	Plunder
schmeckte	NN	1	schmeckte
Wenns	NN	1	Wenns
erschaffen	VB	1	erschaffen
Hindernis	NN	1	Hindernis
befindest	WRB	1	befindest
ziert	NN	1	ziert
17	CD	1	17
Betrieb	NN	1	Betrieb
ausführen	VB	1	ausführen
Capitains	NN	1	Capitains
wichtigst	JJ	1	wichtigsten
Naschmaul	NN	1	Naschmaul
fangen	VB	1	fängst
irr	JJ	1	irre
Maule	NN	1	Maule
Gewohnheit	NN	1	Gewohnheit
Geschicklichkeit	NN	1	Geschicklichkeit
achtzig	CD	1	achtzig
zerfallen	VB	1	zerfallen
sagten	NN	1	sagten
untüchtig	JJ	1	untüchtig
ungemein	NN	1	ungemein
wohlen	VB	1	wohl
Consequens	NN	1	Consequens
fürstlich	JJ	1	fürstliche
kennst	NN	1	kennst
Danken	NN	1	Danken
natürliche	NNP	1	natürliche
gescheit	JJ	1	gescheiten
gebührende	NN	1	gebührende
Beispiele	NN	1	Beispiele
valten	VBN	1	viel
belieben	NN	1	belieben
heiss	JJ	1	heiß
Feldzuge	NN	1	Feldzuge
fest	RB	1	fest
verflucht	JJ	1	verflucht
artiger	NN	1	artiger
geschiedene	JJ	1	geschiedene
Nebenzimmer	NN	1	Nebenzimmer
Erlaubnis	NN	1	Erlaubnis
Willkommen	NN	1	Willkommen
lärmen	NN	1	lärmen
überhören	NN	1	überhören
Nam	JJ	1	Nam
Krankheit	NN	1	Krankheit
wievielste	WP	1	wievielste
Wärst	NN	1	Wärst
Obgleich	NN	1	Obgleich
ausser	IN	1	außer
anhängen	NN	1	anhängen
Reichtum	NN	1	Reichtum
ehrliebender	NN	1	ehrliebender
wüsste	NN	1	wüßte
nie	RB	1	nie
jetzo	NN	1	jetzo
Clarice	NN	1	Clarice
Garten	NN	1	Garten
angekommen	NN	1	angekommen
Leutgen	NN	1	Leutgen
Tänze	NN	1	Tänze
Kriegsmann	NN	1	Kriegsmann
Darinne	NN	1	Darinne
wärest	RP	1	wärest
lasst	RP	1	laßt
just	JJ	1	just
Streit	NN	1	Streit
anderm	NN	1	anderm
aufgeschlagen	NN	1	aufgeschlagen
Musen	NN	1	Musen
entschliess	VB	1	entschließen
Herausgehen	NN	1	Herausgehen
gewinnen	RP	1	gewonnen
Gar	NN	1	Gar
sitzen	VB	1	sitzen
beschweren	VB	1	beschweren
Sagen	NN	1	Sagen
vorteilhafte	NN	1	vorteilhafte
Orte	NN	1	Orte
unten	RB	1	unten
Kohle	NNS	1	Kohlen
Adlich	JJ	1	Adlichen
Appetitlich	JJ	1	Appetitliche
drucken	VB	1	drucken
Vogel	NN	1	Vogel
Gedulden	NN	1	Gedulden
schwarz	JJ	1	schwarzer
Arm	NNS	1	Arme
darzu	RB	1	darzu
mannbares	NN	1	mannbares
ekel	NN	1	ekel
Stell	NN	1	Stelle
Ewr	NN	1	Ewr
verwünschte	NN	1	verwünschte
Quark	NN	1	Quark
schalkhaftem	NN	1	schalkhaftem
stiften	VBN	1	gestiftet
Versprechen	NN	1	Versprechen
Grab	NN	1	Grab
aufgesucht	NN	1	aufgesucht
erbaulich	JJ	1	erbaulich
Schuh	JJ	1	Schuh
drückt	NN	1	drückt
Komödie	NN	1	Komödie
gedient	NN	1	gedient
majestätischer	NN	1	majestätischer
Vorschläge	NN	1	Vorschläge
Topp	NN	1	Topp
geschieht	JJ	1	geschieht
hübsch	JJ	1	hübsch
ohnedem	RB	1	ohnedem
nähme	NN	1	nähme
liesse	NN	1	ließe
leiden	VB	1	leiden
Bauer	NN	1	Bauer
Fenster	NN	1	Fenster
beeissen	VB	1	beißen
stürmisch	JJ	1	stürmisch
dringend	JJ	1	dringend
Eheleute	NN	1	Eheleute
ausgelesen	NN	1	ausgelesen
dacht	VB	1	dachte
Partie	NN	1	Partie
gelegnerer	NN	1	gelegnerer
Fleischerhund	NN	1	Fleischerhund
niederträchtige	NN	1	niederträchtige
beiseite	NN	1	beiseite
Blicke	NN	1	Blicke
geschehn	NN	1	geschehn
Weisen	NN	1	Weisen
mild	JJ	1	milde
sieht	VB	1	sieht
Ostern	NN	1	Ostern
herzlich	JJ	1	herzlich
überlegt	JJ	1	überlegt
Dahintern	RB	1	Dahinter
tust	NN	1	tust
deswegen	RB	1	deswegen
mache	NN	1	mache
hurtiger	NN	1	hurtiger
Hochzeitabend	JJ	1	Hochzeitabend
Schlusse	NN	1	Schlusse
Tagen	NN	1	Tagen
Grossmut	NN	1	Großmut
Wen	NN	1	Wen
Wem	NN	1	Wem
zukünftig	JJ	1	zukünftigen
Wahl	NN	1	Wahl
unterbringe	NN	1	unterbringe
Tag	NN	1	Tag
flucht	NN	1	flucht
Grabe	NN	1	Grabe
Glaubst	NN	1	Glaubst
Narrenspossen	NN	1	Narrenspossen
gelinder	NN	1	gelinder
fehlen	VB	1	fehlt
übrige	NN	1	übrige
Vorstellen	NN	1	Vorstellen
Töpfen	NN	1	Töpfen
benennen	VB	1	benennen
Appetit	NN	1	Appetit
unbekümmern	JJ	1	unbekümmert
Unrecht	NN	1	Unrecht
Ehestand	NN	1	Ehestand
Franzose	NNS	1	Franzosen
zuziehen	VB	1	zuzieht
Benennung	NN	1	Benennung
einziges	NN	1	einziges
abgewonnen	NN	1	abgewonnen
michs	NN	1	michs
Erbaulich	RB	1	Erbaulich
Ihres	NN	1	Ihres
bange	NN	1	bange
Verlangen	NN	1	Verlangen
Warte	NN	1	Warte
Gange	NN	1	Gange
stören	VB	1	stören
vorsagte	NN	1	vorsagte
Vorsehung	NN	1	Vorsehung
gewinnt	NN	1	gewinnt
lesen	VBN	1	gelesen
Sehen	VB	1	Sieht
Felde	NN	1	Felde
schaden	VB	1	schadet
habt	NN	1	habt
lächerlich	JJ	1	lächerlich
bezeigen	NN	1	bezeigen
worüber	RB	1	worüber
Hörest	NN	1	Hörest
unsern	PRP$	1	unsern
Lied	NNS	1	Lieder
Männersucht	NN	1	Männersucht
Sapienti	NN	1	Sapienti
Krame	NN	1	Krame
zwölfte	CD	1	zwölfte
Korbe	NN	1	Korbe
Jungf	JJ	1	Jungfer
hoffen	VB	1	hoffe
wässrig	JJ	1	wäßrig
Traktaten	NN	1	Traktaten
sauren	NN	1	sauren
grob	JJ	1	grobes
Bettler	NN	1	Bettler
zehnte	CD	1	zehnte
Vier	CD	1	Vier
vorenthalten	NN	1	vorenthalten
Warten	NN	1	Warten
Unwissenheit	NN	1	Unwissenheit
Probe	NN	1	Probe
unbesonnene	NN	1	unbesonnene
ausgäbst	NN	1	ausgäbst
bedenkst	NN	1	bedenkst
Gelegenheien	NN	1	Gelegenheiten
richtigen	VBN	1	richtig
lachende	NN	1	lachende
bescheiden	JJ	1	bescheidener
Kräusel	RB	1	Kräusel
entbehren	VB	1	entbehren
bunt	RB	1	bunt
Grube	NN	1	Grube
Flegel	NN	1	Flegel
ehern	VBN	1	eher
not	FW	1	not
umzugehen	NN	1	umzugehen
erwerben	VBN	1	erworben
Aufsetzerin	NN	1	Aufsetzerin
Erstlich	JJ	1	Erstlich
eingeständig	JJ	1	eingeständig
Affengesichte	NN	1	Affengesichte
verzeihe	NN	1	verzeihe
Ordnung	NN	1	Ordnung
Holländern	NN	1	Holländern
Prozent	NN	1	Prozent
schmecken	VBN	1	geschmeckt
Kapitel	NN	1	Kapitel
Theater	NN	1	Theater
Lauf	NN	1	Lauf
unvergleichlicher	NN	1	unvergleichlicher
Geschmacke	NN	1	Geschmacke
zweit	JJ	1	zweiten
umhängen	NN	1	umhängen
Licht	NN	1	Licht
ehlich	JJ	1	ehlichen
zittre	NN	1	zittre
unvernünftiges	NN	1	unvernünftiges
unvernünftiger	NN	1	unvernünftiger
währen	VB	1	währen
Post	NN	1	Post
treib	VB	1	treiben
ansehnlich	JJ	1	ansehnlichen
unterlassen	VBN	1	unterlassen
Zweifelst	WRB	1	Zweifelst
Laster	NN	1	Laster
Stehen	VB	1	Steht
16	CD	1	16
19	CD	1	19
gehe	NN	1	gehe
sechs	CD	1	sechs
unterdessen	NN	1	unterdessen
Kennzeichen	NN	1	Kennzeichen
geht	VB	1	geht
Närrchen	VB	1	Närrchen
Bürger	NN	1	Bürger
sahen	NN	1	sahen
neulich	RB	1	neulich
ausgeschlafen	NN	1	ausgeschlafen
sau	JJ	1	sauer
sat	NN	1	sat
Rechthaberin	JJ	1	Rechthaberin
gehörige	NN	1	gehörige
Name	NN	1	Name
Cabinetstückchen	VB	1	Cabinetstückchen
falle	NN	1	falle
verdienen	VB	1	verdient
Brunette	NN	1	Brunette
Erinnern	NN	1	Erinnern
lernen	VB	1	lernen
wunderbar	JJ	1	wunderbar
Weg	NN	1	Weg
Dichter	NN	1	Dichter
fassen	VB	1	fassen
Gesetzt	NN	1	Gesetzt
unverständiger	NNP	1	unverständiger
Drittens	NN	1	Drittens
König	NN	1	König
otia	JJ	1	otia
Männer	NN	1	Männer
Ärgste	NN	1	Ärgste
Diensten	NN	1	Diensten
wüsstest	NN	1	wüßtest
bekümmern	NN	1	bekümmern
merken	VB	1	merkt
Aufzugs	NN	1	Aufzugs
süsse	NN	1	süße
geh	NN	1	geh
Männern	JJ	1	Männern
brauchst	NN	1	brauchst
Zumal	RB	1	Zumal
Tochtermann	NNP	1	Tochtermann
erkundigen	VB	1	erkundigen
lebhaft	JJ	1	lebhafte
einst	WRB	1	einst
Ecke	JJ	1	Ecke
Wache	NN	1	Wache
einräumen	VB	1	einräumen
kriegerisch	JJ	1	kriegerische
Kellertür	NN	1	Kellertür
versichere	NN	1	versichere
Hitze	NN	1	Hitze
Anspruch	NN	1	Anspruch
gottlose	NN	1	gottlose
Werk	NN	1	Werk
mans	JJ	1	mans
22	CD	1	22
Glücke	NN	1	Glücke
beklagen	VB	1	beklagen
zerlappte	NN	1	zerlappte
jemanden	NN	1	jemanden
einfallen	VB	1	einfallen
beissenden	NN	1	beißenden
beiderseits	NN	1	beiderseits
Kehren	NN	1	Kehren
Grobheit	NN	1	Grobheit
erlösen	VB	1	erlösen
Kannst	NN	1	Kannst
Raserei	NN	1	Raserei
Ohrfeige	NN	1	Ohrfeige
500	CD	1	500
Verbeugung	NN	1	Verbeugung
Schuldhausen	NN	1	Schuldhausen
einfinden	VB	1	einfinden
Unmöglich	JJ	1	Unmöglich
Intressen	NN	1	Intressen
Vorhaben	NN	1	Vorhaben
Ernsthaften	NN	1	Ernsthaften
Menuet	NN	1	Menuet
ginge	NN	1	ginge
krank	JJ	1	krank
Dennen	RB	1	Denn
nächst	JJ	1	nächste
Anstiften	JJ	1	Anstiften
Dokumente	NN	1	Dokumente
Erwägung	NN	1	Erwägung
Mund	NN	1	Mund
besitze	NN	1	besitze
eigennützig	JJ	1	eigennützig
lüderlich	JJ	1	lüderlichen
geniessen	VB	1	genossen
Schatzes	JJ	1	Schatzes
anderwärts	NN	1	anderwärts
Erzeigen	NN	1	Erzeigen
seufzet	NN	1	seufzet
poetisch	JJ	1	poetisch
Abend	NN	1	Abend
Zeile	NN	1	Zeile
erzeugen	VBN	1	erzeugt
vertrösten	NN	1	vertrösten
Anderns	NN	1	Anderns
parat	JJ	1	parat
beneidenswert	NN	1	beneidenswert
erkenntlich	JJ	1	erkenntlich
gering	NN	1	geringe
gestossen	VBN	1	gestoßen
Lächerlichesen	JJ	1	Lächerliches
Geschwist	JJ	1	Geschwister
mannbar	JJ	1	mannbare
Montierung	NN	1	Montierung
Österreichern	NN	1	Österreichern
garen	VB	1	gar
Gulden	NN	1	Gulden
hinbegeben	NN	1	hinbegeben
bemühen	VB	1	bemühen
meines	IN	1	meines
hierinnen	NN	1	hierinnen
suche	NN	1	suche
Satiren	NN	1	Satiren
schamhaft	NN	1	schamhaft
gestrige	NN	1	gestrige
fragen	VB	1	fragen
übertreffen	RP	1	übertroffen
Schlesien	NNP	1	Schlesien
gebrauchen	VB	1	gebrauchen
Allusion	NN	1	Allusion
ach	UH	1	Ach
historischem	NN	1	historischem
diejenig	DT	1	diejenigen
Bloss	NN	1	Bloß
mannhafter	NN	1	mannhafter
deutlichen	NN	1	deutlichen
Vaterland	NN	1	Vaterland
Gefiel	NN	1	Gefiel
Zweck	NN	1	Zweck
Schuldmann	NNP	1	Schuldmann
Widerstehen	NN	1	Widerstehen
aufgesetzt	NN	1	aufgesetzt
eingehen	VB	1	eingehen
schönes	NN	1	schönes
nützlicher	JJ	1	nützlicher
geirrt	NN	1	geirrt
erlangt	VB	1	erlangt
erinnern	VB	1	erinnern
vors	JJ	1	vors
Verrichtungen	NN	1	Verrichtungen
kleiden	VBN	1	gekleidet
Freiersmann	NNP	1	Freiersmann
satyrischem	NN	1	satyrischem
sagst	NN	1	sagst
haben.ende	NN	1	haben.Ende
vorsagen	RP	1	vorsagt
Stücks	NN	1	Stücks
Edelmannen	NN	1	Edelmannen
Beschwerlichkeiten	NN	1	Beschwerlichkeiten
Gottes	NN	1	Gottes
Entzückung	NN	1	Entzückung
leisten	VB	1	leisten
Musae	NN	1	Musae
gibts	NN	1	gibts
Freigeister	NN	1	Freigeister
unsrer	PRP$	1	unsrer
leichtsinniger	NNP	1	leichtsinniger
feste	NNP	1	feste
Traum	NN	1	Traum
dienen	VB	1	dienen
Übels	NN	1	Übels
müsste	VB	1	müßte
tu	NN	1	tu
Entschliessung	NNS	1	Entschließungen
darnachen	VB	1	darnach
steckten	NN	1	steckten
Lisette.Ende	NN	1	Lisette.Ende
vorhinen	JJ	1	vorhin
Rücken	NN	1	Rücken
glaube	VB	1	glaube
laut	JJ	1	lauter
Feinheit	NN	1	Feinheit
teu	JJ	1	teuer
unterstehen	NN	1	unterstehen
Liebhaber	NN	1	Liebhaber
beständige	NN	1	beständige
manch	JJ	1	manchem
Türe	NN	1	Türe
Lehre	NN	1	Lehre
Körper	NN	1	Körper
Freunden	NN	1	Freunden
heben	VB	1	hebt
treffen	VB	1	treffen
übern	NN	1	übern
Gedulde	NN	1	Gedulde
Pfui	NN	1	Pfui
Mühe	NN	1	Mühe
nachkommen	VB	1	nachkommen
fernern	NN	1	fernern
Tod	NN	1	Tod
geschehen	VBN	1	geschehen
darum	RB	1	darum
Offizier	NN	1	Offizier
Apfel	NN	1	Apfel
Universalerbe	NN	1	Universalerbe
hingehn	NN	1	hingehn
Grillen	NN	1	Grillen
Verziehen	NN	1	Verziehen
bedauren	NN	1	bedauren
Adel	NN	1	Adel
verlieren	VB	1	verlöre
biete	NN	1	biete
anderswo	IN	1	anderswo
abgekauft	NN	1	abgekauft
beitragen	VBN	1	beigetragen
Recht	NN	1	Recht
Injurie	NN	1	Injurie
wegkomme	NN	1	wegkomme
gekrönt	JJ	1	gekrönten
rasend	JJ	1	rasend
Meisterstück	NN	1	Meisterstück
Stoss	NN	1	Stoß
willens	JJ	1	willens
Schlingel	NN	1	Schlingel
vorläufig	JJ	1	vorläufig
gehabt	NN	1	gehabt
dreimal	RB	1	dreimal
Übergänge	NN	1	Übergänge
mitzuteilen	NN	1	mitzuteilen
allerliebstes	NN	1	allerliebstes
allerliebster	NN	1	allerliebster
Jawort	NN	1	Jawort
leichte	NN	1	leichte
Alter	NN	1	Alter
bezahle	NN	1	bezahle
altes	NN	1	altes
Erb	TRUNC	1	Erb-
gewartet	NN	1	gewartet
gespielt	NN	1	gespielt
nenne	VB	1	nenne
Ermunterung	NN	1	Ermunterung
Bessers	NN	1	Bessers
verzweifelte	NN	1	verzweifelte
Gutes	NN	1	Gutes
Lumpenhund	NN	1	Lumpenhund
erlauben	VB	1	erlauben
Mut	NN	1	Mut
abzuhelfen	VB	1	abzuhelfen
schimpfen	VB	1	schimpfen
bedeuten	VB	1	bedeuten
fasste	NN	1	faßte
allerliebst	JJ	1	allerliebste
verführst	NN	1	verführst
unerträglich	JJ	1	unerträglich
Muster	NN	1	Muster
Schatz	NN	1	Schatz
Schritt	NN	1	Schritt
natürlichen	IN	1	natürlichen
Eh	NN	1	Eh
ertragen	VB	1	ertragen
Brot	NNS	1	Brote
irren	VB	1	irren
höchst	JJ	1	höchst
Schalkhaften	NN	1	Schalkhaften
beschlagen	VB	1	beschlagen
Vaters	NN	1	Vaters
Geplaudre	NNP	1	Geplaudre
verzweifelten	NN	1	verzweifelten
gewöhnt	NN	1	gewöhnt
nennen	VB	1	nennen
Ehekrüpel	NN	1	Ehekrüpel
aufbringen	VB	1	aufbringen
Zettel	NN	1	Zettel
Rechten	NN	1	Rechten
nackigte	NN	1	nackigte
jetzig	JJ	1	jetziger
Eheteufel	NN	1	Eheteufel
Bekomme	NN	1	Bekomme
Falsche	NN	1	Falsche
Umstand	NNS	1	Umstände
Ursache	NN	1	Ursache
Poesie	JJ	1	Poesie
Neuigkeiten	NN	1	Neuigkeiten
beständig	JJ	1	beständig
steht	VB	1	steht
beisst	NN	1	beißt
Mutter	NN	1	Mutter
selb	DT	1	selber
unrecht	JJ	1	unrecht
Adlicher	NN	1	Adlicher
vorige	NN	1	vorige
hitzig	JJ	1	hitzig
theologisch-polemisch-poetisch	JJ	1	theologisch-polemisch-poetischen
Ratschlägen	NN	1	Ratschlägen
Verächter	NN	1	Verächter
Geldborgern	NN	1	Geldborgern
Klügste	NN	1	Klügste
unserer	PRP$	1	unserer
Bedingungen	NN	1	Bedingungen
antworen	VB	1	antworten
hervortut	NN	1	hervortut
Immern	VB	1	Immer
Titel	NN	1	Titel
Held	NNS	1	Helden
gelb	JJ	1	gelber
redst	NN	1	redst
anakreontisch	JJ	1	anakreontische
manchmal	RB	1	manchmal
arm	JJ	1	armes
seh	PRP$	1	seh
auchen	VB	1	auch
jünger	NN	1	jünger
Lehn	TRUNC	1	Lehn-
klug	JJ	1	klug
Katze	NN	1	Katze
Ohre	NN	1	Ohre
lass	JJ	1	laß
Quere	NN	1	Quere
finde	NN	1	finde
Stossen	NN	1	Stoßen
Tode	NN	1	Tode
Schaden	NN	1	Schaden
Zank	NN	1	Zank
neinen	RP	1	nein
abgesetzte	NN	1	abgesetzte
zusammen	RP	1	zusammen
abgedankten	NN	1	abgedankten
walten	NN	1	walten
Tags	NN	1	Tags
Sprung	NNS	1	Sprünge
hinters	NN	1	hinters
reisst	VB	1	reißt
Erschrak	NN	1	Erschrak
zugezählt	NN	1	zugezählt
scribentis	NN	1	scribentis
Neidisch	JJ	1	Neidische
heute	RB	1	heute
Ding	NN	1	Ding
abfertigen	NN	1	abfertigen
verewiget	NN	1	verewiget
abern	VBN	1	aber
Reihen	NN	1	Reihen
Engländern	NN	1	Engländern
möchten	VB	1	möchten
sicherer	NN	1	sicherer
Äussere	NN	1	Äußere
bekomme	NN	1	bekomme
Arbeit	NN	1	Arbeit
Besuch	NN	1	Besuch
Hausrat	NN	1	Hausrat
beweisen	VB	1	beweisen
verhasst	NN	1	verhaßt
Rekommendation	NN	1	Rekommendation
andermal	RB	1	andermal
Gehn	NN	1	Gehn
eure	NN	1	eure
herumspringen	NN	1	herumspringen
bringst	NN	1	bringst
dreien	NN	1	dreien
fällen	VBN	1	fällt
beschäftigen	VB	1	beschäftiget
Schätzchen	NN	1	Schätzchen
wohlgetroffenen	NN	1	wohlgetroffenen
Wirst	WRB	1	Wirst
rechte	NN	1	rechte
Dienst	NN	1	Dienst
Monaten	NN	1	Monaten
balden	RB	1	bald
Zeiten	NN	1	Zeiten
Weibchen	NN	1	Weibchen
Schamröte	NN	1	Schamröte
Beredsamkeit	NN	1	Beredsamkeit
Redens	NN	1	Redens
Erbe	NNS	1	Erben
Denken	NN	1	Denken
Zufall	NN	1	Zufall
Armingen	NN	1	Armingen
Ehemänner	NN	1	Ehemänner
Wahrlich	JJ	1	Wahrlich
hinter	IN	1	hinter
verderbst	NN	1	verderbst
dümmer	NN	1	dümmer
eitel	JJ	1	eitel
Nehmen	VB	1	Nehmen
verziehen	VB	1	verziehen
Freuen	NN	1	Freuen
begegnete	NN	1	begegnete
Freiers	NNP	1	Freiers
Pack	NN	1	Pack
Gefallen	NN	1	Gefallen
dulden	VB	1	dulden
stückweise	NN	1	stückweise
Menge	NN	1	Menge
einfliessen	NN	1	einfließen
gescheite	NN	1	gescheite
stossen	VB	1	stoßen
verfahren	VB	1	verfahren
Schwanze	NN	1	Schwanze
vorbringen	RP	1	vorbringt
herrscht	NN	1	herrscht
eindringen	VB	1	eindringen
Machts	NN	1	Machts
sähe	NN	1	sähe
Plappermaul	NN	1	Plappermaul
blühenden	JJ	1	blühenden
Gemütsart	NNP	1	Gemütsart
Hauptpunkten	NN	1	Hauptpunkten
Lernen	NN	1	Lernen
Betragen	NN	1	Betragen
Frauenzimmern	NN	1	Frauenzimmern
gesehn	NN	1	gesehn
Namens	NN	1	Namens
Überflusse	NN	1	Überflusse
Frauenzimmers	NN	1	Frauenzimmers
willen	IN	1	willen
Tu	NN	1	Tu
sichern	PRP$	1	sichern
Kerlen	NN	1	Kerlen
goldnes	JJ	1	goldnes
erteilen	VB	1	erteilt
gottloses	JJ	1	gottloses
jüngst	NN	1	jüngst
Gewissers	NN	1	Gewissers
eurer	NN	1	eurer
Anlass	NN	1	Anlaß
lang	JJ	1	lang
dächten	NN	1	dächten
verzählt	NN	1	verzählt
strafbar	JJ	1	strafbar
Ausnahme	NN	1	Ausnahme
vieren	NN	1	vieren
Cabinettüre	NN	1	Cabinettüre
letzt	JJ	1	letzten
Halse	NN	1	Halse
Stückgen	JJ	1	Stückgen
höflicher	NN	1	höflicher
Familie	NN	1	Familie
Ergebene	NN	1	Ergebene
Anno	NN	1	Anno
Jahrs	NN	1	Jahrs
ältest	JJ	1	ältesten
Kunst	NN	1	Kunst
Widersprechen	VB	1	Widersprechen
wenigstens	RB	1	wenigstens
Hexe	NN	1	Hexe
Arrest	NN	1	Arrest
folg	VB	1	folgen
eigensinnig	RB	1	eigensinnig
hochadlich	JJ	1	hochadliches
gestehen	VB	1	gestehen
Bruder	NNP	1	Bruder
Müssiggänger	NN	1	Müßiggänger
Dingergen	NN	1	Dingergen
Einwilligung	NN	1	Einwilligung
denke	RB	1	denke
Seeln	VB	1	Seelen
englisch	JJ	1	englisches
30	CD	1	30
Hochzeitcarmen	NN	1	Hochzeitcarmen
voll	JJ	1	voll
Finger	NN	1	Finger
verdammter	NN	1	verdammter
anwende	NN	1	anwende
Wohl	RB	1	Wohl
Hut	NN	1	Hut
Gestern	NN	1	Gestern
Angriff	NN	1	Angriff
versöhnt	NN	1	versöhnt
Weiber	NN	1	Weiber
Madam	JJ	1	Madam
begreifen	VB	1	begreife
vergraben	VB	1	vergraben
Sachse	NNS	1	Sachsen
Worinne	NN	1	Worinne
Taufschein	NN	1	Taufschein
Zahn	NNS	1	Zähne
erbaulichem	NN	1	erbaulichem
treffe	NN	1	treffe
widerrufst	NN	1	widerrufst
fortpflanzen	VB	1	fortpflanzen
darinn	JJ	1	darinne
verschwendrisch	JJ	1	verschwendrischen
dafüren	VB	1	dafür
danken	VB	1	danken
Erklärung	NN	1	Erklärung
rechtschaffner	JJ	1	rechtschaffner
hätten	RB	1	hätten
Mademoisell	JJ	1	Mademoiselle
Betteldorf	NN	1	Betteldorf
Meines	NN	1	Meines
umgehen	VB	1	umgeht
dochen	RB	1	doch
siehst	NN	1	siehst
ältern	NN	1	ältern
secessum	NN	1	secessum
Rekompenz	NN	1	Rekompenz
gesund	JJ	1	gesund
Fragen	NN	1	Fragen
dabeien	VB	1	dabei
Brücke	NN	1	Brücke
neumodisch	JJ	1	neumodische
eingezogen	NN	1	eingezogen
nascht	NN	1	nascht
Vortrefflich	JJ	1	Vortreffliches
Anweisung	NN	1	Anweisung
Woche	NN	1	Woche
deutlichsten	NN	1	deutlichsten
gedenke	NN	1	gedenke
unbekannt	NN	1	unbekannter
ablaufen	VB	1	ablaufen
Wende	NNS	1	Wenden
mythologischem	NN	1	mythologischem
Gefahr	NN	1	Gefahr
kommend	VB	1	kommende
Borgen	VBN	1	Geborgt
Übel	NN	1	Übel
Golde	NN	1	Golde
kaum	RB	1	kaum
Abschied	NN	1	Abschied
Vorrecht	NN	1	Vorrecht
ausgeholfen	NN	1	ausgeholfen
einerlei	RP	1	einerlei
gedenken	VBN	1	gedacht
dahin	IN	1	dahin
Muhm	NNP	1	Muhme
irrest	WRB	1	irrest
Schmause	NN	1	Schmause
umsonst	IN	1	umsonst
Nächte	NN	1	Nächte
kaiserlich	JJ	1	kaiserliche
ausgesonnen	NN	1	ausgesonnen
adlichem	NN	1	adlichem
zufried	JJ	1	zufrieden
einbilden	NN	1	einbilden
lebendig	JJ	1	lebendig
Forderungen	NN	1	Forderungen
überraschen	VBN	1	überrascht
Belieben	NN	1	Belieben
ichs	NN	1	ichs
Zorn	NN	1	Zorn
unhöflich	JJ	1	unhöflich
leidige	NN	1	leidige
übriges	NN	1	übriges
spräche	NN	1	spräche
zärtlich	JJ	1	zärtliche
wegnehmen	VB	1	wegnehmen
anzufangen	VB	1	anzufangen
Genug	NN	1	Genug
jemand	DT	1	jemand
darbien	NN	1	darbiete
Ernst	NNP	1	Ernst
überirdisch	JJ	1	überirdische
betrügen	VB	1	betrügen
käme	RB	1	käme
Bene	NN	1	Bene
anstehe	NN	1	anstehe
entkommen	VB	1	entkommen
uneben	NN	1	uneben
Leutch	JJ	1	Leutchen
bekannt	JJ	1	bekannt
verlor	JJ	1	verloren
herankriechen	VB	1	herankriechen
vorstellen	VBN	1	vorgestellt
schreibst	NN	1	schreibst
Betrügerei	NN	1	Betrügerei
unsinniges	PRP$	1	unsinniges
unzähligmal	RB	1	unzähligmal
Schelm	NN	1	Schelm
Täubchen	VB	1	Täubchen
Bringst	NN	1	Bringst
ausweisen	RB	1	ausweisen
Aufs	JJ	1	Aufs
wichtig	JJ	1	wichtigen
bessern	VB	1	bessern
packen	VB	1	packen
fünfhundert	CD	1	fünfhundert
Vetters	NN	1	Vetters
Begegnet	NN	1	Begegnet
allzusehr	NN	1	allzusehr
Frommen	NN	1	Frommen
Stoff	NN	1	Stoff
schlechen	VBN	1	schlecht
nimm	NN	1	nimm
überlegen	VB	1	überlegen
allezeit	NN	1	allezeit
Rolle	NN	1	Rolle
vergebens	RB	1	vergebens
Viertens	NN	1	Viertens
Anfällen	NN	1	Anfällen
Anteil	NN	1	Anteil
beschwerst	NN	1	beschwerst
Achsel	NN	1	Achsel
Wahrheit	NN	1	Wahrheit
besinnen	VB	1	besinnen
Los	JJ	1	Loser
Hört	NN	1	Hört
widersetzen	NN	1	widersetzen
scherzen	VB	1	scherzen
Valer	NN	1	Valer
Kaufen	NN	1	Kaufen
Antecedens	NN	1	Antecedens
quaerunt	NN	1	quaerunt
scherzhaftem	NN	1	scherzhaftem
spricht	VB	1	spricht
beteuren	NN	1	beteuren
Erzähle	NN	1	Erzähle
Gefangen	NN	1	Gefangen
Creditoren	JJ	1	Creditoren
wild	VB	1	wilder
Creditores	NN	1	Creditores
Hoffnung	NN	1	Hoffnung
nütze	NN	1	nütze
brauche	NN	1	brauche
längst	RB	1	längst
ändern	VB	1	ändern
spitzbübisch	JJ	1	spitzbübisch
abhelfen	NN	1	abhelfen
Christi	NN	1	Christi
Judas	NN	1	Judas
betreigen	VB	1	betriegen
beschreiben	VB	1	beschreiben
Ehrfurcht	NN	1	Ehrfurcht
willige	NN	1	willige
Schwäger	NN	1	Schwäger
allzuviel	IN	1	allzuviel
artigsten	NN	1	artigsten
göttlich	JJ	1	göttlichen
anmelden	VB	1	angemeldet
Knebelbart	NNP	1	Knebelbart
Kaffeehause	NN	1	Kaffeehause
schelten	VB	1	schalten
Tasche	NN	1	Tasche
Moral	JJ	1	Moral
Haus	NN	1	Haus
kleinst	JJ	1	kleinste
bekäme	NN	1	bekäme
wen	WP	1	wen
Oronten	NN	1	Oronten
Männchen	NN	1	Männchen
Naturlehre	NN	1	Naturlehre
erschlage	NN	1	erschlage
Heirate	NN	1	Heirate
Profession	NN	1	Profession
bemächtige	NN	1	bemächtige
höflich	JJ	1	höflich
Sonderlich	JJ	1	Sonderlich
beisamm	JJ	1	beisammen
Personen	NN	1	Personen
handeln	VB	1	handeln
Weisst	NN	1	Weißt
ziele	NN	1	ziele
Böhmen	NNP	1	Böhmen
Drolligtes	NN	1	Drolligtes
hinterlässt	NN	1	hinterläßt
wetten	VB	1	wetten
Maus	NN	1	Maus
gegenen	NN	1	gegenen
Beschimpfung	NN	1	Beschimpfung
feurig	NN	1	feurigen
oben	RB	1	oben
Gesellschaftlichen	VB	1	Gesellschaftliche
drollichter	NN	1	drollichter
Maul	NN	1	Maul
dahinten	RB	1	dahinten
erbaulichen	VB	1	erbauliche
anschreiben	VBN	1	angeschrieben
eins	CD	1	eins
willigen	NN	1	willigen
überheben	NN	1	überheben
Bildung	NN	1	Bildung
Gelder	NN	1	Gelder
entschlassen	VB	1	entschließen
Todes	NN	1	Todes
geheim	JJ	1	geheim
wack	JJ	1	wacker
hassen	VB	1	hieße
übrig	JJ	1	übrig
neutral	JJ	1	neutral
Welt	NN	1	Welt
Kundmann	NN	1	Kundmann
Sprechen	VB	1	Sprechen
davor	JJ	1	davor
seit	IN	1	seit
Diener	NNP	1	Diener
wär	JJ	1	wären
1748	CD	1	1748
wohlgewachsenen	NN	1	wohlgewachsenen
braucht	VB	1	braucht
freissen	VB	1	frißt
einbringen	VBN	1	einbringt
Familien	NN	1	Familien
Untüchtig	JJ	1	Untüchtig
Versehn	NN	1	Versehn
Lust	NN	1	Lust
zugreifen	NNP	1	zugreifen
