Title: Die Juden
Number of all lemmas: 3266
Nummber of different lemmas: 1371

Lemma	POS	Frequency	Tokens
Herr	NN	73	Herren, Herrn, Herr
wissen	VVINF, VVFIN, VVPP	43	wissen, weiß, Wißt, wüßten, wüßte, Wissen, wußte, gewußt
sagen	VVPP, VVFIN, VVINF	40	gesagt, sagt, sagen, sage, Sagen, sagte
gut	ADJD, ADJA	34	gut, guter, besser, guten, gute, Gut, Besser, Besten, besten, gutem
sehen	VVFIN, VVIMP, VVPP, VVINF	32	sieht, sieh, gesehen, sahen, sehen, sehe, seht, Sehe
wohl	ADV	30	wohl
glauben	VVFIN, VVIMP, VVINF, VVPP	29	glaube, glauben, glaub, glaubt, geglaubt, glaubte, Glauben
Dose	NN	26	Dose
Jude	NN	24	Juden, Jude
gewiss	ADJD, ADJA	20	gewiß, Gewiß, gewissen, Gewisse, Gewisser, gewisser
nehmen	VVFIN, VVPP, VVINF	20	nimmt, nehme, genommen, nehmen, Nehmen
Vogt	NN	19	Vogt
wenige	PIS, PIAT	19	wenigem, wenig, wenige, weniger, wenigen
Freund	NN	19	Freund, Freunde
wahr	ADJD	18	wahr
ehrlich	ADJA	17	ehrlichen, ehrlicher, ehrliches, ehrlichsten
Hand	NN	16	Hand, Händen, Hände
denken	VVFIN, VVINF	16	denkst, denken, dächte, denke, dachte
vielleicht	ADV	15	Vielleicht, vielleicht
gar	ADV	15	gar
allein	ADV, PTKVZ	15	allein, Allein
fragen	VVINF, VVFIN, VVPP	14	fragen, fragt, fragst, fragte, gefragt
eben	ADV	14	eben
ei	NE	13	Ei, ei
Mann	NN	13	Mann
lieb	ADJA, ADJD	12	lieben, liebe, lieber, Lieber
hören	VVINF, VVIMP, VVFIN	12	hören, hör, höre, hört, Hören
unser	PPOSAT	12	unsrer, unserm, Unser, unser, unsere
euer	PPOSAT	12	Eurem, Euren, Euer, Eure
Lisette	NE	11	Lisette
Bart	NN	11	Bärte, Bart, Bärten
Papa	NN	11	Papa
stehen	VVFIN	11	steht, stehen
ha	NE	11	ha
finden	VVFIN, VVPP, VVINF	10	fand, finden, gefunden
Leute	NN	10	Leute, Leuten
Kerl	NN	10	Kerle, Kerl
ach	ITJ	10	Ach
Bediente	NN	10	Bedienten, Bedienter
Uhr	NN	9	Uhr
Geschenk	NN	9	Geschenken, Geschenk, Geschenke
erst	ADV, ADJA	9	erst, erste
bitten	VVFIN, VVINF, VVPP	9	bitten, bitte, gebeten
reden	VVINF, VVFIN	9	reden, rede
sonst	ADV	9	sonst, Sonst
Freundschaft	NN	9	Freundschaft
setzen	VVFIN, VVPP, VVINF	9	setzt, gesetzt, Setzen, setzen, Gesetzt
bald	ADV	9	bald
silbern	ADJA, ADJD	9	silberne, silbernen, silbern
recht	ADJD	8	recht
Herz	NN	8	Herz, Herzen
Zeit	NN	8	Zeit
Vergnügen	NN	8	Vergnügen
fort	PTKVZ, ADV	8	fort, Fort
Tag	NN	8	Tage, Tag, Tagen
groß	ADJD, ADJA	8	groß, großer, größte, großes, große, großen
kömmt	VVFIN, ADJA	8	kömmt
gern	ADV	8	gern
Glück	NN	8	Glück, Glücks
Wahrheit	NN	8	Wahrheit
Diener	NN	8	Diener
Seite	NN	7	Seite
beinahe	ADV	7	beinahe, Beinahe
Geier	NN, NE	7	Geier
Ha	NE	7	Ha
deswegen	PAV	7	deswegen
Verdacht	NN	7	Verdacht, Verdachte
Stand	NN	7	Stande, Stand
unsre	PPOSAT	7	unsern, unsre
Jahr	NN	7	Jahr, Jahre
gering	ADJA, ADJD	7	geringes, geringste, geringen, geringsten, geringer
alt	ADJD	7	älter, alt
irren	VVFIN, VVPP, VVINF	7	irrte, irren, geirrt
Umstand	NN	7	Umstände, Umständen
klug	ADJD, ADJA	7	klüger, klug, kluges
Gott	NN	7	Gott
lang	ADJD	7	länger, lang
befehlen	VVPP, VVINF, VVFIN	7	befohlen, befehlen
ichs	ADJD	7	ichs
Christ	NN, NE	7	Christen, Christ
entdecken	VVFIN, VVINF, VVPP	7	entdecken, entdeckt, entdecke
Mensch	NN	7	Menschen, Mensch
schämen	VVFIN, VVINF, VVPP	6	schäme, schämen, geschämt
nu	ITJ	6	nu, Nu
Vermögen	NN	6	Vermögen
lange	ADV	6	lange
gestern	ADV	6	gestern, Gestern
verdienen	VVINF, VVFIN	6	verdienen, verdiene, verdiente
verzeihen	VVFIN	6	Verzeihen, verzeihen, Verzeiht
kennen	VVINF, VVFIN, VVPP	6	kennen, kenne, gekannt
Mamsell	NN, NE	6	Mamsell
Fräulein	NN	6	Fräulein
Teufel	NN	6	Teufel
zufrieden	ADJD	6	zufrieden
fallen	VVFIN, VVINF	6	falle, fallen
meinig	PPOSS	6	meinige, meinigen
dumm	ADJA, ADJD	6	dummer, dumm
sitzen	VVINF, VVFIN	6	sitzen, sitze
böse	ADJD, ADJA	6	böse
suchen	VVFIN, VVINF	6	suche, suchen, sucht
Liebe	NN	6	Liebe
Wohltat	NN	6	Wohltaten, Wohltat
annehmen	VVPP, VVIZU, VVINF	5	angenommen, anzunehmen, annehmen
gottlos	ADJA	5	gottlosen, gottlose, gottloses, gottloser
sicher	ADJD, ADJA	5	sichrer, sichersten, sicher, sichere
Frage	NN	5	Frage
laufen	VVFIN, VVPP	5	liefen, läuft, gelaufen, laufe, laufen
gestehn	VVINF, VVFIN, ADJD	5	gestehn
schenken	VVPP, VVINF	5	geschenkt, schenken
klein	ADJA, ADJD	5	kleine, klein, kleinen
gehn	VVINF, ADJD, VVFIN	5	gehn
ertappen	VVPP, VVFIN	5	ertappt, ertappte
genug	ADV	5	genug, Genug
wenig	ADV	5	wenig
verschweigen	VVPP, VVINF	5	verschwiegen, verschweigen
Volk	NN	5	Volk, Völker, Volke
übereilen	VVPP, VVINF	5	übereilt, übereilen
verstehen	VVPP, VVFIN	5	verstanden, versteht, verstehe
hurtig	ADJD	5	Hurtig, hurtig, hurtiger
kurz	ADJA, ADJD	5	kurzem, kurzen, kurzer, Kurz
wert	ADJD	5	wert
Name	NN	5	Namen
lernen	VVINF, VVPP, VVFIN	5	lernen, gelernt, lerne
Weg	NN	5	Wege, Weg
Grobheit	NN	5	Grobheit
Nu	NN	5	Nu
Ehre	NN	5	Ehre
begleiten	VVINF, VVPP	5	begleiten, begleitet
Mühe	NN	5	Mühe
Recht	NN	5	Recht, Rechts
Dienst	NN	5	Dienste, Diensten
leicht	ADJD	5	leicht, leichter
lügen	VVINF, VVFIN, VVPP	5	lügen, log, gelogen, lögen
wenigstens	ADV	5	wenigstens
reißen	VVPP, VVINF, VVFIN	5	gerissen, reißen, riß
Spaß	NN	5	Spaß
vorhin	ADV	5	Vorhin, vorhin
Ernst	NE	5	Ernst
etwa	ADV	5	etwa
zeigen	VVINF, VVFIN, VVPP	5	zeigen, zeigt, gezeigt, Zeigt
Auge	NN	5	Augen, Auge
Vermutung	NN	5	Vermutung, Vermutungen
freilich	ADV	5	freilich
jung	ADJA, ADJD	5	junge, jung, junger, jungen
kaum	ADV	4	kaum
übel	ADJD	4	übel
Rede|Reden	NN	4	Reden
Gedanke	NN	4	Gedanken
verraten	VVPP, VVFIN	4	verraten, verratet, verrate, verrieten
Garten	NN	4	Garten
Tochter	NN	4	Tochter
lieben	VVFIN	4	liebe
Krumm	NN, NE	4	Krumm
leiden	VVINF	4	leiden
selber	ADV	4	selber
Flucht	NN	4	Flucht
Vergeltung	NN	4	Vergeltung
Dieb	NN	4	Diebe, Dieb
Tobaksdose	NN	4	Tobaksdose
Martin	NE	4	Martin
Unglück	NN	4	Unglücke, Unglück
antworten	VVINF	4	antworten
merken	VVINF, VVFIN, VVPP	4	merken, merke, gemerkt, Merken
Sache	NN	4	Sache, Sachen
dergleichen	PIS	4	dergleichen
Abreise	NN	4	Abreise
sauer	ADJD	4	saurer, sauer
Spitzbube	NN	4	Spitzbube, Spitzbuben
verstehs	VVFIN, NN	4	verstehs
nötig	ADJD	4	nötig
fein	ADJD, ADJA	4	fein, feinen
hochöchst	ADJD	4	höchst
gleichwohl	ADV, KOUS	4	gleichwohl, Gleichwohl
dienen	VVINF	4	dienen
Kleinigkeit	NN	4	Kleinigkeit
Schuldigkeit	NN	4	Schuldigkeit
werfen	VVFIN, VVPP	4	wirft, werfe, geworfen
Henker	NN	4	Henker
nimmermehr	ADV	4	nimmermehr, Nimmermehr
Ei	NN	4	Ei
bekommen	VVINF, VVPP	4	bekommen
sehnen	VVIMP	4	sehn
unverschämt	ADJD, ADJA	4	unverschämt, unverschämtes, Unverschämter
Ursache	NN	4	Ursachen, Ursache
küssen	VVFIN, VVIMP, VVINF	4	küßt, küß, küssen
Großmut	NN	4	Großmut
Jungfer	NN	4	Jungfer
unschuldig	ADJD	4	unschuldig
heute	ADV	4	heute
Ding	NN	4	Dinger, Ding, Dingen, Dinge
verlassen	VVFIN, VVINF, VVPP	4	verließen, verlassen
Frauenzimmers	NN	4	Frauenzimmers
Himmel	NN	4	Himmel
Leben	NN	4	Leben, Lebens
liebenswürdig	ADJA, ADJD	4	liebenswürdigen, liebenswürdig, liebenswürdigste
verlangen	VVINF, VVFIN	4	verlangen, verlange
Gefahr	NN	4	Gefahr
verbinden	VVFIN, VVINF	4	verband, verbinden, Verbinde
allezeit	ADV	4	allezeit
greifen	VVINF, VVFIN, VVPP	4	greifen, griff, gegriffen
zwei	CARD	4	zwei, Zwei
übrig	ADJA	4	übrigen, übrige
anfallen	VVPP, VVFIN	3	angefallen, anfiele
vergessen	VVFIN, VVIMP	3	vergißt, Vergiß, Vergessen
verfolgen	VVINF, VVPP	3	verfolgen, verfolgt
Dankbarkeit	NN	3	Dankbarkeit
Gefälligkeit	NN	3	Gefälligkeit, Gefälligkeiten
laß	ADJD, ADJA	3	laß, lassen
kehren	VVINF, VVFIN	3	kehren
Augenblick	NN	3	Augenblick
Stunde	NN	3	Stunde
wollens	VVFIN, ADJD	3	wollens
tragen	VVPP, VVFIN	3	getragen, trägt, trugen
falsch	ADJA, ADJD	3	falschen, falsch
Dero	NE, ADJA	3	Dero
Wort	NN	3	Wörter, Wort
darnach	ADV	3	darnach
endlich	ADV	3	endlich
angenehm	ADJA, ADJD	3	angenehmen, angenehme, angenehmer
Räuber	NN	3	Räuber
anfangen	VVINF, VVPP	3	anfangen, angefangen
erhalten	VVINF, VVFIN, VVPP	3	erhalten, erhält
diese	PDS	3	diese, Diese, dieser
belieben	VVFIN	3	belieben, Belieben, beliebten
stehlen	VVINF, VVPP	3	stehlen, gestohlen
Zweifel	NN	3	Zweifel
Fasson	NN	3	Fasson
niemals	ADV	3	niemals
Punkt	NN	3	Punkt, Punkte
schweigen	VVFIN, VVINF	3	Schweigt, schweigen
beschwerlich	ADJD	3	beschwerlich
Bitte	NN	3	Bitte
Pferd	NN	3	Pferde
behaupten	VVINF	3	behaupten
Unrecht	NN	3	Unrecht
Verdrüßlichkeiten	NN	3	Verdrüßlichkeiten
grob	ADJD	3	grob
Wohltäter	NN	3	Wohltäters, Wohltäter
erweisen	VVPP, VVINF	3	erwiesen, erweisen
schuldig	ADJD	3	schuldig
ähnlich	ADJA, ADJD	3	ähnlicher, ähnlich
Meile	NN	3	Meilen
schlecht	ADJD, ADJA	3	schlecht, schlechteste
Schnupftabaksdose	NN	3	Schnupftabaksdose
Furcht	NN	3	Furcht
ansehen	VVPP, VVIZU	3	angesehen, anzusehen
betrachten	VVFIN	3	betrachten, Betrachten
verlegen	ADJD, VVINF	3	verlegen
geschwind	ADJD	3	Geschwind, geschwind
verdammen	VVPP	3	Verdammt, verdammt
Mund	NN	3	Munde
hieher	NN	3	hieher
Mantelsäcke	NN	3	Mantelsäcke
einander	PRF	3	einander
schimpfen	VVFIN, VVINF	3	schimpft, Schimpft, schimpfen
ah	ITJ	3	Ah
Dose|Dosis	NN	3	Dosen
schätzen	VVFIN, VVINF	3	Schätzen, schätzen, schätze
Exempel	NN	3	Exempel
Stunde|Stunden	NN	3	Stunden
empfindlich	ADJD	3	empfindlich
wohin	PWAV	3	Wohin, wohin
Reise	NN	3	Reise
leid	ADJD	3	leid
alsdann	VVFIN, ADJD	3	alsdann
aufs	APPRART	3	aufs, Aufs
verlieren	VVPP, VVFIN	3	verloren, verliert
mirs	ADJD	3	mirs
unschätzbar	ADJD, ADJA	3	unschätzbar, unschätzbare
nötigen	VVFIN, VVINF, VVPP	3	nötigte, nötigen, genötigt
erlauben	VVFIN, VVPP	3	erlauben, erlaubt
Mord	NN	3	Mords
bedeuten	VVFIN, VVINF	3	bedeutet, bedeuten
bedenken	VVINF, VVFIN	3	bedenken, bedenke, Bedenken
Hunger	NN	3	Hunger
abpacken	VVINF	3	abpacken
Durst	NN	3	Durst
Kind	NN	3	Kind, Kindes
bewegen	VVFIN, VVINF	3	bewog, bewegen
erkenntlich	ADJD	3	erkenntlich
urteilen	VVFIN, VVINF	3	urteilen
fällen	VVPP	3	gefällt
stellen	VVINF, VVFIN	3	stellen, stellt, stelle
redt	ADJD	3	redt
weinen	VVFIN	3	weinen, weine, weint
hinter	APPR	3	hinter
allgemein	ADJA, ADJD	3	allgemeine, allgemeiner, allgemein
verfahren	VVPP, VVFIN	3	verfahren, verfährt
Frauenzimmer	NN	3	Frauenzimmer
Ort	NN	3	Orte, Ort
Seele	NN	3	Seele, Seelen
sachte	ADV	3	Sachte, sachte
erklären	VVPP, VVINF, VVFIN	3	erklärt, erklären, Erklären
zornig	ADJD	3	zornig
schön	ADJA	3	schöne
Gut	NN	3	Gut, Gütern
paar	PIAT	3	Paar
Mannsperson	NN	3	Mannspersonen, Mannsperson
zugehen	VVPP, VVINF, VVFIN	3	zugegangen, zugehen, zuging
heraus	PTKVZ	3	heraus
gedenken	VVFIN, VVINF	3	gedenke, gedenken
dahin	PAV	3	dahin
umbringen	VVINF	3	umbringen
überlegen	VVFIN	3	Überlegen, überlegen
drum	PAV	3	Drum
wild	ADJA, ADJD	3	wilde, wild
Verwirrung	NN	3	Verwirrung, Verwirrungen
oft	ADV	3	oft
höflich	ADJD	3	höflicher, Höflich, höflich
wünschen	VVINF, VVIMP	3	wünschen, wünsch
zweifeln	VVINF, VVFIN	3	zweifeln, zweifle
vortrefflich	ADJA, ADJD	3	Vortrefflicher, vortrefflich
Sprache	NN	2	Sprache
jemals	ADV	2	jemals
träumen	VVFIN	2	Träumt, Träumen
recht|rechts	ADJA	2	rechten, rechte
Straßenräuber	NN	2	Straßenräuber, Straßenräubern
satteln	VVINF, VVPP	2	satteln, gesattelt
bezahlen	VVINF	2	bezahlen
Mangel	NN	2	Mangel
Gleiche	NN	2	Gleiches, Gleichem
Acht	NN	2	Acht
Mantelsack	NN	2	Mantelsack
zuwider	ADV, PTKVZ	2	zuwider
zielen	VVINF, VVFIN	2	zielen
niemand	PIS	2	niemanden, niemand
Neugierde	NN	2	Neugierde
Hülfe	NN	2	Hülfe
antreffen	VVFIN, VVPP	2	antrifft, angetroffen
schade	ADJD	2	Schade
verbindlich	ADJD	2	verbindlich
Antrag	NN	2	Antrag
Arm|Arme	NN	2	Armen, Arme
überflüssig	ADJA, ADJD	2	überflüssige, überflüssig
brauchen	VVIMP, VVFIN	2	brauch, brauche
weniger	ADV	2	weniger
Urteil	NN	2	Urteile
raten	VVFIN, VVINF	2	rate, raten
spazieren	VVINF	2	spazieren
wohlbestallt	ADJA	2	wohlbestallter
bedanken	VVINF	2	bedanken
sollens	VVFIN	2	sollens
verschaffen	VVINF, VVFIN	2	verschaffen, verschaffte
weiter	ADV	2	weiter
bekannt	ADJD, ADJA	2	bekannt, bekannter
brav	ADJD, ADJA	2	brav, braver
Neugierigkeit	NN	2	Neugierigkeit
allzugütig	ADJD	2	allzugütig
Schuld	NN	2	Schuld
entfliehen	VVFIN, VVINF	2	entfliehen
Aufsicht	NN	2	Aufsicht
Sies	NN	2	Sies
Genugtuung	NN	2	Genugtuung
erzählen	VVINF, VVFIN	2	erzählen, Erzählen
wenden	VVFIN	2	wendet
ordentlich	ADJA, ADJD	2	ordentliche, ordentlicher
schließen	VVINF, VVFIN	2	schließen
ohngefähr	ADJD	2	ohngefähr
gefällig	ADJA, ADJD	2	gefällige, gefällig
Eigenschaft	NN	2	Eigenschaften
gewinnen	VVPP	2	gewonnen
Anerbieten	NN	2	Anerbieten
dankbar	ADJD	2	dankbar
Schulze	NE	2	Schulze
Art	NN	2	Art
zärtlich	ADJA	2	zärtliche, zärtlichen
gönnen	VVINF, VVFIN	2	gönnen, Gönnen
kosten	VVFIN	2	kostet
hundertmal	ADV	2	hundertmal
Argwohn	NN	2	Argwohn, Argwohns
niederschlagen	VVPP	2	niedergeschlagen
anbieten	VVFIN, VVINF	2	anbot, anbieten
dritt	ADJA	2	dritten
schätzbar	ADJD	2	schätzbar
Erstaunen	NN	2	Erstaunen
gehören	VVFIN	2	gehört
Stehlen	NN	2	Stehlen
zeihen|ziehen	VVFIN	2	zieht
Tat	NN	2	Tat
heißen	VVINF	2	heißen
Gute	NN	2	Gute, Gutes
Franzose	NN	2	Franzose, Franzosen
glücklich	ADJD	2	glücklich
lächerlich	ADJD	2	lächerlich
schrecken	VVFIN, VVINF	2	schrecke, schrecken
meinetwegen	ADV	2	meinetwegen
Larve	NN	2	Larve
Galgen	NN	2	Galgen
erlernen	VVINF, VVFIN	2	erlernen, erlernt
Lüge|Lügen	NN	2	Lügen
zuschreiben	VVIZU, VVPP	2	zuzuschreiben, zugeschrieben
Erkenntlichkeit	NN	2	Erkenntlichkeit
ihrige	PPOSAT	2	Ihrige
gefallen	VVINF	2	gefallen
schlagen	VVPP, VVFIN	2	geschlagen, schlage
ewig	ADJD	2	ewig
fertig	ADJD	2	fertig
helfen	VVPP, VVINF	2	geholfen, helfen
machts	ADJD, VVFIN	2	machts
Geduld	NN	2	Geduld
großmütig	ADJD, ADJA	2	großmütig, großmütige
Erretter	NN	2	Erretter
Messe	NN	2	Messe
Glücke	NN	2	Glücke
darin	PAV	2	darin
verdammt	ADJA	2	verdammte, verdammten
zugleich	ADV	2	zugleich
Verfahren	NN	2	Verfahren, Verfahrens
hungern	VVFIN	2	hungert
Fremde	NN	2	Fremden
unbelohnt	ADJD	2	unbelohnt
Vaterland	NN	2	Vaterlande
essen	VVINF	2	essen
ehe	KOUS	2	ehe
erinnern	VVFIN	2	erinnerte, Erinnern
am	PTKA	2	am
halber	APPO	2	halber
zanken	VVINF	2	zanken
Spiel	NN	2	Spiel
Bekannte	NN	2	Bekannte, Bekannten
genötiget	VVFIN	2	genötiget
notwendig	ADJD	2	notwendig
beschuldigen	VVPP	2	beschuldigt
erfahren	VVINF, VVFIN	2	erfahren, erfährt
Bitte|Bitten	NN	2	Bitten
hinein	PTKVZ	2	hinein
Menschenliebe	NN	2	Menschenliebe
Unvorsichtigkeit	NN	2	Unvorsichtigkeit
laut	ADJD	2	lauter
trinken	VVINF	2	trinken
grausam	ADJD, ADJA	2	grausam, grausamer
verzweifelt	ADJA, ADJD	2	verzweifelten, verzweifelt
besitzen	VVFIN	2	besitzt, besäßen
rächen	VVINF	2	rächen
darum	PAV	2	Darum, darum
Gewissen	NN	2	Gewissen
Strick	NN	2	Stricke
Adel	NN	2	Adel
heran	PTKVZ	2	heran
rasend	ADJD	2	rasend
deutlich	ADJD	2	deutlich, deutlicher
behüten	VVFIN	2	behüte
Hamburg	NE	2	Hamburg
Wohlstand	NN	2	Wohlstands
Rat	NN	2	Rat
begeben	VVPP	2	begeben
ernsthaft	ADJD	2	ernsthaft
verstellen	VVPP	2	verstellt
hart	ADJD	2	hart
anwenden	VVFIN	2	anwendete, anwenden
wagen	VVPP, VVFIN	2	gewagt, wagen
nennen	VVFIN	2	nannte, nennen
Verrichtung	NN	2	Verrichtungen
vermummen	VVPP	2	vermummt
Freiheit	NN	2	Freiheit
genießen	VVINF, VVPP	2	genießen, genossen
Unwahrheit	NN	2	Unwahrheit
lachen	VVFIN	2	Lacht, lacht
rechtschaffne	ADJA	2	rechtschaffne
treiben	VVFIN	2	trieb, treibt
arg	ADJD	2	ärger, arg
arm	ADJA, ADJD	2	armen, arm
Dank	NN	2	Dank
dadurch	PAV	2	dadurch
Schaden	NN	2	Schaden
zwingen	VVPP, VVINF	2	gezwungen, zwingen
erraten	VVFIN, VVPP	2	errate, erraten
Natur	NN	2	Natur
Nation	NN	2	Nationen, Nation
ansehn	VVFIN	2	ansehn
Vater	NN	2	Vater, Väter
vermuten	VVINF	2	vermuten
beschwören	VVINF, VVFIN	2	beschwören, beschwöre
Engeland	NN	2	Engeland
entwenden	VVPP	2	entwendet, entwandt
weis	PTKVZ	2	weis
wanns	NN, NE	2	wanns
Gesicht	NN	2	Gesicht
Schicksal	NN	2	Schicksale, Schicksal
fast	ADV	2	fast
Geheimnis	NN	2	Geheimnisse, Geheimnis
Verlust	NN	2	Verlust
besorgen	VVFIN	2	besorge
Verweis	NN	2	Verweise, Verweis
Prise	NN	2	Prise
fallen|gefallen	VVPP	2	gefallen
Duell	NN	2	Duells, Duell
dringen	VVFIN	2	dringen, drang
verwirren	VVPP, VVFIN	2	verwirrt
umwenden	VVINF	2	umwenden
wohnen	VVPP	2	gewohnt
Not	NN	2	Not
Holland	NE	2	Holland
gemein	ADJD	2	gemein
reich	ADJD	2	reich
gütig	ADJD, ADJA	2	gütig, gütigen
Gemüt	NN	2	Gemüt, Gemüte
erzeigt	VVFIN, ADJD	2	erzeigt
Frankreich	NE	2	Frankreich
Land	NN	2	Lande
begreifen	VVFIN, VVIMP	2	begreife, begreif
empfehlen	VVINF, VVFIN	2	empfehlen, empfehle
rechtschaffnen	ADJA	2	rechtschaffnen
eins	CARD	2	eins
Reisende	NN	2	Reisende
wundern	VVFIN	2	wundern, Wundern
Sau	NN	2	Säue
Kompliment	NN	2	Komplimente
vorwerfen	VVIZU, VVINF	2	vorzuwerfen, vorwerfen
erfreuen	VVFIN, VVINF	2	erfreut, erfreuen
Griff	NN	2	Griff, Griffe
umsonst	ADV	2	umsonst
Rede	NN	2	Rede
aufrichtig	ADJD, ADJA	2	aufrichtig, aufrichtige
Zorn	NN	2	Zorn
weisen	VVINF	2	weisen
steinern	ADJD	2	steinern
jemand	PIS	2	jemand, jemanden
beistehen	VVPP	2	beigestanden
Pöbel	NN	2	Pöbels, Pöbel
Gast	NN	2	Gast
spotten	VVINF	2	spotten
fremd	ADJA	2	fremden, Fremden
Kenner	NN	2	Kenner
zumuten	VVINF	2	zumuten
vergebens	ADV	2	vergebens
Physiognomie	NN	2	Physiognomie
längst	ADV	2	längst
halbpart	ADJD	2	halbpart
Liebesantrag	NN	2	Liebesantrag
beschreiben	VVINF, VVFIN	2	beschreiben, beschreibt
Tasche	NN	2	Tasche
weg	PTKVZ	2	weg
treffen|triefen	VVPP	2	getroffen
Ihrigen	NN	2	Ihrigen
Frühstück	NN	2	Frühstück
vermissen	VVFIN	2	vermisse
fahren	VVFIN, VVINF	2	fährt, fahren
Segen	NN	2	Segen
Welt	NN	2	Welt
Vertrauen	NN	2	Vertrauen
entsetzlich	ADJD	2	entsetzlich
seit	APPR	2	seit
wär	ADJD, VVFIN	2	wär
Entleibten	NN	2	Entleibten
Nachricht	NN	2	Nachricht
Haus	NN	2	Hause
Respekt	NN	1	Respekt
naseweiser	ADJA	1	naseweiser
Empfindlichers	NN	1	Empfindlichers
steigen	VVFIN	1	stieg
nieder	ADJD	1	nieder
niederträchtig	ADJA	1	niederträchtigsten
dürsten	VVFIN	1	dürstet
pflegen	VVPP	1	gepflegt
ungeneigt	ADJD	1	ungeneigt
Richter	NE	1	Richter
Bedienung	NN	1	Bedienungen
Brodgrümel	NN	1	Brodgrümel
Schubsäcke	NN	1	Schubsäcke
Umgang	NN	1	Umgang
wahrhaftig	ADJD	1	Wahrhaftig
auspressen	VVPP	1	ausgepreßt
deutsch	ADJD	1	deutsch
unsicher	ADJD	1	unsicher
Untersuchung	NN	1	Untersuchung
toll	ADJD	1	toll
Zeug	NN	1	Zeug
drei	CARD	1	drei
wirds	VVFIN	1	wirds
ungefähr	ADJD	1	ungefähr
Eigennützige	NN	1	Eigennützige
ungekünsteltste	ADJA	1	ungekünsteltste
allzeit	ADV	1	allzeit
gewissenhaft	ADJD	1	gewissenhaft
Recht|Rechte	NN	1	Rechte
unleidlich	ADJD	1	unleidlich
drauf	PAV	1	drauf
wars	NE	1	wars
Person	NN	1	Person
er|es	PPER	1	Ihm
Gewinst	NN	1	Gewinst
lohnen	VVFIN	1	lohnt
trotz	APPR	1	Trotz
Umwenden	NN	1	Umwenden
sterben	VVPP	1	gestorben
Termin	NN	1	Termin
hundert	CARD	1	hundert
Junge	NN	1	Jungen
nachteilig	ADJD	1	nachteilig
verschwiegen	ADJD	1	verschwiegen
nachreden	VVINF	1	nachreden
hüten	VVFIN	1	hüten
herzu	ADV	1	herzu
Untergebnen	NN	1	Untergebnen
versprechen	VVFIN	1	versprechen
Monat	NN	1	Monaten
Antwort	NN	1	Antwort
teilen	VVINF	1	teilen
dorthin	ADV	1	dorthin
drinne	NN	1	drinne
Lisettchen	NN	1	Lisettchen
Rittergute	NN	1	Rittergute
übereinstimmen	VVINF	1	übereinstimmen
dasmal	ADJD	1	dasmal
Darzu	ADV	1	Darzu
klingen	VVFIN	1	klingt
Unterhaltung	NN	1	Unterhaltung
Verzeihen	NN	1	Verzeihen
frei	ADJD	1	frei
unendlich	ADJD	1	unendlich
muntre	ADJA	1	muntre
doppelt	ADJA	1	doppeltes
Lisetten	NN	1	Lisetten
sahe	VVFIN	1	sahe
Ernste	NN	1	Ernste
angehen	VVFIN	1	angeht
unnötig	ADJA	1	unnötige
Schuldige	NN	1	Schuldigen
einen	VVINF	1	einen
Pistol	NN	1	Pistol
gefährlich	ADJA	1	gefährlichen
tot	ADJD	1	tot
herkommen	VVINF	1	herkommen
dulden|gedulden	VVPP	1	geduldet
Närrin	NN	1	Närrin
verblenden	VVINF	1	verblenden
binnen	APPR	1	binnen
Viertelstunde	NN	1	Viertelstunde
liefst	VVFIN	1	liefst
bedanket	VVFIN	1	bedanket
abgeschmackt	ADJD	1	abgeschmackt
treu	ADJD	1	Treu
herrschet	VVFIN	1	herrschet
Eigennutz	NN	1	Eigennutz
durchaus	ADV	1	durchaus
nachfolgen	VVINF	1	nachfolgen
denkts	VVFIN	1	denkts
herrschen	VVFIN	1	herrschen
künftig	ADJD	1	künftig
taumeln	VVFIN	1	taumelt
Einfall	NN	1	Einfall
erfolgen	VVFIN	1	erfolgt
Ungelegenheit	NN	1	Ungelegenheit
Verklagen	NN	1	Verklagen
einladen	VVINF	1	einladen
durchkommen	VVIZU	1	durchzukommen
visitieren	VVFIN	1	visitieren
Fuß	NN	1	Fuß
Miene	NN	1	Miene
Macht	NN	1	Macht
mitten	ADV	1	mitten
ausgeben	VVFIN	1	ausgibt
weswegen	PWAV	1	weswegen
christlich	ADJA	1	christliche
Mademoisell	ADJA	1	Mademoisell
verteidigen	VVINF	1	verteidigen
unbequem	ADJA	1	unbequemsten
Gewaltsamkeit	NN	1	Gewaltsamkeit
vielmehr	ADV	1	vielmehr
schimpflich	ADJD	1	schimpflich
Wein|Weinen	NN	1	Weinen
hiesig	ADJA	1	hiesige
inne	PTKVZ	1	inne
schreiben	VVFIN	1	schreiben
Alfanzereien	NN	1	Alfanzereien
zuviele	PIS	1	zuviel
fangen	VVFIN	1	fangen
allzugewissenhaften	NN	1	allzugewissenhaften
Philosophie	NN	1	Philosophie
Ausflucht	NN	1	Ausflucht
geraten|raten	VVPP	1	geraten
erfodert	VVFIN	1	erfodert
lösete	ADJD	1	lösete
ausreißen	VVPP	1	ausgerissen
zweitenmal	NN	1	zweitenmal
vexieren	VVFIN	1	vexieren
wider	APPR	1	wider
Gnüge	NN	1	Gnüge
dringen|drängen	VVFIN	1	drängen
Marquisin	NN	1	Marquisin
Italien	NE	1	Italien
ochsenmäßig	ADJD	1	ochsenmäßig
fest	ADJD	1	fest
Liebste	NN	1	Liebsten
boshafterer	ADJA	1	boshafterer
Schutzengel	NE	1	Schutzengel
gewöhnen	VVINF	1	gewöhnen
Scherz	NN	1	Scherze
Niesen	NN	1	Niesen
verzeihen|verziehen	VVFIN	1	Verziehen
Schande	NN	1	Schande
aufräumen	VVPP	1	aufgeräumt
nie	ADV	1	nie
legen	VVPP	1	gelegt
Portion	NN	1	Portion
Grobian	NN	1	Grobian
ankommen	VVPP	1	angekommen
Verlauf	NN	1	Verlauf
beschweren	VVINF	1	beschweren
geschmeidig	ADJD	1	geschmeidiger
übern	APPRART	1	übern
Wollte	VVFIN	1	Wollte
besehn	VVINF	1	besehn
offnen	ADJA	1	offnen
Tugend	NN	1	Tugend
bezeugen	VVFIN	1	bezeugte
Anfange	NN	1	Anfange
durstet	ADJD	1	durstet
Haufe	NN	1	Haufen
stoßen	VVFIN	1	stößt
Stolz	NN	1	Stolz
betriegt	VVFIN	1	betriegt
Arm	NN	1	Arm
darzu	ADV	1	darzu
bereit	ADJD	1	bereit
Wechsel	NN	1	Wechsel
ums	APPRART	1	ums
Abendmahlzeit	NN	1	Abendmahlzeit
sinnreich	ADJD	1	sinnreich
Quark	NN	1	Quark
stiften	VVFIN	1	stiften
binden	VVINF	1	binden
Bräutigam	NN	1	Bräutigam
Religionspunkt	NN	1	Religionspunkt
Grad	NN	1	Grade
Liebesverständnisse	NN	1	Liebesverständnisse
stecken	VVFIN	1	steckte
gutherziger	ADJA	1	gutherziger
Rocktasche	NN	1	Rocktasche
verbleiben	VVFIN	1	verbleibe
unternehmend	ADJD	1	unternehmend
Trauerspielen	NN	1	Trauerspielen
vorkommen	VVPP	1	vorgekommen
untern	APPRART	1	untern
Ende	NN	1	Ende
Verbindlichkeit	NN	1	Verbindlichkeit
Unschuld	NN	1	Unschuld
woher	PWAV	1	Woher
aufnehmen	VVINF	1	aufnehmen
reiten	VVFIN	1	ritt
Stück	NN	1	Stücken
Loch	NN	1	Loch
bedienen	VVINF	1	bedienen
Abschiedsformeln	NN	1	Abschiedsformeln
Vogte	NN	1	Vogte
toppen	VVIMP	1	Topp
Freundin	NN	1	Freundin
Hund	NN	1	Hund
Geringe	NN	1	Geringes
geschehn	VVPP	1	geschehn
dicht	ADJD	1	dichter
verdächtig	ADJD	1	verdächtig
entgehn	ADJD	1	entgehn
gehorchen	VVINF	1	gehorchen
greulich	ADJD	1	greulich
weils	NN	1	weils
entdeckt	ADJA	1	entdecktes
Querstrich	NN	1	Querstrich
entzücken	VVFIN	1	entzückt
Mäßige	NN	1	Mäßigen
schwerlich	ADJD	1	schwerlich
übergeben	VVFIN	1	übergebe
weitrer	ADJA	1	weitrer
Ehrlichkeit	NN	1	Ehrlichkeit
Großvater	NN	1	Großvater
Bibel	NN	1	Bibel
aufsetzen	VVINF	1	aufsetzen
beurlauben	VVINF	1	beurlauben
gescheuter	ADJA	1	gescheuter
Rache	NN	1	Rache
Lustspiel	NN	1	Lustspielen
Kriegsdienst	NN	1	Kriegsdiensten
hochadelichen	ADJA	1	hochadelichen
gelangen|langen	VVPP	1	gelangt
Klage	NN	1	Klage
Absicht	NN	1	Absicht
Pest	NN	1	Pest
Bedenkzeit	NN	1	Bedenkzeit
allzusicher	ADJD	1	allzusicher
ausstechen	VVINF	1	ausstechen
verbergen	VVPP	1	verborgen
Verlangen	NN	1	Verlangen
Mundsemmel	NN	1	Mundsemmel
lesen	VVINF	1	lesen
Sehen	NN	1	Sehen
schaden	VVINF	1	schaden
ungekannt	ADJD	1	ungekannt
vous	NE	1	vous
tausenderlei	ADJD	1	Tausenderlei
ungeehrt	ADJD	1	ungeehrt
redten	VVFIN	1	redten
unmöglich	ADJD	1	unmöglich
Brandwein	NN	1	Brandwein
Narre	NN	1	Narre
Essenszeit	NN	1	Essenszeit
ängstlich	ADJA	1	ängstliches
Reisebibliothek	NN	1	Reisebibliothek
verdienstliches	ADJA	1	verdienstliches
französisch	ADJA	1	französische
ausplaudern	VVINF	1	ausplaudern
ärgern	VVFIN	1	ärgert
Vormittag	NN	1	Vormittag
st	VVFIN	1	st
geredt	ADJD	1	geredt
wirksam	ADJA	1	wirksame
hohl	ADJA	1	hohlen
Beiwort	NN	1	Beiwort
wiedergeben	VVINF	1	wiedergeben
vermeinen	VVFIN	1	vermeinte
Buch	NN	1	Bücher
Handgemenge	NN	1	Handgemenge
Flegel	NN	1	Flegel
Deutsche	NN	1	Deutscher
erweiset	VVFIN	1	erweiset
antreiben	VVINF	1	antreiben
spielen	VVFIN	1	spielt
erwerben	VVPP	1	erworben
gnädig	ADJA	1	gnädiges
Kette	NN	1	Kette
verkleiden	VVPP	1	verkleidet
bekömmt	VVFIN	1	bekömmt
schmecken	VVFIN	1	schmeckt
ausersehen	VVPP	1	ausersehen
Kinderspiel	NN	1	Kinderspiel
Licht	NN	1	Lichte
weich	ADJA	1	weichste
tiefsinnig	ADJA	1	tiefsinnigen
Meineid	NN	1	Meineid
Anstalt	NN	1	Anstalt
Warens	ADV	1	Warens
einnehmender	ADJD	1	einnehmender
behalten	VVFIN	1	behaltet
Entleibte	NN	1	Entleibte
Atem	NN	1	Atem
aufheben	VVINF	1	aufheben
Lohn	NN	1	Lohn
ansehnlich	ADJA	1	ansehnlichen
unterlassen	VVPP	1	unterlassen
Ungewissenhafte	NN	1	Ungewissenhafte
verheiraten	VVPP	1	verheiratet
anvertrauen	VVINF	1	anvertrauen
freuen	VVFIN	1	freue
beschämen	VVFIN	1	beschämen
unterdessen	ADV	1	unterdessen
erkundigen	VVINF	1	erkundigen
ansichtig	ADV	1	ansichtig
Größe	NN	1	Größe
unvollkommen	ADJD	1	unvollkommen
zehnmal	ADV	1	zehnmal
Baurensprache	NN	1	Baurensprache
erwiesen	ADJA	1	erwiesene
erbärmlich	ADJA	1	erbärmlichen
untertänig	ADJA	1	untertänige
Redlichkeit	NN	1	Redlichkeit
führen	VVINF	1	führen
verrichten	VVFIN	1	verrichten
ungegründeten	ADJA	1	ungegründeten
König	NE	1	König
erstlich	ADJD	1	erstlich
nüchtern	VVINF	1	nüchtern
beurteilen	VVINF	1	beurteilen
bekümmern	VVINF	1	bekümmern
raset	VVFIN	1	raset
verachten	VVINF	1	verachten
schwer	ADJD	1	schwer
gesehn	VVFIN	1	gesehn
Schwanz	NN	1	Schwanze
behutsam	ADJD	1	behutsam
ausgenommen	ADV	1	ausgenommen
behend	ADJA	1	behende
Gestalt	NN	1	Gestalt
schreien	VVINF	1	schreien
Bewegung	NN	1	Bewegungen
erstrecken	VVFIN	1	erstreckt
Abneigung	NN	1	Abneigung
versichern	VVFIN	1	versichere
erwischen	VVFIN	1	erwischt
Mädel	NN	1	Mädel
Werk	NN	1	Werk
brauchen|gebrauchen	VVPP	1	gebraucht
Erlauben	NN	1	Erlauben
teuer	ADJA	1	teuerster
sichs	NE	1	sichs
gleichviel	ADV	1	gleichviel
hintertreiben	VVINF	1	hintertreiben
närrisch	ADJD	1	närrisch
Stich	NN	1	Stich
genugsam	ADV	1	genugsam
Eigensinn	NN	1	Eigensinn
verhelfen	VVINF	1	verhelfen
bestürmen	VVINF	1	bestürmen
Zeitlebens	NN	1	Zeitlebens
hernach	ADV	1	hernach
herum	APZR	1	herum
einzig	ADJA	1	einzigen
eröffnen	VVINF	1	eröffnen
Naseweis	NN	1	Naseweis
Erklärte	NN	1	Erklärten
hochzuehrenden	ADJA	1	hochzuehrenden
Christenheit	NN	1	Christenheit
allzuzärtlicher	ADJA	1	allzuzärtlicher
missfallen	VVPP	1	mißfallen
herausreißen	VVPP	1	herausgerissen
Höflichkeit	NN	1	Höflichkeit
zittern	VVFIN	1	zitterte
Unbekannte	NN	1	Unbekannten
Befehl	NN	1	Befehl
berichten	VVPP	1	berichtet
Ankunft	NN	1	Ankunft
frühmorgens	ADV	1	frühmorgens
Abend	NN	1	Abends
Hehler	NN	1	Hehler
derenwegen	VVFIN	1	derenwegen
bereden	VVINF	1	bereden
ungerecht	ADJD	1	ungerecht
allda	ADV	1	Allda
geschickt	ADJD	1	geschickt
verstehn	VVFIN	1	verstehn
Nacht	NN	1	Nacht
vergelten	VVINF	1	vergelten
Geschwindigkeit	NN	1	Geschwindigkeit
bloß	ADJA	1	bloße
Dummheit	NN	1	Dummheit
schmelzen	VVINF	1	schmelzen
erzeigen	VVFIN	1	erzeigen
auslegen	VVINF	1	auslegen
destoweniger	NN	1	destoweniger
bemühen	VVFIN	1	Bemühe
schicken	VVPP	1	geschickt
Sorge|Sorgen	NN	1	Sorgen
vergeben	VVINF	1	vergeben
gesprächig	ADJA	1	gesprächigen
nebst	APPR	1	nebst
Neigung	NN	1	Neigung
Übel	NN	1	Übels
unvermutet	ADJA	1	unvermuteten
Betrachtung	NN	1	Betrachtungen
venia	NE	1	venia
rühmen	VVINF	1	rühmen
erwachen	VVINF	1	erwachen
zürnen	VVFIN	1	zürnen
aussinnen	VVPP	1	ausgesonnen
stark	ADJD	1	stark
Schönheit	NN	1	Schönheit
beleidigt	ADJD	1	beleidigt
Träumende	NN	1	Träumenden
überzeugt	ADJD	1	überzeugt
Orgel	NN	1	Orgel
Gedränge	NN	1	Gedränge
eingehen	VVINF	1	eingehen
Gehülfe	NN	1	Gehülfe
Verfolgung	NN	1	Verfolgung
erlangt	ADJA	1	erlangtes
vors	APPRART	1	vors
melancholisch	ADJA	1	melancholische
pfui	ITJ	1	Pfui
gelinde	ADJD	1	gelinder
sodann	ADV	1	Sodann
dunkel	ADJD	1	dunkel
Sacke	NN	1	Sacke
anderns	ADV	1	anderns
Wagen	NN	1	Wagen
Alsdann	NE	1	Alsdann
heftig	ADJD	1	heftig
verknüpft	ADJA	1	verknüpften
Eltern	NN	1	Eltern
Winter	NN	1	Winter
Edelmütigkeit	NN	1	Edelmütigkeit
gestehen|stehen	VVPP	1	gestanden
Schlimme	NN	1	Schlimmes
richtig	ADJD	1	richtig
Sohn	NN	1	Sohn
breit	ADJD	1	breit
Vermummte	NN	1	Vermummte
Stehn	NN	1	Stehn
einfältig	ADJD	1	einfältig
übertrieben	ADJA	1	übertriebene
hervor	PTKVZ	1	hervor
unterstehen	VVINF	1	unterstehen
auflösen	VVINF	1	auflösen
Liebhaber	NN	1	Liebhaber
ausfragen	VVINF	1	ausfragen
Verzeihung	NN	1	Verzeihung
zweimal	ADV	1	zweimal
Türe	NN	1	Türe
Prischen	NN	1	Prischen
heben	VVFIN	1	hebe
Gift	NN	1	Gift
Bekanntschaft	NN	1	Bekanntschaft
verzweifeln	VVPP	1	Verzweifelt
erstechen	VVINF	1	erstechen
lustig	ADJD	1	lustig
plündern	VVINF	1	plündern
Verdienst	NN	1	Verdienst
unergründlich	ADJD	1	unergründlich
Lache|Lachen	NN	1	Lachen
lenken	VVFIN	1	lenken
Unachtsamkeit	NN	1	Unachtsamkeit
inbrünstig	ADJA	1	inbrünstigen
nachkommen	VVPP	1	nachgekommen
zurückhalten	VVINF	1	zurückhalten
sauber	ADJD	1	sauber
Hinterhause	NN	1	Hinterhause
alsdenn	NE	1	alsdenn
verlieret	VVFIN	1	verlieret
Schrei|Schreien	NN	1	Schreien
St	NE	1	St
zerrinnen	VVPP	1	zerronnen
edel	ADJA	1	edles
beitragen	VVINF	1	beitragen
allerboshaftesten	ADJA	1	allerboshaftesten
erlustigen	VVINF	1	erlustigen
bedeutend	ADJA	1	bedeutende
widersprechen	VVINF	1	widersprechen
befürchten	VVINF	1	befürchten
drohen	VVFIN	1	drohen
Meisterstück	NN	1	Meisterstück
vorbei	ADV	1	vorbei
Landstraße	NN	1	Landstraße
List	NN	1	List
Heldengedichten	NN	1	Heldengedichten
fünfzig	CARD	1	fünfzig
Erde	NN	1	Erde
nachgewünscht	VVPP	1	nachgewünscht
vermag	VVFIN	1	vermag
Alter	NN	1	Alter
Handelschaft	NN	1	Handelschaft
Ers	ADJD	1	Ers
aufpacken	VVFIN	1	aufpacken
entfernt	ADJD	1	entfernt
nötiget	VVFIN	1	nötiget
fünf	CARD	1	fünf
Bessers	NN	1	Bessers
verschieden	ADJA	1	verschiedenen
Tückische	NN	1	Tückische
Schlimmers	NN	1	Schlimmers
weitläuftig	ADJD	1	weitläuftig
abnehmen	VVINF	1	abnehmen
Räuber|Räubern	NN	1	Räubern
abgedroschnen	ADJA	1	abgedroschnen
ungeschickt	ADJA	1	ungeschickter
unerträglich	ADJD	1	unerträglich
Schritt	NN	1	Schritte
Unterscheid	NN	1	Unterscheid
unruhig	ADJD	1	unruhig
Haar	NN	1	Haar
hassen	VVFIN	1	haßte
Befehl|Befehlen	NN	1	Befehlen
erniedrigen	VVINF	1	erniedrigen
aufgehen	VVFIN	1	aufgingen
jüdisch	ADJA	1	jüdischen
frech	ADJD	1	frech
wofür	PWAV	1	wofür
Dämmerung	NN	1	Dämmerung
subtil	ADJD	1	subtil
Laffe	NN	1	Laffe
jen	PDS	1	jene
gereiset	VVFIN	1	gereiset
Breslau	NE	1	Breslau
leiblich	ADJA	1	leiblichen
Straße	NN	1	Straßen
dank	APPR	1	Dank
Notwendiges	NN	1	Notwendiges
stehn	VVFIN	1	stehn
Verschwiegenheit	NN	1	Verschwiegenheit
Trinklied	NN	1	Trinkliedern
übereilt	ADJA	1	übereilte
Witz	NN	1	Witz
Affe	NN	1	Affen
Vorwande	NN	1	Vorwande
kostbar	ADJD	1	kostbarer
Schwatzhaftigkeit	NN	1	Schwatzhaftigkeit
unsinnig	ADJA	1	unsinniges
Verwahrung	NN	1	Verwahrung
ermüden	VVFIN	1	ermüdet
zuziehen	VVPP	1	zugezogen
finster	ADJD	1	finster
drittemal	ADJD	1	drittemal
Hörst	NE	1	Hörst
zulassen	VVFIN	1	zuließen
befühlen	VVFIN	1	befühlen
Helf	VVFIN	1	Helf
Schnupftuch	NN	1	Schnupftuch
überreden	VVINF	1	überreden
allerlieb	ADJA	1	allerliebstes
manchmal	ADV	1	manchmal
seh	FM	1	seh
Gebüsch	NN	1	Gebüsche
unterschreiben	VVINF	1	unterschreiben
diebisch	ADJA	1	diebisches
entwandte	ADJA	1	entwandte
Rippe	NN	1	Rippen
Kinn	NN	1	Kinn
Gesichtsbildung	NN	1	Gesichtsbildung
verlohne	VVFIN	1	verlohne
Katze	NN	1	Katze
Schulzen	NN	1	Schulzen
Neid	NN	1	Neid
drängen	VVFIN	1	drängte
schmeißen	VVFIN	1	schmeißt
Unruhe	NN	1	Unruhe
Fall	NN	1	Fälle
schwören	VVINF	1	schwören
reisete	VVFIN	1	reisete
weislich	ADJD	1	weislich
zusammen	ADV	1	zusammen
stürzen	VVPP	1	gestürzt
verwandeln	VVFIN	1	verwandelt
überheben	VVPP	1	überhoben
genugsames	ADJA	1	genugsames
wegstipitzt	VVFIN	1	wegstipitzt
bestens	ADV	1	bestens
Finstre	NN	1	Finstern
bestärken	VVFIN	1	bestärkt
Irrtum	NN	1	Irrtum
Michel	NE	1	Michel
erfreu	VVFIN	1	erfreu
beständig	ADJD	1	beständig
statten	VVINF	1	statten
beleidigen	VVINF	1	beleidigen
Heirat	NN	1	Heirat
Lügner	NN	1	Lügner
gehören|hören	VVPP	1	gehört
Betrieger	NN	1	Betrieger
liebreich	ADJD	1	liebreich
Beantwortung	NN	1	Beantwortung
Aufrichtigkeit	NN	1	Aufrichtigkeit
Entdeckung	NN	1	Entdeckung
Völkerschaft	NN	1	Völkerschaften
scheinet	ADJD	1	scheinet
Wanns	NN	1	Wanns
verdient	ADJD	1	verdient
Predigt	NN	1	Predigt
salva	NE	1	salva
reizend	ADJD	1	reizend
Christophen	NN	1	Christophen
Provinz	NN	1	Provinz
Argwohne	VVFIN	1	Argwohne
erwarten	VVINF	1	erwarten
Zufall	NN	1	Zufall
verschnupfen	VVPP	1	verschnupft
verhinderlich	ADJD	1	verhinderlich
besaufen	VVINF	1	besaufen
Heldentat	NN	1	Heldentaten
hinten	ADV	1	hinten
Kutscher	NN	1	Kutscher
offenbar	ADJD	1	offenbar
funfzig	CARD	1	funfzig
fügen	VVFIN	1	fügen
Ohr	NN	1	Ohren
verderben	VVFIN	1	verderbt
Baron	NN	1	Baron
verursachen	VVFIN	1	verursachte
gehorsam	ADJD	1	gehorsam
Rasende	NN	1	Rasenden
spaßen	VVINF	1	spaßen
beschließen	VVPP	1	beschlossen
hochmütig	ADJA	1	hochmütige
ausschütten	VVINF	1	ausschütten
Feind	NN	1	Feinden
Heirat|Heiraten	NN	1	Heiraten
Anwesenheit	NN	1	Anwesenheit
kürzen	VVFIN	1	kürzen
Böse	NN	1	Bösem
Plündern	NN	1	Plündern
umwechseln	VVINF	1	umwechseln
schnurrig	ADJD	1	schnurrig
Schurke	NN	1	Schurke
Versicherung	NN	1	Versicherung
holen	VVIMP	1	hol
Ausnahme	NN	1	Ausnahme
Ohrwürmchen	NN	1	Ohrwürmchen
witzig	ADJA	1	witzige
Gesetzchen	NN	1	Gesetzchen
belohnen	VVPP	1	belohnt
wiederkommen	VVINF	1	wiederkommen
erkenntliches	ADJA	1	erkenntliches
zuhören	VVPP	1	zugehört
Ruhe	NN	1	Ruhe
Nötige	NN	1	Nötige
abgehen	VVFIN	1	abgehen
Blitz	NN	1	Blitz
Kunst	NN	1	Kunst
Zimmermann	NE	1	Zimmermann
Pflicht	NN	1	Pflicht
gestehen	VVINF	1	gestehen
betaure	VVFIN	1	betaure
Bedenken	NN	1	Bedenken
prahlen	VVINF	1	prahlen
unzulänglich	ADJD	1	unzulänglich
Wichtigers	NN	1	Wichtigers
neunmalen	ADJA	1	neunmalen
anbeten	VVINF	1	anbeten
verdoppeln	VVINF	1	verdoppeln
ergeben	VVFIN	1	ergebe
ärgre	VVFIN	1	ärgre
undankbar	ADJD	1	undankbar
erzdumm	ADJD	1	erzdumm
voll	ADJD	1	voll
entgehen	VVPP	1	entgangen
Hui	NE	1	Hui
zublinzt	VVFIN	1	zublinzt
vergnügen	VVINF	1	vergnügen
Schweinfleisch	NN	1	Schweinfleisch
fett	ADJA	1	fetten
Pfarr	NE	1	Pfarr
danken	VVINF	1	danken
hindern	VVFIN	1	hindert
Erklärung	NN	1	Erklärung
Roman	NN	1	Roman
nachdenkend	ADJD	1	nachdenkend
erstaunen	VVINF	1	erstaunen
heiß	ADJD	1	heiß
zeitig	ADJD	1	zeitig
worin	PWAV	1	worin
zweierlei	PIAT	1	zweierlei
gereuen	ADJD	1	gereuen
bins	NN	1	bins
umgehen	VVINF	1	umgehen
Belohnung	NN	1	Belohnung
Sinn	NN	1	Sinne
öfters	ADV	1	öfters
ausrichten	VVINF	1	ausrichten
Beute	NN	1	Beute
morgen	ADV	1	morgen
gleichgültig	ADJD	1	gleichgültig
Allein	NN	1	Allein
Schulmeister	NN	1	Schulmeister
Woche	NN	1	Wochen
entschließen	VVFIN	1	entschließt
warten	VVINF	1	warten
fahren|führen	VVFIN	1	führen
fluchen	VVFIN	1	flucht
Vers	NN	1	Verse
ausnehmen	VVPP	1	ausgenommen
preiswürdig	ADJA	1	preiswürdigen
Gegendienst	NN	1	Gegendienst
schüchtern	ADJD	1	schüchtern
Treulosigkeit	NN	1	Treulosigkeit
wovon	PWAV	1	Wovon
Unhöflichkeit	NN	1	Unhöflichkeit
Narr	NN	1	Narr
einnehmen	VVFIN	1	einnimmt
echt	ADJA	1	echten
wodurch	PWAV	1	Wodurch
Tier	NN	1	Tiere
eilends	ADV	1	eilends
Reife	NN	1	Reife
Biß	NN	1	Bissen
Uhrtasche	NN	1	Uhrtasche
überdrüssig	ADJD	1	überdrüssig
Betrug	NN	1	Betrug
einbilden	VVINF	1	einbilden
belügen	VVPP	1	belogen
worinne	VVFIN	1	worinne
unhöflich	ADJD	1	unhöflich
Glas	NN	1	Gläser
ists	VVFIN	1	ists
zurück	PTKVZ	1	zurück
herausfallen	VVFIN	1	herausfiele
adieu	ADV	1	Adieu
durchdringet	VVFIN	1	durchdringet
plaudern	VVINF	1	plaudern
Kosten	NN	1	Kosten
aushalten	VVINF	1	aushalten
allzuklugen	ADJA	1	allzuklugen
Kostbarers	NN	1	Kostbarers
Religion	NN	1	Religion
Wetter	NN	1	Wetter
Ofen	NN	1	Ofen
vorstellen	VVINF	1	vorstellen
Stückchen	NN	1	Stückchen
Sage|Sagen	NN	1	Sagen
wiegen	VVFIN	1	wiegt
begehen	VVINF	1	begehen
neugierig	ADJD	1	neugierig
Betrügerei	NN	1	Betrügerei
Schelm	NN	1	Schelm
honetten	ADJA	1	honetten
obgleich	KOUS	1	obgleich
willkürlich	ADJA	1	willkürliche
streben	VVFIN	1	strebe
Danksagung	NN	1	Danksagung
vier	CARD	1	vier
Heller	NE	1	Heller
bessern	VVFIN	1	bessern
packen	VVFIN	1	packt
sehs	VVFIN	1	sehs
achtungswürdig	ADJD	1	achtungswürdig
allzusehr	ADJD	1	allzusehr
bezaubern	VVFIN	1	bezaubert
aufhören	VVINF	1	aufhören
verhindern	VVPP	1	verhindert
ken	VVINF	1	ken
sparen	VVFIN	1	sparen
verkappt	ADJA	1	verkappten
verkaufen	VVINF	1	verkaufen
Knecht	NN	1	Knecht
Lot	NN	1	Lot
besänftigen	VVINF	1	besänftigen
scherzen	VVFIN	1	scherzen
kahl	ADJA	1	kahle
dümmre	ADJA	1	dümmre
Überlegung	NN	1	Überlegungen
Gespräch	NN	1	Gespräch
Stadt	NN	1	Städten
Flasche	NN	1	Flaschen
moralisieren	VVINF	1	moralisieren
leer	ADJD	1	leer
Kalender	NN	1	Kalender
nütze	ADV	1	nütze
ziehen	VVINF	1	ziehen
vermummt	ADJA	1	vermummte
kränken	VVFIN	1	kränken
hintragen	VVINF	1	hintragen
Erhaltung	NN	1	Erhaltung
belauschen	VVINF	1	belauschen
allzuviel	PIS	1	allzuviel
Mörder	NN	1	Mörder
siebenmal	ADV	1	siebenmal
Aime	NE	1	aime
bewundern	VVFIN	1	bewundre
gelaßne	ADJA	1	gelaßne
Stern	NN	1	Stern
Siebensache	NN	1	Siebensachen
Döschen	NN	1	Döschen
verfluchen	VVPP	1	verflucht
Tabak	NN	1	Tabak
Magd	NN	1	Magd
Karte	NN	1	Karte
Ankläger	NN	1	Ankläger
besehen	VVFIN	1	besehe
Gelegenheit	NN	1	Gelegenheit
ersuchen	VVFIN	1	ersuche
Küsschen	NN	1	Küßchen
dienstwilliger	ADJA	1	dienstwilliger
Anverwandte	NN	1	Anverwandten
letztemal	ADV	1	letztemal
denken|gedenken	VVPP	1	gedacht
erpicht	ADJD	1	erpicht
ausgestellet	ADJD	1	ausgestellet
gesetzt	ADJD	1	Gesetzt
Geld	NN	1	Geld
Besorgnis	NN	1	Besorgnis
Grund	NN	1	Grunde
ankömmt	VVFIN	1	ankömmt
weder	KON	1	weder
erkennen	VVFIN	1	erkenne
allzugroße	ADJA	1	allzugroße
Erstlich	ADJD	1	Erstlich
Gesindel	NN	1	Gesindel
Schirrmeister	NN	1	Schirrmeister
Amt	NN	1	Amts
hängen	VVPP	1	gehangen
hastig	ADJD	1	hastig
Verdruss	NN	1	Verdruß
Dienen	NN	1	Dienen
Eifer	NN	1	Eifer
Potz	NN	1	Potz
zergliedern	VVINF	1	zergliedern
verwegen	ADJD	1	verwegen
Gericht	NN	1	Gerichten
Geschmack	NN	1	Geschmack
gehorsamster	ADJA	1	gehorsamster
gutherzig	ADJA	1	gutherzige
genau	ADJD	1	genau
Landwein	NN	1	Landwein
Besaufen	NN	1	Besaufen
Ausschweifung	NN	1	Ausschweifungen
vertreiben	VVINF	1	vertreiben
