Title: Emilia Galotti
Number of all lemmas: 6863
Nummber of different lemmas: 2154

Lemma	POS	Frequency	Tokens
Prinz	NE, NN	119	Prinz, Prinzen
Herr	NN	89	Herr, Herrn
gut	ADJD, ADJA	86	besser, gut, Guten, gute, guter, gutem, bester, Gut, guten, gutes, bestes, beste, besten, Guter, Bester
Graf	NN, NE	80	Grafen, Graf
Marinelli	NE	79	Marinelli
sagen	VVINF, VVFIN, VVIMP, VVPP	77	sagen, sagte, sag, sage, gesagt, sagten, sagt, Sag, Sagen, Sagte
Tochter	NN	73	Tochter, Töchter
wissen	VVFIN, VVINF, VVPP	70	wissen, weiß, wüßte, gewußt, wußte, wisse, Wissen, wüßten, Weiß, wüßtest
gnädig	ADJA, ADJD	66	gnädiger, Gnädiger, gnädige, gnädig, Gnädige, gnädiges, gnädigster, gnädigen
wohl	ADV, PTKVZ	65	wohl, Wohl
Mutter	NN	62	Mutter, Mütter
Emilia	NE	60	Emilia
sehen	VVFIN, VVPP, VVINF, VVIMP	59	sieht, gesehen, sehen, sahen, sehe, siehst, sah, Sehen, Sieh, sieh
Vater	NN	53	Vater, Vaters, Väter
hören	VVFIN, VVINF, VVIMP	47	hörten, Hören, höre, hören, hörte, hört, Hört, Hörten, höret, hör
Galotti	NE, NN	41	Galotti
Gräfin	NN	39	Gräfin
eben	ADV	35	eben, Eben
Wort	NN	31	Wort, Worte
erst	ADV, ADJA	31	erst, erste, ersten, Erst
gar	ADV	31	gar
lieb	ADJA, ADJD	30	lieben, lieber, Lieber, liebsten, Liebster, Liebe, liebste, liebe, Liebes
Hand	NN	30	Hand, Hände, Händen
heute	ADV	30	heute, Heute
Auge	NN	30	Augen, Auge
denken	VVFIN, VVINF, VVIMP	29	dachte, dächte, denken, denk, denkst, denke, Denke, Denken, denkt
nehmen	VVFIN, VVPP, VVINF, VVIMP	28	nimmt, nehmen, genommen, Nehmen, nahm, Nimm, Nimmt, nehme
recht	ADJD, PTKVZ	27	Recht, recht
Mann	NN	26	Mann, Manne, Mannes, Männer
unser	PPOSAT	26	Unsere, unserer, Unser, unsere, unser, unserm, unseres, unsres, unsrer, unsers
ruhig	ADJD, ADJA	26	ruhig, ruhiger, Ruhig
Ha	NE	25	Ha
Freund	NN, NE	25	Freund, Freunde, Freundes
einzig	ADJA, ADJD	24	einziges, einzigen, einziger, einzige, einzig
kennen	VVFIN, VVINF, VVIMP	24	kenne, kennen, kenn, Kennen, kennst, Kenn, kennest, kennt
glauben	VVIMP, VVPP, VVFIN, VVINF	24	glaub, geglaubt, glaubt, glaube, glaubte, glauben, Glauben
Conti	NE	23	Conti
Frau	NN	23	Frau
gewiss	ADJD, ADJA	22	gewiß, gewisse, Gewiß
tot	ADJD	22	tot, Tot
wahr	ADJD, ADJA	22	Wahr, wahre, wahr
Appiani	VVFIN, ADJD, ADJA, NN, VVPP, NE	21	Appiani
ah	ITJ	20	Ah, ah
kömmt	VVFIN, ADJA, ADJD	20	kömmt
finden	VVFIN, VVINF, VVPP	19	fand, finde, findet, finden, gefunden
Liebe	NN	19	Liebe
Stadt	NN	19	Stadt
wenige	PIS, PIAT	18	weniger, weniges, wenig, wenigen
verlieren	VVPP, VVINF, VVFIN	18	verloren, verlieren
Gott	NN	18	Gott
Ding	NN	18	Dinge, Dingen, Ding
allein	ADV	18	allein
Herz	NN	17	Herzen, Herz
verstehen	VVFIN, VVIMP, VVPP, VVINF	17	Verstehen, versteh, versteht, verstand, verstanden, verstehen, verstehe, Versteh, verstünde
Ton	NN	17	Tone, Ton
erwarten	VVINF, VVPP, VVFIN	17	erwarten, erwartet, erwarteten, erwarte
Zufall	NN	17	Zufall
schön	ADJD, ADJA	17	schön, schönen, schöner, schönes, schönstes, schöne, schönste
genug	ADV	16	genug, Genug
nie	ADV	16	nie, Nie
Orsina	NE	16	Orsina
Bild	NN	16	Bild, Bilde, Bildern
sonst	ADV	16	sonst, Sonst
gern	ADV	16	gern
weiter	ADV, PTKVZ	16	weiter, Weiter
freilich	ADV	16	freilich, Freilich
Haus	NN	16	Häuser, Häusern, Haus, Hause
Morgen	NN	15	Morgen, Morgens
groß	ADJA, ADJD	15	großen, großer, größte, größten, große, groß, größter, größere, Größer, großem, großes
Gnade	NN	15	Gnade, Gnaden
stehen	VVFIN, VVINF, VVIMP	15	Steht, stehe, steht, stehet, stehen, steh, stand
vergessen	VVFIN, VVPP, VVINF	14	vergißt, vergessen, vergaß, vergesse, Vergessen
sogleich	ADV	14	sogleich, Sogleich
Ehre	NN	14	Ehre
Braut	NN	14	Braut
Name	NN	14	Namen, Name
Kunst	NN	14	Kunst
Seele	NN	14	Seele, Seelen
verzeihen	VVINF, VVFIN	13	verzeihen, Verzeihen, verzeihe
Kind	NN	13	Kind, Kinder, Kinde
Mörder	NN	13	Mörder, Mörders
bitten	VVFIN, VVINF, VVPP	12	bitte, bitten, bat, gebeten
Angelo	NE	12	Angelo
Gewalt	NN	12	Gewalt
heißen	VVFIN, VVINF	12	heißt, heißen
Weg	NN	12	Wege, Weg, Weges
bloß	ADJD, ADJA	12	bloß, bloßer, bloße
Wagen	NN	12	Wagen
Fräulein	NN	12	Fräulein
bald	ADV	12	bald, Bald
geschehen	VVFIN, VVINF, ADJA, VVPP	12	geschieht, geschehen, geschehenen, geschähe
Verstand	NN	12	Verstande, Verstand
leben	VVFIN, VVINF, VVIMP	12	leben, Leb, lebe, lebte, Leben, lebt
Guastalla	NE	12	Guastalla
Welt	NN	12	Welt
ha	ITJ, NE	12	Ha, ha
Dolch	NN	11	Dolch, Dolche
vielleicht	ADV	11	vielleicht, Vielleicht
lieben	VVPP, VVFIN, VVINF	11	geliebt, liebte, liebe, lieben, liebet, liebt
Tag	NN	11	Tag, Tage, Tages
lange	ADV	11	lange
lang	ADJA, ADJD	11	langen, lange, länger, lang, langes
Leben	NN	11	Lebens, Leben
Brief	NN	11	Brief, Briefes, Briefe
Glück	NN	11	Glück
retten	VVFIN, VVINF, VVPP	11	Retten, retten, gerettet
fürchten	VVINF, VVFIN	10	fürchten, fürchtet, fürchte, fürchtete
Zeit	NN	10	Zeit
unglücklich	ADJA, ADJD	10	unglücklicher, unglücklich, unglückliche, unglücklichen
Claudia	NE	10	Claudia
werd	VVFIN	10	ward, werd, Ward
Seite	NN	10	Seite, Seiten
klein	ADJA, ADJD	10	kleinen, kleine, kleiner, kleines
geschwind	ADJD	10	geschwind, Geschwind
Sache	NN	10	Sache
Tod	NN	10	Tod
Verbrechen	NN	10	Verbrechen, Verbrechens
lachen	VVINF, VVFIN, VVIMP	10	lachen, Lachen, lach, lacht
zurück	PTKVZ, ADV	10	zurück, Zurück
Kopf	NN	10	Kopf, Kopfe
fahren	VVFIN, VVINF	10	fahren, Fahren, fährt, Fährt
Schönheit	NN	9	Schönheit, Schönheiten
Augenblick	NN	9	Augenblick, Augenblicke
brauchen	VVFIN, VVINF	9	braucht, brauchen, brauchte
führen	VVINF, VVFIN	9	führen, führt, führtest, führte
Dosalo	NN	9	Dosalo
Madame	NN	9	Madame
darum	PAV	9	darum
Freundschaft	NN	9	Freundschaft
Himmel	NN	9	Himmel, Himmels
heraus	PTKVZ, ADV	9	heraus, Heraus
treten	VVFIN, VVINF	9	Treten, tritt, treten, trat, Tritt
wahrlich	ADV	8	Wahrlich, wahrlich
Gemahlin	NN	8	Gemahlin
hätt	VVFIN	8	hätt
Wut	NN	8	Wut
stolz	ADJA, ADJD	8	stolze, Stolz, stolz, stolzer
außer	APPR, KOUS	8	außer, Außer
fassen	VVINF, VVFIN, VVPP	8	fassen, Fasse, gefaßt, faßt, Fassen
Mund	NN	8	Mund
Maler	NN	8	Maler, Malers
alt	ADJA	8	alter, alte, alten
treffen	VVFIN, VVINF	8	traf, trifft, treffen
Recht	NN	8	Recht
endlich	ADV, ADJA	8	Endlich, endlich, endlichen
heuen	VVFIN	8	heut
unschuldig	ADJA, ADJD	8	unschuldigen, unschuldig, Unschuldig
herein	ADV, PTKVZ	8	herein
befehlen	VVPP, VVINF, VVFIN	8	befohlen, befehlen, befehle
schmeicheln	VVPP, VVINF, VVFIN	8	geschmeichelt, schmeicheln, Schmeicheln, schmeichelt
warten	VVFIN, VVINF	8	wartet, warten, wartete
reißen	VVFIN, VVPP, VVINF	8	reißt, gerissen, riß, Reißt, reißen
Battista	NE	8	Battista
eins	CARD	8	eins, Eins
Emilien	NE	8	Emilien
Mensch	NN	8	Menschen, Mensch
Lust	NN	8	Lust, Lüsten, Lüste
kehren	VVFIN, VVIMP, VVINF	7	kehret, kehre, kehrt, Kehrt, kehren
ergreifen	VVFIN, VVPP, VVINF	7	ergreift, ergriffen, ergreifen
Stunde	NN	7	Stunde
Mädchen	NN	7	Mädchen
Arm|Arme	NN	7	Arme, Armen
Gedanke	NN	7	Gedanken, Gedanke
Verachtung	NN	7	Verachtung
Tugend	NN	7	Tugend
fort	ADV, PTKVZ	7	fort, Fort
gehören	VVFIN	7	gehört, gehörte
Marchese	NN	7	Marchese
würdig	ADJA, ADJD	7	würdiger, würdig, würdigen, würdigsten
schlagen	VVFIN, VVINF, VVPP	7	schlägt, schlagen, schlug, geschlagen
Leute	NN	7	Leuten, Leute
merken	VVPP, VVIMP, VVINF, VVFIN	7	gemerkt, merk, merken
Blut	NN	7	Blut, Blute
fallen|fällen	VVFIN	7	fällt
wozu	PWAV	7	Wozu, wozu
fragen	VVFIN, VVINF, VVIMP	7	fragt, fragen, Fragen, frag
Haar	NN	7	Haar, Haare, Haaren
stürzen	VVPP, VVFIN	7	gestürzt, stürzte, stürzen, stürzt
Bediente	NN	7	Bediente, Bedienten, Bedienter
Sabionetta	NE	7	Sabionetta
Dame	NN	7	Damen, Dame
früh	ADJD, ADJA	7	früh, früher, frühen
Wunsch	NN	7	Wünsche, Wunsche, Wunsch
ablaufen	VVPP, VVIZU, VVFIN	7	abgelaufen, abzulaufen, abläuft
setzen	VVFIN, VVPP	7	Setzen, Setzt, setzt, setzen, gesetzt, Gesetzt
wild	ADJD, ADJA	7	wild, wildes, wilden
voraus	ADV, PTKVZ	6	voraus, Voraus
beleidiget	VVFIN	6	beleidiget
Person	NN	6	Person, Personen
er|es	PPER	6	Ihm
Lüge	NN	6	Lüge
Wille	NN	6	Willen, Willens
erwägen	VVINF, VVFIN	6	erwägen, Erwägen, erwäge
Fuß	NN	6	Fuße, Füße, Füßen
wert	ADJD	6	wert
diese	PDS	6	diese, diesen, dieser, dieses
Bräutigam	NN	6	Bräutigam
schwerlich	ADJD	6	schwerlich, Schwerlich
Tat	NN	6	Tat, Taten
ehrlich	ADJA	6	ehrliche, ehrlichen, ehrlicher
lesen	VVPP, VVFIN	6	gelesen, las
glücklich	ADJD, ADJA	6	glücklich, glückliches
entfernen	VVPP, VVINF, VVFIN	6	entfernt, entfernen, Entfernen
Verdacht	NN	6	Verdacht
itzt	ADJD	6	itzt
antworten	VVPP, VVINF, VVFIN	6	geantwortet, antworten, antworte
Werk	NN	6	Werk
Messe	NN	6	Messe
gering	ADJA	6	geringste, geringsten, geringeres
begegnen	VVPP, VVINF, VVFIN	6	begegnet, begegnen, begegnete
entgegen	APPR, PTKVZ, ADV, APPO	6	entgegen
sterbend	ADJA	6	sterbenden
ehe	KOUS	6	ehe
Künstler	NN	6	Künstler, Künstlers
Sohn	NN	6	Sohnes, Sohn, Sohne
lustig	ADJA, ADJD	6	lustigsten, lustiger, lustig, lustigste, Lustig
eilen	VVFIN	6	eilen, eilte, Eilen
erlauben	VVINF, VVPP, VVFIN	6	erlauben, erlaubt, erlaube, Erlauben
ernsthaft	ADJD, ADJA	6	Ernsthaft, ernsthaft, ernsthafte
Schritt	NN	6	Schritte, Schritt
nennen	VVFIN, VVINF	6	nennen, nennst, nannte
jen	PDS, PDAT	6	jene, jenem, jenes, jener, Jene, jenen
Umstand	NN	6	Umstände, Umstand, Umständen
zusammen	ADV, PTKVZ	6	zusammen
verlassen	VVPP, VVINF, ADJA	6	verlassen, verlassene
brechen	VVFIN, VVINF, VVPP	6	bricht, brechen, brach, gebrochen
vermuten	VVPP, VVFIN, VVINF	6	vermutet, vermutete, vermuten, vermute
leicht	ADJD	6	leicht
wenigstens	ADV	6	wenigstens
indes	ADV, KOUS	6	Indes, indes
danken	VVFIN, VVINF	6	danke, danken
tief	ADJD, ADJA	6	tiefer, tief, tiefen, tiefster, tiefsten
morgen	ADV	6	morgen, Morgen
kaum	ADV	6	kaum, Kaum
zärtlich	ADJA	6	zärtliche, zärtlichsten, zärtlichen
suchen	VVFIN, VVINF	6	suchte, suchen, suche
Bruneschi	NE, NN	6	Bruneschi
melden	VVINF, VVPP, VVFIN	6	melden, gemeldet
vortrefflich	ADJD	6	Vortrefflich, vortrefflich
Kammerherr	NN	6	Kammerherr
Miene	NN	5	Miene, Mienen
laß	ADJD	5	laß
versprechen	VVPP, VVINF, VVFIN	5	versprochen, versprechen, versprach
weniger	ADV	5	weniger
Fürst	NN	5	Fürst, Fürsten
Kanzler	NN	5	Kanzler, Kanzlers
vielmehr	ADV	5	vielmehr
wider	APPR	5	wider
Kloster	NN	5	Kloster
Art	NN	5	Art
weiblich	ADJA	5	weibliches, weiblichen, weibliche
nochmals	ADV	5	nochmals
reiten	VVFIN, VVINF	5	reitet, reiten, reitest, Reite, reite
Massa	NE	5	Massa
worüber	PWAV	5	worüber
gestern	ADV	5	gestern
schlimm	ADJD, ADJA	5	schlimmer, schlimmsten, Schlimm
kurz	ADJA, ADJD	5	kurzen, kurz
zweit	ADJA	5	zweiten
Anstalt	NN	5	Anstalten
Hals	NN	5	Hals, Halse
fertig	ADJA, ADJD, PTKVZ	5	fertige, fertig
Furcht	NN	5	Furcht
zugleich	ADV	5	zugleich
schicken	VVFIN, VVINF	5	Schicken, schicken, schickte
vergeben	VVFIN, VVPP, VVINF, VVIMP	5	vergebe, vergeben, vergib, Vergeben
einander	PRF	5	einander
Original	NN	5	Original
Hof	NN	5	Hofe, Hof, Hofes
am	PTKA	5	Am, am
dienen	VVPP, VVINF	5	gedient, dienen
elend	ADJA, ADJD	5	elenden, elender, Elender
begleiten	VVINF, VVPP	5	begleiten, begleitet
Gift	NN	5	Gift
senden	VVINF, VVFIN	5	senden, Senden
werfen	VVFIN	5	wirft, werfe
vollends	ADV	5	vollends, Vollends
fallen	VVFIN, VVINF	5	fiel, fiele, fallen, falle
wagen	VVFIN, VVINF, VVIMP, VVPP	5	wagst, wagen, wag, gewagt
Unrecht	NN	5	Unrecht
reden	VVFIN	5	reden, Reden
arm	ADJA	5	arme, armen, Armes
Rose	NN	5	Rose
Bittschrift	NN	5	Bittschriften, Bittschrift
gehören|hören	VVPP	5	gehört
Kammerdiener	NN	5	Kammerdiener
Unglückliche	NN	5	Unglücklicher, Unglücklichen, Unglückliche
hinter	APPR	5	hinter, Hinter
Feind	NN	5	Feind, Feindes
Weib	NN	5	Weibe, Weiber, Weib
Verwahrung	NN	5	Verwahrung
Sinn	NN	5	Sinne, Sinn
fahren|führen	VVFIN	5	führe
dahin	PAV	5	dahin, Dahin
beten	VVFIN, VVINF	5	bete, beten
Pirro	NE	5	Pirro
Stelle	NN	5	Stelle
Wahrheit	NN	5	Wahrheit
legen	VVFIN, VVINF	5	Legt, legte, legt, legen
wünschen	VVFIN, VVPP, VVINF	5	wünschte, gewünscht, wünschen
weder	KON	5	weder
erkennen	VVFIN	5	erkenne, Erkennen, erkannte
Nähe	NN	5	Nähe
wär	VVFIN, ADJD	5	wär
erblicken	VVFIN, VVINF, VVPP	5	erblicke, erblicken, erblickte, erblickt, Erblickt
niemand	PIS	4	niemanden, Niemand, niemand
Hülfe	NN	4	Hülfe
Sinn|Sinnen	NN	4	Sinnen
konnt	VVFIN	4	konnt
laufen	VVFIN, VVIMP	4	lief, lauf
nahe	PTKVZ	4	nahe
Gleichgültigkeit	NN	4	Gleichgültigkeit
Mitleid	NN	4	Mitleid, Mitleids
schlecht	ADJD, ADJA	4	schlechter, schlechten, schlecht
leid	ADJD	4	leid
blicken	VVFIN	4	blickest, blickte, Blickt
erhalten	VVINF	4	erhalten
Kirche	NN	4	Kirche
schließen	VVINF, VVFIN	4	schließen, schloß
hierher	PAV, PTKVZ	4	hierher
hereintritt	VVFIN	4	hereintritt
kosten	VVINF, VVPP, VVFIN	4	kosten, gekostet, kostet
arbeiten	VVINF	4	arbeiten, Arbeiten
woran	PWAV	4	woran, Woran
Ende	NN	4	Ende
Pferd	NN	4	Pferde, Pferd
sogar	ADV	4	sogar, Sogar
fliehen	VVFIN, VVINF	4	floh, fliehen
Perle|Perlen	NN	4	Perlen
Gesicht	NN	4	Gesicht, Gesichte
hoffen	VVINF, VVFIN	4	hoffen, hoffe
vorbei	PTKVZ, ADV	4	vorbei
Beutel	NN	4	Beutel
ewig	ADJD	4	ewig
vertrauen	VVINF, VVFIN	4	vertrauen, vertraute
traurig	ADJA	4	traurigen, traurige
sonderbar	ADJD, ADJA	4	sonderbar, sonderbare, sonderbarer
Geduld	NN	4	Geduld
lernen	VVINF, VVFIN	4	lernen
vorzüglich	ADJA	4	vorzüglichsten, vorzüglichen
Gebiet	NN	4	Gebiete
besonder	ADJA	4	besondere, Besondere
redlich	ADJD	4	redlich, Redlich, redlicher
verwunden	VVINF, VVPP	4	verwunden, verwundet
zittern	VVFIN	4	zitterst, zitterte
Befehl	NN	4	Befehls, Befehl
Grimaldi	NE	4	Grimaldi
Nebenbuhler	NN	4	Nebenbuhler
Engel	NN, NE	4	Engel
nötig	ADJD	4	nötigsten, nötig
Todesurteil	NN	4	Todesurteil
erfahren	VVFIN, VVPP	4	erführe, erfahren, erfuhr
Traum	NN	4	Traum, Traume
wohin	PWAV	4	wohin, Wohin
Kleinigkeit	NN	4	Kleinigkeit
Liebhaber	NN	4	Liebhaber
Odoardo	NE	4	Odoardo
Verzeihung	NN	4	Verzeihung
Türe	NN	4	Türe
ausmachen	VVFIN, VVIZU, VVPP	4	ausmache, auszumachen, ausgemacht
erheben	VVINF, VVFIN	4	erheben, erhebt, erhob
Teufel	NN	4	Teufel
weißen	VVFIN	4	Weißt, weißt
Schuldigkeit	NN	4	Schuldigkeit
Unglück	NN	4	Unglück, Unglücke
Rat	NN	4	Räten, Rat
nimmermehr	ADV	4	Nimmermehr
zufrieden	ADJD	4	zufrieden
wofür	PWAV	4	wofür
fehlen	VVFIN, VVINF	4	fehlt, fehlen
bedenken	VVFIN, VVINF	4	bedenkst, bedenken
sprengen	VVFIN, VVPP	4	sprengte, gesprengt
schießen	VVPP, VVFIN	4	geschossen, Geschossen, schoß
seh	FM, XY, NE	4	seh
unterschreiben	VVFIN, VVINF	4	unterschreibt, unterschreiben
schwören	VVINF, VVFIN	4	schwören, Schwören
Natur	NN	4	Natur
Zimmer	NN	4	Zimmer, Zimmern
andermal	ADV	4	andermal
vernehmen	VVPP, VVINF	4	vernommen, vernehmen
Räuber	NN	4	Räuber, Räubers
bedürfen	VVFIN, VVINF	4	bedarf, bedürfen
voll	ADJD, ADJA	4	voll, voller, vollem
gleichgültig	ADJD	4	gleichgültig, Gleichgültig
Gefahr	NN	4	Gefahr
Teil	NN	4	Teil, Teile
Vorzimmer	NN	4	Vorzimmer
Rede	NN	4	Rede
jemand	PIS	4	jemand
Gesetz	NN	4	Gesetz, Gesetze
Träne|Tränen	NN	4	Tränen
Anteil	NN	4	Anteil
Überlegung	NN	4	Überlegung
selten	ADJD	4	selten
Entfernung	NN	4	Entfernung
oft	ADV	4	oft
Gerechtigkeit	NN	4	Gerechtigkeit
beschäftiget	VVFIN	4	beschäftiget
geheim	ADJD, ADJA	4	geheim, geheimsten
seit	APPR	4	seit
ausfahren	VVINF, VVIZU, VVPP	3	ausfahren, auszufahren, ausgefahren
Platz	NN	3	Platz
Richter	NN, NE	3	Richter
freundschaftlich	ADJD, ADJA	3	freundschaftlich, freundschaftlichsten
warm	ADJD, ADJA	3	warm, warmes
plötzlich	ADJD, ADJA	3	plötzlich, plötzlichen
Ziel	NN	3	Ziele, Ziel
augenblicklich	ADJD, ADJA	3	augenblicklich, augenblicklichen
verleiten	VVFIN, VVPP	3	verleiten, verleitet
frei	ADJA, ADJD	3	freie, frei
Rede|Reden	NN	3	Reden
Halle	NN	3	Halle
raten	VVINF, VVFIN	3	raten, Raten
bitter	ADJD, ADJA	3	Bitter, bittern
Närrin	NN	3	Närrin
albern	ADJA, ADJD	3	albernes, albern, albernen
verraten	VVFIN, VVPP	3	verriet, verraten
Gang	NN	3	Gang, Ganges
Vergnügen	NN	3	Vergnügen
durchaus	ADV	3	durchaus
Eindruck	NN	3	Eindrücken, Eindruck, Eindrücke
Vermählung	NN	3	Vermählung
Verbindung	NN	3	Verbindung
sinken	VVINF, VVFIN	3	sinken
rufen	VVFIN, VVINF	3	rufen
Grund	NN	3	Grund, Grunde
verdammt	ADJA	3	verdammtes, Verdammter, verdammte
wenig	ADV	3	wenig
Zweifel	NN	3	Zweifel
Genugtuung	NN	3	Genugtuung
manche	PIAT, PIS	3	manchem, mancher
Entführung	NN	3	Entführung
kalt	ADJD	3	kalt, Kalt, kälter
weise	ADJD, ADJA	3	weise, weisen
Arm	NN	3	Arm
Geschmeide	NN	3	Geschmeide
widerfahren	VVINF, VVPP	3	widerfahren
feierlich	ADJD, ADJA	3	feierlich, feierlichen
beneiden	VVFIN, VVINF	3	beneidet, beneiden
Argwohn	NN	3	Argwohn
Hochzeit	NN	3	Hochzeiten, Hochzeit
verdienen	VVINF, VVFIN	3	verdienen, verdiene, verdiente
Unschuld	NN	3	Unschuld
Fenster	NN	3	Fenster
Schwachheit	NN	3	Schwachheit
erholen	VVFIN, VVPP, VVINF	3	Erholen, erholt, erholen
geträumet	VVFIN, VVPP	3	geträumet
trennen	VVFIN, VVINF	3	trenne, trennen
herzlich	ADJD	3	herzlich, Herzlich
streng	ADJA	3	strengen, strengste, strengsten
schrecklich	ADJD, ADJA	3	schrecklich, schreckliche
Altar	NN	3	Altar, Altare
lächerlich	ADJA, ADJD	3	lächerlichsten, lächerlich
bezeigen	VVINF, VVFIN	3	bezeigen, bezeigte
verachten	VVFIN, VVPP, VVINF	3	verachtet, verachten
Tanz	NN	3	Tanz
vorenthalten	VVIZU, VVPP, VVINF	3	vorzuenthalten, vorenthalten
Vorwurf	NN	3	Vorwürfen, Vorwurf, Vorwürfe
verderben	VVFIN, VVINF	3	verderbt, verderben, verdarb
meiste	PIS	3	meisten
Fall	NN	3	Fall
halb	ADJD, ADJA	3	halb, halbes
schuldig	ADJD	3	schuldig
wirken	VVFIN	3	wirket, Wirkt, wirkt
Laster	NN	3	Laster, Lasters
verbitten	VVINF	3	verbitten
Schrecken	NN	3	Schreckens, Schrecken
verdienet	VVFIN	3	verdienet
morden	VVINF	3	morden
ohnedem	ADJD	3	ohnedem
väterlich	ADJA	3	väterlichen, väterliche
unsre	PPOSAT	3	unsern
schreien	VVINF	3	schreien
mitnehmen	VVPP, VVINF	3	mitgenommen, mitnehmen
Andacht	NN	3	Andacht
versichern	VVPP, VVFIN	3	versichert, versichern
aufsuchen	VVPP, VVINF, VVFIN	3	aufgesucht, aufsuchen, aufsuchte
Tiergarten	NN	3	Tiergartens, Tiergarten
teilen	VVFIN, VVINF	3	teilen
Gefängnis	NN	3	Gefängnis
euer	PPOSAT	3	eure, Eurer, Euer
erinnern	VVFIN	3	erinnern, erinnere
pfui	ITJ	3	Pfui, pfui
Entzückung	NN	3	Entzückung
Eltern	NN	3	Eltern
Heilige	NN	3	Heiliger, Heiligen, Heilige
laut	ADJA, ADJD, APPR	3	laute, lauter, laut
Porträt	NN	3	Porträt
heben	VVFIN, VVIMP	3	hob, heb
Rota	NE, NN	3	Rota
äußer	ADJA	3	äußersten
Porträte	NN	3	Porträte
gleichsam	ADJD	3	gleichsam
Alter	NN	3	Alter
Anblick	NN	3	Anblicks, Anblicke, Anblick
eräugnen	VVFIN, VVINF	3	eräugnen
malen	VVINF, VVFIN	3	malen
bedeuten	VVFIN	3	bedeuten
Räuber|Räubern	NN	3	Räubern
unruhig	ADJD	3	unruhig
irren	VVFIN	3	irren
bekommen	VVINF, VVFIN	3	bekommen, bekam
Affe	NN	3	Affe, Affen
geruhen	VVINF, VVFIN	3	geruhen
Achtung	NN	3	Achtung
Oberste	NN	3	Oberster
küssen	VVINF	3	küssen
treiben	VVINF	3	treiben
begünstigter	ADJA	3	begünstigter
Dank	NN	3	Dank, Dankes
Glückseligkeit	NN	3	Glückseligkeiten, Glückseligkeit
zwingen	VVPP, VVFIN, VVINF	3	gezwungen, zwingt, zwingen
verwandeln	VVPP, VVFIN	3	verwandelt, verwandle
Gegenwart	NN	3	Gegenwart
Haarnadel	NN	3	Haarnadel
Besuch	NN	3	Besuche, Besuch, Besuchs
Maske	NN	3	Maske
fühlen	VVFIN	3	fühlte, fühle
Wortwechsel	NN	3	Wortwechsel
gelingen	VVFIN, VVPP	3	gelingt, gelungen
vollziehen	VVPP, VVFIN	3	vollzogen, vollziehe, vollzöge
Streich	NN	3	Streiche, Streich
erschrecken	VVFIN	3	erschrecke, erschrecken
sitzen	VVINF, VVPP	3	sitzen, gesessen
willen	APPO	3	willen
mächtig	ADJD	3	mächtig
fallen|gefallen	VVPP	3	gefallen
aufopfern	VVPP, VVIZU	3	aufgeopfert, aufzuopfern
holen	VVFIN, VVINF	3	hole, holen
belohnen	VVINF, VVPP, VVFIN	3	belohnen, belohnt
Bestürzung	NN	3	Bestürzung
Ruhe	NN	3	Ruhe
Triumph	NN	3	Triumphe, Triumph
Durchlaucht	NN	3	Durchlaucht
Finger	NN	3	Finger
Angelegenheit	NN	3	Angelegenheit, Angelegenheiten
Nicolo	NE	3	Nicolo
möcht	VVFIN	3	möcht
Schuss	NN	3	Schuß
hämisch	ADJD	3	hämisch, Hämisch
zeigend	ADJD	3	zeigend
heilig	ADJA	3	heiligen, heiliger, heilige
Pause	NN	3	Pause
Lustschlosse	NN	3	Lustschlosse
Verwünschung	NN	3	Verwünschung
hässlich	ADJD	3	häßlicher, häßlich
fürs	APPRART	3	fürs
lebendig	ADJD	3	lebendiger, lebendig
überraschen	VVFIN, VVPP	3	überraschen, überrascht
Religion	NN	3	Religion
rechnen	VVFIN	3	rechnen, Rechnen
Zeremonie	NN	3	Zeremonie
Schloss	NN	3	Schloß, Schlosse
Schmeichelei	NN	3	Schmeichelei, Schmeicheleien
gefallen	VVFIN, VVINF	3	gefiel, gefallen, Gefällt
Entschluss	NN	3	Entschluß, Entschlusses
fremd	ADJD, ADJA	3	fremd, fremdes, fremden
verhindern	VVPP, VVINF	3	verhindert, verhindern
Kränkung	NN	3	Kränkungen
längst	ADV	3	längst
weg	ADV, PTKVZ	3	weg
Gelegenheit	NN	3	Gelegenheit
Ohr	NN	3	Ohre, Ohren
Sünde	NN	3	Sünden, Sünde
hm	NE	3	Hm, hm
Blick	NN	3	Blicke
zweifeln	VVFIN	3	zweifle, zweifeln, zweifelte
jung	ADJA	3	junger, junge, jungen
hatt	VVFIN	2	hatt
vorschreiben	VVFIN, VVIZU	2	vorschreiben, vorzuschreiben
steigen	VVFIN	2	steigen, steigt
nieder	PTKVZ, ADJD	2	nieder
vorauf	NN	2	vorauf
Sprache	NN	2	Sprache
anfallen	VVPP, VVFIN	2	angefallen, anfielen
Grenze	NN	2	Grenzen, Grenze
Farbe	NN	2	Farben, Farbe
jemals	ADV	2	jemals
träumen	VVFIN, VVINF	2	träume, träumen
pflegen	VVFIN	2	pflegt, pflege
vermutend	ADJD	2	vermutend
verwahret	VVFIN, NE	2	verwahret
toll	ADJA, ADJD	2	tollen, toll
Spur	NN	2	Spur
Täter	NN	2	Tätern, Täter
bezahlen	VVINF	2	bezahlen
Geschäft	NN	2	Geschäfte, Geschäft
lohnen	VVFIN	2	lohnen, lohnt
Rache	NN	2	Rache
springen	VVFIN	2	springt, sprangen
anstehen	VVINF	2	anstehen
unterhalten	VVFIN	2	unterhielt, Unterhielt
Junge	NN	2	Jungen
Gegenstand	NN	2	Gegenstand
Neugierde	NN	2	Neugierde
Monat	NN	2	Monaten, Monat
Weise	NN	2	Weise
Läufer	NN	2	Läufer
Antwort	NN	2	Antwort
tragen	VVINF, VVFIN	2	tragen, trug
beehren	VVFIN	2	beehren, beehrte
unstreitig	ADJD	2	unstreitig, Unstreitig
foderte	VVFIN	2	foderte
Stirne	NN	2	Stirne
Ware	NN	2	Waren
nirgends	ADV	2	nirgends
geliebt	ADJA	2	geliebte, geliebten
richten	VVPP, VVINF	2	gerichtet, richten
Stätte	NN	2	Stätten, Stätte
Schein	NN	2	Schein
Einfall	NN	2	Einfall
empfangen	VVPP, VVINF	2	empfangen
Empfindung	NN	2	Empfindung
höchstens	ADV	2	höchstens
gehn	ADJD	2	gehn
schämen	VVINF	2	schämen
verschaffen	VVFIN	2	verschafft
Prinzessin	NN	2	Prinzessin
suchend	ADJD	2	suchend
töricht	ADJA, ADJD	2	törichte, töricht
argwohnet	VVFIN	2	argwohnet
bekannt	ADJD	2	bekannt
argwohnen	VVFIN	2	argwohnen
ziehen	VVINF	2	ziehen
Entschuldigung	NN	2	Entschuldigung
Vegghia	NE	2	Vegghia
Meuchelmord	NN	2	Meuchelmord
ehrwürdig	ADJA	2	ehrwürdige, ehrwürdigen
Frevel	NN	2	Frevel
blutig	ADJA	2	blutige
Geschöpf	NN	2	Geschöpf, Geschöpfe
Geschlecht	NN	2	Geschlecht, Geschlechts
Aufsicht	NN	2	Aufsicht
Fall|Fällen	NN	2	Fällen
Zorn	NN	2	Zorne, Zorn
erzählen	VVINF, VVFIN	2	erzählen, erzählst
Streit	NN	2	Streit
Stahl	NN	2	Stahl
Bewunderung	NN	2	Bewunderung
stoßen	VVIMP, VVFIN	2	stoß, stieß
nachkommen	VVINF	2	nachkommen
bereit	ADJD	2	bereit
Putz	NN	2	Putze, Putz
Zeuge	NN	2	Zeugen, Zeuge
verdenken	VVINF, VVPP	2	verdenken, Verdacht
Angst	NN	2	Angst
lieset	VVFIN	2	lieset
Acht	NN	2	Acht
stecken	VVFIN	2	steckte, Stecken
Beste	NN	2	Bester
fern	APPR, ADJA	2	fern, fernerer
vorkommen	VVPP, VVINF	2	vorgekommen, vorkommen
Planke	NN	2	Planke
Stück	NN	2	Stücke, Stück
erscheinet	ADJD, VVFIN	2	erscheinet
leer	ADJD, ADJA	2	leer, leeres
Falle	NN	2	Falle
Bitte	NN	2	Bitte
Schmerz	NN	2	Schmerz
dicht	ADJD	2	dicht
Phantasie	NN	2	Phantasie
innig	ADJA, ADJD	2	innigsten, inniger
Schöpfung	NN	2	Schöpfung
Rang	NN	2	Rang
selber	ADV	2	selber
unmittelbar	ADJD, ADJA	2	unmittelbar, unmittelbares
bravo	ITJ	2	bravo
bestellen	VVFIN, VVINF	2	bestellte, bestellen
Abrede	NN	2	Abrede
Gute	NN	2	Gutes, Gute
fehlet	ADJD	2	fehlet
verschwinden	VVINF, VVFIN	2	verschwinden, verschwindet
versuchen	VVFIN, VVINF	2	versucht, versuchen
Absicht	NN	2	Absicht
abreisen	VVFIN, VVINF	2	abreisen
abgeredet	VVPP	2	abgeredet
unmöglich	ADJA, ADJD	2	Unmögliche, unmöglich
Pinsel	NN	2	Pinsel
still	ADJA, ADJD	2	stilles, Still
Wahnwitzigen	NN	2	Wahnwitzigen
Mittag	NN	2	Mittag
Lüge|Lügen	NN	2	Lügen
ei	NE	2	Ei
Verräter	NN	2	Verräter
Stand	NN	2	Stand, Stande
Licht	NN	2	Licht
ihrige	PPOSAT	2	Ihrige
durchstoßen	VVINF	2	durchstoßen
gilts	NN	2	gilts
sündigen	VVINF	2	sündigen
behalten	VVFIN	2	behielte, behält
vorfallen	VVPP, VVFIN	2	vorgefallen, vorfällt
vermengen	VVFIN	2	vermengen, Vermenge
ans	APPRART	2	ans
helfen	VVINF	2	helfen
Bescheidenheit	NN	2	Bescheidenheit
wunderbar	ADJA	2	wunderbarsten, wunderbaren
Wen	NE	2	Wen
weitern	VVINF	2	weitern
betrachten	VVINF	2	betrachten
zahm	ADJD	2	zahm
beurteilen	VVINF	2	beurteilen
grässlich	ADJA, ADJD	2	gräßliche, Gräßlich
edeln	ADJA	2	edeln
Emiliens	NE	2	Emiliens
Frucht	NN	2	Frucht
schnell	ADJD	2	schnell
Eintritt	NN	2	Eintritte, Eintritt
teuer	ADJA	2	teure, teuere
abhangen	VVFIN	2	abhangen
eitel	ADJA, ADJD	2	eitle, eitel
Klage|Klagen	NN	2	Klagen
Höflichkeit	NN	2	Höflichkeit
Vorwand	NN	2	Vorwand
wollüstigen	ADJA	2	wollüstigen
Ausgang	NN	2	Ausgang
Gebieterin	NN	2	Gebieterin
ketten	VVFIN	2	kettet, ketten
Schutz	NN	2	Schutzes, Schutz
jagen	VVINF	2	jagen
ach	ITJ	2	Ach
fein	ADJD	2	fein
woll	VVFIN	2	woll
unvermutet	ADJD, ADJA	2	unvermutet, unvermuteter
zürnen	VVFIN	2	Zürnen, zürnen
achten	VVINF, VVFIN	2	achten, achtet
vors	APPRART	2	vors
gelinde	ADJA, ADJD	2	gelinden, Gelinder
Rechnung	NN	2	Rechnung
gibts	NN	2	gibts
heftig	ADJA, ADJD	2	heftigen, heftig
ehedem	ADV	2	Ehedem, ehedem
entblättern	VVPP	2	entblättert
Schlimme	NN	2	Schlimmes, Schlimmer
minder	ADJD	2	minder, Minder
richtig	ADJD	2	richtig
Sturm	NN	2	Sturm
angetragen	ADJA	2	angetragene
Schwermut	NN	2	Schwermut
Ring	NN	2	Ring
Schreck	NN	2	Schreck
räumen	VVIMP, VVINF	2	räum, räumen
hinaus	PTKVZ, ADV	2	hinaus
äußerst	ADV	2	äußerst
grausam	ADJD, ADJA	2	grausam, Grausamer
besitzen	VVFIN	2	besitze, besäße
Tor	NN	2	Toren, Tor
Mühe	NN	2	Mühe
verlieret	VVFIN	2	verlieret
Geliebte	NN	2	Geliebte, Geliebten
widersprechen	VVFIN	2	widerspricht
Meisterstück	NN	2	Meisterstück, Meisterstücke
Erde	NN	2	Erde
zeihen|ziehen	VVFIN	2	zieht, ziehe
kaufen	VVFIN	2	kauft
Stein	NN	2	Stein, Steinen
närrisch	ADJD	2	närrisch
Verleumdung	NN	2	Verleumdung
Hölle	NN	2	Hölle
Schadenfreude	NN	2	Schadenfreude
hart	ADJD	2	härter, hart
Tal	NN	2	Tälern
Brot	NN	2	Brot
fromm	ADJA	2	fromme
unvermeidlich	ADJD	2	unvermeidlich
Schoß	NN	2	Schoße, Schoß
unverschämt	ADJD, ADJA	2	unverschämt, unverschämter
dank	APPR	2	dank, Dank
Ursache	NN	2	Ursache, Ursachen
äußern	VVINF	2	äußern
unbedeutend	ADJA	2	unbedeutende, unbedeutender
urteilen	VVINF, VVFIN	2	urteilen, urteile
begierig	ADJD	2	begierig
Vornehmste	NN	2	Vornehmste
meinig	PPOSS	2	meinigen, Meinigen
kostbar	ADJA, ADJD	2	kostbaren, kostbar
Schleier	NN	2	Schleier
Ort	NN	2	Ort
find	VVFIN	2	find
Freude	NN	2	Freude
beruhigen	VVFIN, VVINF	2	Beruhigen, beruhigen
scheinet	VVFIN	2	scheinet
stumm	ADJD, ADJA	2	Stumm, stummen
befehlend	ADJD	2	befehlend
verloren	ADJD	2	verloren
nichten	ADJA	2	nichten
fähig	ADJD	2	fähig
rauh	ADJD, ADJA	2	rauh, rauhen
gefaßt	ADJD	2	gefaßt
Unruhe	NN	2	Unruhe
eilig	ADJD	2	eilig, eiligst
Untersuchung	NN	2	Untersuchung
erraten	VVPP, VVFIN	2	Erraten, erriete
nähern	VVFIN	2	nähern, nähert
hegen	VVINF	2	hegen
bewegen	VVFIN, VVINF	2	bewog, bewegen
unendlich	ADJD, ADJA	2	unendlich, unendliche
bestrafen	VVPP	2	bestraft
stellen	VVINF	2	stellen
Witz	NN	2	Witz, Witze
Dienst	NN	2	Diensten, Dienst
Gebrauch	NN	2	Gebrauch
sanft	ADJA, ADJD	2	sanfte, sanft
schlechterdings	ADV	2	schlechterdings
weinen	VVINF, VVFIN	2	weinen, weine
folglich	ADV	2	folglich
Wunder	NN	2	Wunder
Zerstreuung	NN	2	Zerstreuung
Schanze	NN	2	Schanze
dulden	VVINF	2	dulden, Dulden
schaffen	VVPP, VVINF	2	geschaffen, schaffen
geschäftig	ADJD, ADJA	2	geschäftig, geschäftiger
dauern	VVINF, VVFIN	2	dauern, dauert
nachsetzen	VVIZU, VVINF	2	nachzusetzen, nachsetzen
wiederfinden	VVINF, VVPP	2	wiederfinden, wiedergefunden
Schicksal	NN	2	Schicksal
besondern	VVFIN	2	besondern
besorgen	VVIMP, VVFIN	2	besorg, besorgte
Gemahl	NN	2	Gemahl
Itzt	NE	2	Itzt
langsam	ADJD	2	langsam
zurücknehmen	VVINF, VVFIN	2	zurücknehmen
dächt	VVFIN	2	dächt
Gekreusche	NN	2	Gekreusche
wohnen	VVFIN, VVPP	2	wohnet, gewohnt
lügen	VVFIN, VVPP	2	Lügen, gelogen
anhören	VVFIN	2	anhörten
zuführet	VVFIN	2	zuführet
reich	ADJD, ADJA	2	reich, reicher
Seufzer	NN	2	Seufzer
Verführung	NN	2	Verführung
erklären	VVFIN	2	erklären
Lobeserhebungen	NN	2	Lobeserhebungen
Schwur	NN	2	Schwur
liebenswürdig	ADJA	2	liebenswürdige, liebenswürdigen
Geschrei	NN	2	Geschrei
sammeln	VVFIN, VVPP	2	Sammle, gesammelt
seltsam	ADJA	2	seltsamen, seltsame
klar	ADJD	2	klar
Opfer	NN	2	Opfer
erstaunen	VVFIN	2	erstaune
paar	PIAT	2	paar, Paar
verlangen	VVFIN	2	verlangen
vier	CARD	2	vier
öffnen	VVFIN	2	öffnet, Öffnet
wundern	VVINF, VVFIN	2	wundern, Wundert
gewaltsam	ADJA	2	gewaltsamen, gewaltsame
verhehlen	VVFIN	2	verhehlen
Woche	NN	2	Wochen
heilsam	ADJA, ADJD	2	heilsames, heilsam
Beleidigung	NN	2	Beleidigungen, Beleidigung
umarmen	VVFIN	2	umarmen
unbekannt	ADJD, ADJA	2	unbekannt, unbekannter
entschließen	VVINF, VVPP	2	entschließen, entschlossen
bekennen	VVINF, VVFIN	2	bekennen
überfallen	VVFIN, VVPP	2	überfällt, überfallen
Würde	NN	2	Würde
wovon	PWAV	2	wovon
Saal	NN	2	Saales, Saale
umsonst	ADV	2	Umsonst
weiset	VVFIN	2	weiset
verabreden	VVPP	2	verabredet
ichs	ADJD	2	ichs
betreffen	VVPP	2	betroffen
Ernst	NE	2	Ernst
plaudern	VVFIN, VVINF	2	plaudert, plaudern
ziemet	NN, VVFIN	2	ziemet
wieget	VVFIN	2	wieget
begehen	VVPP, VVINF	2	begangen, begehen
neugierig	ADJD, ADJA	2	neugierig, neugierigen
etwa	ADV	2	etwa
Kundschaft	NN	2	Kundschaft
neben	APPR	2	Neben, neben
verweilen	VVFIN	2	verweile, verweilen
bezaubern	VVFIN, VVPP	2	bezaubert
Minute	NN	2	Minute, Minuten
Kerker	NN	2	Kerker
drum	PAV	2	Drum, drum
Wahnwitzige	NN	2	Wahnwitzige
vergebens	ADV	2	vergebens
entscheiden	VVFIN	2	entscheide
Dominikaner	NN	2	Dominikanern
Unangenehme	NN	2	Unangenehmes
Hoffnung	NN	2	Hoffnung
abfahren	VVINF, VVPP	2	abfahren, abgefahren
ernst	ADJD	2	ernst, ernster
bewundern	VVINF, VVPP	2	bewundern, bewundert
Einer	NN	2	Einer
wehen	VVIMP	2	weh, Weh
verfluchen	VVINF	2	verfluchen
Studium	NN	2	Studium
zuverlässig	ADJD	2	Zuverlässig
Unglücksfall	NN	2	Unglücksfälle
umkehren	VVIZU, VVINF	2	umzukehren, umkehren
verschließen	VVPP, VVFIN	2	verschlossen, verschließt
womit	PWAV	2	womit
versagen	VVPP	2	versagt
dennoch	ADV	2	dennoch
denken|gedenken	VVPP	2	gedacht
vorfahren	VVFIN, VVINF	2	vorfahren
Geld	NN	2	Gelde
huschen	VVIMP	2	Husch, husch
klingeln	VVFIN	2	klingelt
verweisen	VVPP	2	verwiesen, Verwiesen
hastig	ADJD	2	hastig, Hastig
Vorsicht	NN	2	Vorsicht
ärgerlich	ADJD	2	ärgerlich
Nachricht	NN	2	Nachricht
Geschmack	NN	2	Geschmack
Heer	NN	2	Heer
meuchelmörderschen	ADJA	1	meuchelmörderschen
Zurückkunft	NN	1	Zurückkunft
schütten	VVFIN	1	Schütten
beobachten	VVFIN	1	beobachte
Takt	NN	1	Takt
bemächtiget	VVFIN	1	bemächtiget
Eingeweide	NN	1	Eingeweide
Galerie	NN	1	Galerie
Kleid	NN	1	Kleid
Lunge	NN	1	Lunge
euern	ADJA	1	euern
Charakter	NN	1	Charakter
trollen	VVINF	1	trollen
treulich	ADJD	1	treulich
durchstechen	VVFIN	1	durchsticht
Trotz	NN	1	Trotze
hervorragend	ADJA	1	hervorragenden
recht|rechts	ADJA	1	rechten
versetzen	VVFIN	1	versetzte
Wuchs	NN	1	Wuchs
Misstrauen	NN	1	Mißtrauen
auspressen	VVINF	1	auspressen
schöpfen	VVINF	1	schöpfen
naiv	ADJD	1	naiv
Traun	NE	1	Traun
Wohltäterin	NN	1	Wohltäterin
gestöret	VVPP	1	gestöret
melancholischsten	ADJA	1	melancholischsten
Nebensache	NN	1	Nebensache
annehmen	VVINF	1	annehmen
vorig	ADJA	1	voriger
drei	CARD	1	drei
überlegend	ADJD	1	Überlegend
ungefähr	ADJD	1	ungefähr
speien	VVINF	1	speien
Tausend	NN	1	Tausende
Vorteil	NN	1	Vorteil
himmlisch	ADJA	1	himmlische
schwärmen	VVFIN	1	schwärmen
abzureden	VVIZU	1	abzureden
gehörest	VVFIN	1	gehörest
Schwärmerei	NN	1	Schwärmerei
Erziehung	NN	1	Erziehung
wenigsten	ADV	1	wenigsten
Uhr	NN	1	Uhr
Befriedigung	NN	1	Befriedigung
nichtswürdig	ADJD	1	nichtswürdig
unglückselig	ADJA	1	unglückselige
sicher	ADJD	1	sicher
innigern	ADJA	1	innigern
fortgehen	VVINF	1	fortgehen
Entsetzen	NN	1	Entsetzen
Freistatt	NN	1	Freistatt
Posse	NN	1	Possen
mäßig	ADJA	1	mäßigen
sterben	VVFIN	1	stirbt
unbegreiflich	ADJD	1	unbegreiflich
hundert	CARD	1	hundert
Mütterchen	NN	1	Mütterchen
Neue	NN	1	Neues
Einbildungskraft	NN	1	Einbildungskraft
erstemal	ADV	1	erstemal
Jünglingskopf	NN	1	Jünglingskopf
billig	ADJD	1	billiger
Scham	NN	1	Scham
wegkommen	VVINF	1	wegkommen
niedergeschlagen	ADJD	1	niedergeschlagen
Winkel	NN	1	Winkel
gelassen	ADJD	1	gelassen
Wolf	NN	1	Wolf
Alp	NN	1	Alpen
behäglicher	ADJD	1	behäglicher
Frage	NN	1	Frage
Liebreiz	NN	1	Liebreiz
Warest	VVFIN	1	Warest
teilet	VVFIN	1	teilet
betreiben	VVINF	1	betreiben
Hofschranze	NN	1	Hofschranze
Eimer	NN	1	Eimer
Mitschuldige	NN	1	Mitschuldigen
Bedinge	NN	1	Bedinge
widerstrebend	ADJA	1	widerstrebende
Ausführung	NN	1	Ausführung
erwähnen	VVFIN	1	erwähnte
entreißen	VVPP	1	entrissen
zucken	VVFIN	1	zucken
schicklich	ADJD	1	schicklich
klingen	VVFIN	1	klingt
Schubsäcke	NN	1	Schubsäcke
wahrscheinlich	ADJD	1	Wahrscheinlich
verziehest	ADJD	1	verziehest
gerächet	VVPP	1	gerächet
verzögern	VVINF	1	verzögern
abziehen	VVPP	1	abgezogen
begünstiget	VVFIN	1	begünstiget
Ihrigen	NN	1	Ihrigen
zudenken	VVPP	1	zugedacht
Bequemlichkeit	NN	1	Bequemlichkeit
sahe	VVFIN	1	sahe
unversöhnlich	ADJD	1	unversöhnlich
gemächlich	ADJD	1	gemächlich
zubringen	VVFIN	1	zubrächte
ausgefodert	VVPP	1	ausgefodert
umbringen	VVPP	1	umgebracht
unschätzbar	ADJA	1	unschätzbare
Abscheuligkeit	NN	1	Abscheuligkeit
lauter	PIAT	1	Lauter
einen	ADJA	1	Einen
Gesandte	NN	1	Gesandte
gefährlich	ADJA	1	gefährliches
werfend	ADJD	1	werfend
herkommen	VVINF	1	herkommen
Landgute	NN	1	Landgute
Gesinnung	NN	1	Gesinnungen
gestrengen	ADJA	1	gestrengen
Mantel	NN	1	Mantel
erreichen	VVINF	1	erreichen
verweigern	VVPP	1	verweigert
galant	ADJD	1	galant
Nichtswürdiger	NN	1	Nichtswürdiger
angeben	VVPP	1	angegeben
Ahnung	NN	1	Ahnungen
treu	ADJD	1	Treu
herrschet	VVFIN	1	herrschet
gebüßet	VVPP	1	gebüßet
Strafe	NN	1	Strafe
Aufheben	NN	1	Aufhebens
Große	NN	1	Großen
zaudern	VVFIN	1	zauderten
leugnen	VVFIN	1	leugne
künftig	ADJA	1	künftige
entschuldigen	VVFIN	1	entschuldigen
Equipage	NN	1	Equipage
Anschlag	NN	1	Anschlag
Gegend	NN	1	Gegend
angenehm	ADJA	1	angenehmste
Abgrund	NN	1	Abgrund
Trauung	NN	1	Trauung
abwenden	VVINF	1	abwenden
Gemach	NN	1	Gemache
lächeln	VVFIN	1	lächelt
Sicherheit	NN	1	Sicherheit
sperren	VVPP	1	gesperrt
verpfuschen	VVINF	1	verpfuschen
hinauf	ADV	1	hinauf
Ungeduld	NN	1	Ungeduld
Geburt	NN	1	Geburt
Wand	NN	1	Wand
Fehltritt	NN	1	Fehltritt
fortgeeilet	VVFIN	1	fortgeeilet
ausfragen	VVPP	1	ausgefragt
Gegenteil	NN	1	Gegenteil
zuträglich	ADJD	1	zuträglich
mitten	ADV	1	mitten
Spott	NN	1	Spott
umwandte	VVFIN	1	umwandte
Mache	NN	1	Mache
Stund	NN	1	Stund
Schild	NN	1	Schilde
verweben	VVPP	1	verwebt
Knie	NE	1	Knie
fehlgeschlagen	ADJA	1	fehlgeschlagene
Bad	NE	1	Bad
Papier	NN	1	Papieren
bewundernswürdigern	NN	1	bewundernswürdigern
bewundernswürdigere	ADJA	1	bewundernswürdigere
Beziehung	NN	1	Beziehung
abbrechen	VVFIN	1	abbreche
Brautschmucke	NN	1	Brautschmucke
anfangen	VVINF	1	anfangen
schwach	ADJD	1	schwach
Strenge	NN	1	Strenge
Wein|Weinen	NN	1	Weinen
Dacht	NN	1	Dacht
ausführen	VVINF	1	ausführen
Bedeutung	NN	1	Bedeutung
Wirtschaftshäusern	NN	1	Wirtschaftshäusern
beschimpfen	VVINF	1	beschimpfen
ertappen	VVINF	1	ertappen
schreiben	VVFIN	1	schreibe
reimen	VVFIN	1	reime
fangen	VVFIN	1	fing
Schlimmers	NN	1	Schlimmers
Ruf	NN	1	Rufe
beschämen	VVPP	1	beschämt
Untätigkeit	NN	1	Untätigkeit
Philosophin	NN	1	Philosophin
ausruhen	VVIZU	1	auszuruhen
Lasterhafte	NN	1	Lasterhaften
bestechen	VVPP	1	bestochen
ungewöhnlich	ADJD	1	ungewöhnlich
Hinterhalt	NN	1	Hinterhalt
Geschenk	NN	1	Geschenke
Schall	NN	1	Schall
Genie	NN	1	Genie
Verwundete	NN	1	Verwundeten
brav	ADJA	1	braver
Behäglicher	NN	1	Behäglicher
Brust	NN	1	Brust
erschöpfen	VVFIN	1	erschöpft
Wendung	NN	1	Wendung
ungemein	ADJD	1	ungemein
Stoß	NN	1	Stoß
Ehrerbietung	NN	1	Ehrerbietung
zuschreiet	VVFIN	1	zuschreiet
Vertraute	NN	1	Vertrauter
Gnüge	NN	1	Gnüge
Schweig	NN	1	Schweig
unterschriebnen	ADJA	1	unterschriebnen
beliebet	VVFIN	1	beliebet
mehres	NN	1	mehres
belieben	VVFIN	1	beliebt
verändern	VVFIN	1	verändert
aufgehobner	VVPP	1	aufgehobner
Schuld	NN	1	Schulden
stehlen	VVPP	1	gestohlen
fest	ADJD	1	fest
Spötter	NN	1	Spötter
Hälfte	NN	1	Hälfte
Vorurteil	NN	1	Vorurteil
Erlaubnis	NN	1	Erlaubnis
zurückgekehret	VVFIN	1	zurückgekehret
Vorreiter	NN	1	Vorreiter
Sterben	NN	1	Sterben
angefallen	VVINF	1	angefallen
aufzufodern	VVIZU	1	aufzufodern
unbedingtern	ADJD	1	unbedingtern
Erfrischung	NN	1	Erfrischung
kurzsichtig	ADJA	1	Kurzsichtiger
eilet	VVFIN	1	eilet
Ideal	NN	1	Ideal
wenden	VVFIN	1	wenden
abweisen	VVINF	1	abweisen
geirret	ADJD	1	geirret
unverzeihlich	ADJA	1	unverzeihliches
Schande	NN	1	Schande
Gequicke	NN	1	Gequicke
Schlag	NN	1	Schlage
weichen	VVINF	1	weichen
ereifern	VVINF	1	ereifern
ohnfern	ADJD	1	ohnfern
Garten	NN	1	Gartens
Nutz	NN	1	Nutze
Handwerk	NN	1	Handwerk
dieselb	PDAT	1	derselben
schlagend	ADJD	1	schlagend
trocknen	VVFIN	1	trocknen
überschwenglich	ADJD	1	überschwenglich
gewinnen	VVFIN	1	gewinnt
billigen	VVINF	1	billigen
unbereitet	ADJD	1	unbereitet
ists	NN	1	ists
stampfen	VVFIN	1	stampft
Spiegel	NN	1	Spiegel
einstecken	VVINF	1	einstecken
beunruhigen	VVINF	1	beunruhigen
Wink	NN	1	Wink
Emilie	NE	1	Emilie
Wind	NN	1	Wind
Wüterich	NN	1	Wüterich
Stolz	NN	1	Stolz
Herzog	NN	1	Herzog
alsdann	ADJD	1	alsdann
Tröster	NN	1	Tröster
Einfalle	NN	1	Einfalle
Anstand	NN	1	Anstand
Schnickschnack	NN	1	Schnickschnack
mehrern	NN	1	mehrern
zeihen	VVFIN	1	Zieh
binden	VVPP	1	gebunden
Bubenstück	NN	1	Bubenstück
gründen	VVINF	1	gründen
Degen	NN	1	Degen
aufhängen	VVINF	1	aufhängen
Geräusch	NN	1	Geräusch
biegen	VVFIN	1	biegt
aha	ITJ	1	Aha
Allerheiligen	NN	1	Allerheiligen
allmächtig	ADJA	1	Allmächtige
Kutsche	NN	1	Kutsche
günstig	ADJA	1	günstigen
Geschichte	NN	1	Geschichte
begehrt	ADJD	1	begehrt
Beben	NN	1	Beben
vogelfrei	ADJD	1	vogelfrei
Verdammnis	NN	1	Verdammnis
verscherzende	ADJA	1	verscherzende
zusagen	VVINF	1	zusagen
Freiwillige	NN	1	Freiwilliger
Vasall	NN	1	Vasall
tugendhaft	ADJD	1	tugendhaft
mitbringen	VVPP	1	mitgebracht
Besorgest	VVFIN	1	Besorgest
Vorgemache	NN	1	Vorgemache
Beschützer	NN	1	Beschützer
beschwerlich	ADJA	1	beschwerliche
aufnehmen	VVINF	1	aufnehmen
gemach	ADV	1	gemach
Genuss	NN	1	Genuß
dritt	ADJA	1	dritte
dringend	ADJA	1	dringendes
verdamm	VVFIN	1	verdamm
erscheinen	VVINF	1	erscheinen
Bißchen	NN	1	Bißchen
Freundin	NN	1	Freundin
Spießgeselle	NN	1	Spießgeselle
erholet	VVPP	1	erholet
Verstellung	NN	1	Verstellung
Versuch	NN	1	Versuch
Erstaunen	NN	1	Erstaunen
Eifersucht	NN	1	Eifersucht
gehöret	VVFIN	1	gehöret
jedermann	PIS	1	Jedermann
fürchtend	ADJA	1	fürchtende
einreden	VVIZU	1	einzureden
trennet	VVFIN	1	trennet
ekeln	VVIMP	1	ekel
verdächtig	ADJD	1	verdächtig
Bett	NN	1	Bette
lächelnd	ADJD	1	Lächelnd
buchstabieren	VVFIN	1	buchstabieren
deswegen	PAV	1	deswegen
Bedenklichkeit	NN	1	Bedenklichkeiten
Ansatz	NN	1	Ansatz
stünd	VVFIN	1	stünd
verliebt	ADJA	1	verliebte
plastisch	ADJA	1	plastische
fortreißen	VVINF	1	fortreißen
Anstande	NN	1	Anstande
entzücken	VVFIN	1	entzückt
wählen	VVFIN	1	wählt
ansehen	VVINF	1	ansehen
einzumengen	ADJA	1	einzumengen
Grausamkeit	NN	1	Grausamkeit
nennest	VVFIN	1	nennest
veranlassen	VVPP	1	veranlaßt
Wahl	NN	1	Wahl
aufsetzen	VVINF	1	aufsetzen
Dürftigkeit	NN	1	Dürftigkeit
wohlfeiler	NN	1	wohlfeiler
Aufwallung	NN	1	Aufwallung
Vermögen	NN	1	Vermögen
belachen	VVINF	1	belachen
gescheuter	ADJA	1	gescheuter
trotz	APPR	1	trotz
Form	NN	1	Form
verschwendrischen	ADJA	1	verschwendrischen
Berg	NN	1	Berge
loszuwinden	VVIZU	1	loszuwinden
Fleiß	NN	1	Fleiß
höhnisch	ADJA	1	höhnische
handfest	ADJA	1	handfesten
ausstechen	VVIZU	1	auszustechen
voraussehen	VVPP	1	vorausgesehen
bange	ADJA	1	bangen
verbergen	VVINF	1	verbergen
funfziger	VVFIN	1	funfziger
zurücktun	VVINF	1	zurücktun
Preis	NN	1	Preis
beigeschrieben	ADJD	1	beigeschrieben
stören	VVINF	1	stören
Hohngelächter	NN	1	Hohngelächter
zerfleischen	VVFIN	1	zerfleischten
abreiset	VVFIN	1	abreiset
gesollt	ADJD	1	gesollt
Retter	NN	1	Retter
bezeiget	VVFIN	1	bezeiget
vermeiden	VVINF	1	vermeiden
leuchten	VVFIN	1	leuchtet
Zurückhaltung	NN	1	Zurückhaltung
denkend	ADJA	1	denkende
gefoltertes	ADJA	1	gefoltertes
Feld	NN	1	Feld
würdigen	VVFIN	1	würdigen
behalt	VVFIN	1	behalt
Unverschämter	NN	1	Unverschämter
Lied	NN	1	Liede
Unterwerfung	NN	1	Unterwerfung
verkümmern	VVPP	1	verkümmert
Belang	NN	1	Belang
Höhle	NN	1	Höhle
Tröstliche	NN	1	Tröstliches
grob	ADJA	1	gröbsten
Bettler	NN	1	Bettler
Galanterie	NN	1	Galanterie
unaussprechlich	ADJD	1	unaussprechlich
Gesellschaft	NN	1	Gesellschaft
ungern	ADV	1	ungern
ärgern	VVFIN	1	ärgert
Nachmittags	NN	1	Nachmittags
verursachen	VVPP	1	verursacht
Kitzel	NN	1	Kitzels
Begleitung	NN	1	Begleitung
beibringen	VVIZU	1	beizubringen
denket	ADJD	1	denket
Jenes	NN	1	Jenes
Larve	NN	1	Larve
bescheiden	VVFIN	1	beschied
entbehren	VVINF	1	entbehren
erneuern	VVINF	1	erneuern
machend	ADJD	1	machend
Geck	NN	1	Geck
sprachlos	ADJA	1	sprachlose
gebieten	VVFIN	1	gebietet
Buch	NN	1	Büchern
Handgemenge	NN	1	Handgemenges
Deutsche	NN	1	Deutsche
herkömmt	VVFIN	1	herkömmt
abmüßigen	ADJA	1	abmüßigen
erweisen	VVPP	1	erwiesen
Abfall	NN	1	Abfall
Schäfchen	NN	1	Schäfchen
irre	PTKVZ	1	irre
Mißbündnis	NN	1	Mißbündnis
Geständnis	NN	1	Geständnisse
trösten	VVFIN	1	tröstet
spielen	VVINF	1	spielen
drücken	VVINF	1	drücken
kosen|kosten	VVFIN	1	kosten
spielet	VVFIN	1	spielet
eh	ADV	1	eh
aufhalten	VVINF	1	aufhalten
bekömmt	VVFIN	1	bekömmt
Flut|Fluten	NN	1	Fluten
deutlich	ADJD	1	deutlicher
Beteurung	NN	1	Beteurung
Vorsatze	NN	1	Vorsatze
Nacht	NN	1	Nacht
Gestirn	NN	1	Gestirn
unanständig	ADJD	1	unanständig
Murmeltier	NN	1	Murmeltiere
Wesen	NN	1	Wesen
Üble	NN	1	Übles
vorhersehen	VVINF	1	vorhersehen
Plauderei	NN	1	Plauderei
Stadterziehung	NN	1	Stadterziehung
herzu	ADV	1	herzu
nachher	ADV	1	Nachher
Gemse	NN	1	Gemsen
Ansehen	NN	1	Ansehen
aufdringend	ADJD	1	aufdringend
erfragen	VVINF	1	erfragen
Pistole	NN	1	Pistolen
Erinnerung	NN	1	Erinnerung
umsehen	VVIZU	1	umzusehen
liefern	VVFIN	1	liefere
beiher	NN	1	beiher
feige	ADJA	1	feiger
durchwühlen	VVFIN	1	durchwühlten
Ausfertigung	NN	1	Ausfertigung
Hofmännchen	NN	1	Hofmännchen
anreden	VVIZU	1	anzureden
Rücksicht	NN	1	Rücksicht
Topp	NN	1	Topp
währen	VVFIN	1	währte
geseufzet	VVPP	1	geseufzet
Atem	NN	1	Atem
aufheben	VVFIN	1	aufhebt
bitt	VVFIN	1	bitt
ähnlich	ADJD	1	ähnlich
anvertrauet	VVFIN	1	anvertrauet
Beßres	NN	1	Beßres
Beßrer	ADJA	1	Beßrer
braun	ADJA	1	braunen
gereiniget	VVFIN	1	gereiniget
Kurz	NE	1	Kurz
Nachstellung	NN	1	Nachstellungen
herumgehen	VVPP	1	herumgegangen
bauen	VVFIN	1	baute
Schilderei	NN	1	Schilderei
weisend	ADJD	1	weisend
Leichnam	NN	1	Leichname
glaublich	ADJD	1	glaublich
Hohn	NN	1	Hohn
Fliehen	NN	1	Fliehen
Schlinge	NN	1	Schlinge
Kabinett	NN	1	Kabinett
leiden	VVINF	1	leiden
ersticken	VVPP	1	erstickt
Glied	NN	1	Gliede
Sünder	NN	1	Sünder
untertänig	ADJD	1	untertänigst
auffodern	VVINF	1	auffodern
Bangigkeit	NN	1	Bangigkeit
Schmuck	NN	1	Schmuck
allertraurig	ADJA	1	allertraurigsten
höllisch	ADJA	1	höllischen
Kenn	VVFIN	1	Kenn
Bube	NN	1	Buben
Erhalten	NN	1	Erhalten
führet	VVFIN	1	führet
verbeißen	VVFIN	1	verbeißt
Fessel|Fesseln	NN	1	Fesseln
Trennung	NN	1	Trennung
schmerzen	VVINF	1	schmerzen
Glückliche	NN	1	Glückliche
Studio	NN	1	Studio
hinterlassen	VVINF	1	hinterlassen
versammeln	VVPP	1	versammelt
schreiet	VVFIN	1	schreiet
verdienest	ADJD	1	verdienest
Villa	NN	1	Villa
Allee	NN	1	Allee
besorgest	VVFIN	1	besorgest
Furchtsamste	NN	1	Furchtsamste
erkundiget	VVFIN	1	erkundiget
wütend	ADJD	1	wütend
Allerreinesten	NN	1	Allerreinesten
erschießen	VVPP	1	erschossen
Qual	NN	1	Qual
Stillschweigen	NN	1	Stillschweigen
entstellen	VVINF	1	entstellen
mitdenken	VVINF	1	mitdenken
Augendiener	NN	1	Augendiener
Rahmen	NN	1	Rahmen
Boden	NN	1	Boden
Angefallenen	NN	1	Angefallenen
Hitze	NN	1	Hitze
angenommen	ADJA	1	angenommenen
Anspruch	NN	1	Ansprüchen
versichert	ADJA	1	versicherten
Wonne	NN	1	Wonne
Glücke	NN	1	Glücke
darin	PAV	1	darin
Vorsprecherin	NN	1	Vorsprecherin
versäumen	VVPP	1	versäumt
Zwang	NN	1	Zwang
Kirch	NE	1	Kirch
verwünschen	VVPP	1	Verwünscht
gegründetste	ADJA	1	gegründetste
genung	NN	1	genung
Jahr	NN	1	Jahre
Güte	NN	1	Güte
gedulden	VVFIN	1	Gedulden
Stoff	NN	1	Stoff
Grimasse	NN	1	Grimasse
gleichviel	ADV	1	Gleichviel
befriedigen	VVINF	1	befriedigen
behüten	VVFIN	1	behüte
Stich	NN	1	Stiche
genugsam	ADV	1	genugsam
entgehest	VVFIN	1	entgehest
Aufschub	NN	1	Aufschub
Verbeugung	NN	1	Verbeugung
vergälle	VVFIN	1	vergälle
dergleichen	PIS	1	dergleichen
angetrauet	NN	1	angetrauet
Inbrunst	NN	1	Inbrunst
hereinstürztest	VVFIN	1	hereinstürztest
Verweis	NN	1	Verweis
räubern	VVIMP	1	Räuber
Rächer	NN	1	Rächer
gemalet	VVPP	1	gemalet
herausziehend	VVFIN	1	herausziehend
Plane	NN	1	Plane
Wunde	NN	1	Wunde
schimpfliche	ADJA	1	schimpfliche
Tempel	NN	1	Tempel
Possenspiel	NN	1	Possenspiel
haltend	ADJD	1	haltend
Staatsinteresse	NN	1	Staatsinteresse
Erwägen	NN	1	Erwägen
Empfindsame	NN	1	Empfindsamen
ernennen	VVINF	1	ernennen
entschlossen	ADJA	1	entschlossenen
Unzufriedenheit	NN	1	Unzufriedenheit
berichten	VVINF	1	berichten
Ankunft	NN	1	Ankunft
Schlich	NN	1	Schliche
Murrkopf	NN	1	Murrkopf
entfernt	ADJD	1	entfernt
Abend	NN	1	Abend
aussehen	VVFIN	1	aussehe
Wallung	NN	1	Wallung
Unfern	NN	1	Unfern
absehen	VVFIN	1	absehe
kämpfet	VVFIN	1	kämpfet
Gattung	NN	1	Gattung
Bevollmächtigte	NN	1	Bevollmächtigten
erkenntlich	ADJD	1	erkenntlich
Gebäude	NN	1	Gebäudes
Locke|Locken	NN	1	Locken
Mitwirkung	NN	1	Mitwirkung
geschickt	ADJD	1	geschickt
schonen	VVFIN	1	schonte
gestrenge	ADJA	1	gestrenge
kriechen	VVFIN	1	kriechen
verdammen	VVPP	1	verdammt
ohnmächtig	ADJD	1	ohnmächtig
tödlichsten	ADJD	1	tödlichsten
zweitesmal	ADV	1	zweitesmal
Gotteslästerung	NN	1	Gotteslästerung
fühlend	ADJD	1	fühlend
hieher	NN	1	hieher
anständig	ADJA	1	anständige
bemühen	VVINF	1	bemühen
Sorge|Sorgen	NN	1	Sorgen
Verhör	NN	1	Verhörs
zurückkehren	VVINF	1	zurückkehren
allgütig	ADJA	1	allgütige
Kommando	NN	1	Kommando
Rock	NN	1	Rock
größern	VVINF	1	größern
feil	ADJD	1	feil
Überlästigen	NN	1	Überlästigen
nachplauderndes	ADJA	1	nachplauderndes
Überraschung	NN	1	Überraschung
einlassen	VVINF	1	einlassen
Meinung	NN	1	Meinung
erwachen	VVFIN	1	erwache
empfinden	VVINF	1	empfinden
bergen	VVPP	1	geborgen
fodert	VVFIN	1	fodert
Stirn	NN	1	Stirn
fodere	VVFIN	1	fodere
fodern	NN	1	fodern
hochöchst	ADJD	1	höchst
Kleine	NN	1	Kleines
mütterlich	ADJA	1	mütterlichen
Übung	NN	1	Übungen
unerhört	ADJD	1	unerhört
Gewissheit	NN	1	Gewißheit
Geifer	NN	1	Geifer
Tropfen	NN	1	Tropfen
Sättigung	NN	1	Sättigung
Dahinaus	ADV	1	Dahinaus
gäb	VVFIN	1	gäb
Camillo	NE	1	Camillo
Wissen	NN	1	Wissen
erkauft	ADJA	1	erkaufte
schäumet	VVFIN	1	schäumet
worauf	PWAV	1	worauf
Spiel	NN	1	Spiel
Bekannte	NN	1	Bekannter
genötiget	ADJA	1	genötiget
sodann	ADV	1	sodann
unzufrieden	ADJD	1	unzufrieden
zitternd	ADJD	1	zitternd
Exempel	NN	1	Exempel
wett	PTKVZ	1	wett
Knabe	NN	1	Knabe
Bewilligung	NN	1	Bewilligung
Tote	NN	1	Toten
Mitlachen	NN	1	Mitlachen
Stille	NN	1	Stille
gestehen|stehen	VVPP	1	gestanden
Wornach	ADV	1	Wornach
te	ADJD	1	te
unschlüssig	ADJD	1	unschlüssig
Zustand	NN	1	Zustande
Wär	ADJD	1	Wär
Löwin	NN	1	Löwin
antragen	VVIZU	1	anzutragen
breit	ADJA	1	breites
übel	ADJD	1	übel
Halunke	NN	1	Halunke
Verzeihen	NN	1	Verzeihen
jammern	VVFIN	1	jammert
gewahr	ADJD	1	gewahr
Rest	NN	1	Rest
gebärden	VVFIN	1	gebärdete
einfältig	ADJD	1	einfältig
Fodre	NN	1	Fodre
Verderb	NN	1	Verderb
schwanger	ADJD	1	schwanger
unterstehen	VVFIN	1	untersteht
Verlassene	NN	1	Verlassenen
ausweichen	VVINF	1	ausweichen
Anklage	NN	1	Anklage
zweimal	ADV	1	zweimal
verleumden	VVFIN	1	verleumde
verzweifelt	ADJD	1	verzweifelt
Kopie	NN	1	Kopie
Gutherziges	ADJA	1	Gutherziges
plündern	VVINF	1	plündern
Barmherzigkeit	NN	1	Barmherzigkeit
Verdienst	NN	1	Verdienst
Wozu	ADV	1	Wozu
Lache|Lachen	NN	1	Lachen
Aug	NE	1	Aug
raffen	VVFIN	1	rafft
verfügen	VVINF	1	verfügen
rächen	VVFIN	1	rächte
Absehn	NN	1	Absehn
streiten	VVFIN	1	stritte
wehmütig	ADJD	1	Wehmütig
kühn	ADJD	1	kühn
Widerspruch	NN	1	Widerspruch
ruhmredig	ADJD	1	ruhmredig
reizen	VVFIN	1	Reizt
edel	ADJD	1	edel
klagen	VVFIN	1	klagte
kümmern	VVFIN	1	kümmert
herunter	ADV	1	Herunter
Ewige	NN	1	Ewigen
Bitter	NN	1	Bitter
drohen	VVFIN	1	drohte
nachmachen	VVINF	1	nachmachen
rasend	ADJD	1	rasend
geraubet	VVFIN	1	geraubet
mischen	VVINF	1	mischen
Landstraße	NN	1	Landstraße
brausender	ADJA	1	brausender
mitleidig	ADJA	1	mitleidiges
Zauberin	NN	1	Zauberin
Ernste	NN	1	Ernste
dreimal	ADV	1	dreimal
Hofgeschmeiß	NN	1	Hofgeschmeiß
hervorziehend	ADJD	1	hervorziehend
Ekel	NN	1	Ekel
unbesorgt	ADJD	1	unbesorgt
entsprechen	VVFIN	1	entspricht
kräftig	ADJA	1	kräftigste
übergeben	VVINF	1	übergeben
Leise	NN	1	Leise
Neidhart	NE	1	Neidhart
Bau	NN	1	Bau
Unfalle	NN	1	Unfalle
Sträuben	NN	1	Sträuben
schönres	NN	1	schönres
gebären	VVPP	1	geboren
ausstrecken	VVFIN	1	ausstreckt
ehegestern	ADJD	1	ehegestern
rechtschaffner	ADJA	1	rechtschaffner
tausend	CARD	1	tausend
samt	APPR	1	samt
Mut	NN	1	Mut
voreilig	ADJD	1	voreilig
Bacchantinnen	NN	1	Bacchantinnen
begeben	VVFIN	1	begibt
ausdehnen	VVINF	1	ausdehnen
stillen	VVFIN	1	stille
heiter	ADJD	1	heiter
genennet	NE	1	genennet
treulos	ADJD	1	treulos
Schlimmere	NN	1	Schlimmeres
Anzüglichsten	NN	1	Anzüglichsten
Leiden	NN	1	Leiden
Leides	NN	1	Leides
winseln	VVFIN	1	winselt
hoffentlich	ADV	1	hoffentlich
ersparen	VVFIN	1	erspare
zuvorkommen	VVINF	1	zuvorkommen
Muster	NN	1	Muster
Verführer	NN	1	Verführer
ausgehen	VVINF	1	ausgehen
lachend	ADJD	1	lachend
verstellen	VVINF	1	verstellen
hassen	VVFIN	1	haßt
Henker	NN	1	Henker
zuflüstern	VVINF	1	zuflüstern
anwenden	VVFIN	1	anwende
findend	ADJD	1	findend
freudigern	ADJA	1	freudigern
Arkade	NN	1	Arkade
verfehlen	VVINF	1	verfehlen
Begriff	NN	1	Begriffe
Raub	NN	1	Raub
Schwiegermutter	NN	1	Schwiegermutter
sehnen	VVIMP	1	sehn
Harnisch	NN	1	Harnisch
bestellet	VVFIN	1	bestellet
passen	VVFIN	1	Passen
Straße	NN	1	Straße
Tisch	NN	1	Tische
überall	ADV	1	überall
alleranständigste	ADJA	1	alleranständigste
Vergebung	NN	1	Vergebung
Schranke	NN	1	Schranken
Tolldreiste	NN	1	Tolldreiste
Galle	NN	1	Galle
trügen	VVINF	1	trügen
mangeln	VVPP	1	gemangelt
schweifen	VVFIN	1	schweift
angehören|anhören	VVPP	1	angehört
gerühret	VVFIN	1	gerühret
Erfahrung	NN	1	Erfahrung
Hexerei	NN	1	Hexerei
Vorwande	NN	1	Vorwande
überlassen	VVINF	1	überlassen
Vorsichtigkeit	NN	1	Vorsichtigkeit
Zeiger	NN	1	Zeiger
Frömmigkeit	NN	1	Frömmigkeit
Verbrecher	NN	1	Verbrecher
Träne	NN	1	Träne
Gehör	NN	1	Gehöre
Schubsacke	NN	1	Schubsacke
aufgestellet	VVPP	1	aufgestellet
zerreißen	VVPP	1	zerrissen
Marinellis	NN	1	Marinellis
trüb	ADJA	1	trübe
reuen	VVINF	1	reuen
Erfolg	NN	1	Erfolg
genießen	VVFIN	1	genießt
getrost	ADV	1	getrost
heften	VVPP	1	geheftet
glühet	VVFIN	1	glühet
Zirkel	NN	1	Zirkel
Händel	NN	1	Händel
Großmut	NN	1	Großmut
Entzückungen	NN	1	Entzückungen
finster	ADJD	1	finster
Nachteilige	NN	1	Nachteiliges
Unwahrheit	NN	1	Unwahrheit
furchtsam	ADJA	1	furchtsames
haften	VVFIN	1	haften
Notwendigkeit	NN	1	Notwendigkeit
Waage	NN	1	Waage
Entschlossenste	NN	1	Entschlossenste
aussetzen	VVIZU	1	auszusetzen
Knall	NN	1	Knall
Gehorsam	NN	1	Gehorsam
Spaziergange	NN	1	Spaziergange
überreden	VVINF	1	überreden
Beobachtung	NN	1	Beobachtung
Furie	NN	1	Furien
arg	ADJD	1	arg
zwingend	ADJD	1	zwingend
Anschlage	NN	1	Anschlage
Vorrede	NN	1	Vorrede
Auftrag	NN	1	Auftrag
Ausspruch	NN	1	Ausspruch
aufschlagen	VVFIN	1	aufschlägt
ausgelassen	ADJD	1	ausgelassen
Unmögliche	NN	1	Unmögliche
Kinn	NN	1	Kinn
Gaukelspieles	NN	1	Gaukelspieles
Bedingung	NN	1	Bedingung
verschenken	VVINF	1	verschenken
gewähren|währen	VVPP	1	Gewährt
zurückführet	VVFIN	1	zurückführet
drängen	VVINF	1	drängen
warest	ADJD	1	warest
Eifersüchtige	NN	1	Eifersüchtigen
vorlassen	VVINF	1	vorlassen
Urheberin	NN	1	Urheberin
vergehen	VVPP	1	vergangen
bürgen	VVINF	1	bürgen
umher	PTKVZ	1	umher
überheben	VVPP	1	überhoben
Plan	NN	1	Plan
Zusammenkunft	NN	1	Zusammenkunft
erhaben	ADJD	1	erhaben
Verschweigen	NN	1	Verschweigen
Quittung	NN	1	Quittung
Antworts	NN	1	Antworts
Schlimmste	NN	1	Schlimmste
bild	VVFIN	1	bild
Verdammt	NN	1	Verdammt
Verlangen	NN	1	Verlangen
statten	VVINF	1	statten
beleidigen	VVINF	1	beleidigen
gewöhnlich	ADJD	1	gewöhnlich
Heirat	NN	1	Heirat
Oberst|Oberste	NN	1	Obersten
Sklave	NN	1	Sklave
sehend	ADJD	1	sehend
sichtbar	ADJA	1	sichtbarer
jungüngst	ADJD	1	jüngst
ungerecht	ADJD	1	ungerecht
Stock	NN	1	Stock
Vorbeigehende	NN	1	Vorbeigehenden
untergraben	VVFIN	1	untergrub
verhasst	ADJD	1	verhaßt
Strafbare	NN	1	Strafbares
fliegend	ADJD	1	fliegend
Raphael	NE	1	Raphael
umsehend	VVFIN	1	umsehend
Liebhaberin	NN	1	Liebhaberin
flehen	VVINF	1	flehen
erflehen	VVINF	1	erflehen
beschäftigen	VVFIN	1	beschäftigt
eilend	ADJD	1	eilend
Zufalle	NN	1	Zufalle
Missfallen	NN	1	Mißfallen
unangemeldet	ADJD	1	unangemeldet
Fährte	NN	1	Fährte
Prunke	NN	1	Prunke
zerpflücken	VVPP	1	zerpflückt
bieder	ADJD	1	bieder
verhüten	VVINF	1	verhüten
Alte	NN	1	Alte
steif	ADJD	1	steif
Überbringer	NN	1	Überbringer
willkommen	ADJD	1	willkommen
Erbe	NN	1	Erbe
weiß	ADJD	1	weiß
beschwören	VVFIN	1	beschwor
männlich	ADJA	1	männlichen
Bravo	NN	1	Bravo
Wahrlich	ADJD	1	Wahrlich
Vierteil	NN	1	Vierteil
Bosheit	NN	1	Bosheit
Kutscher	NN	1	Kutscher
Wiedersehen	NN	1	Wiedersehen
offenbar	ADJD	1	offenbar
verstatten	VVINF	1	verstatten
Antlitz	NN	1	Antlitz
acht	CARD	1	acht
Verziehung	NN	1	Verziehung
Treppe	NN	1	Treppe
Langeweile	NN	1	Langeweile
prediget	VVFIN	1	prediget
gerichtlich	ADJA	1	gerichtlichen
ausdrücklich	ADJD	1	ausdrücklich
schwatzen	VVINF	1	schwatzen
abrichten	VVIZU	1	abzurichten
Spazierritt	NN	1	Spazierritt
Entzücken	NN	1	Entzücken
meinetwegen	ADV	1	Meinetwegen
allzudienstfertiger	ADJA	1	allzudienstfertiger
irrig	ADJD	1	irrig
Seinige	NN	1	Seinige
leise	ADJD	1	Leise
Sieger	NN	1	Sieger
betrogen	ADJA	1	betrogene
Verlust	NN	1	Verlust
Piemont	NE	1	Piemont
toben	VVFIN	1	tobe
Zeremoniell	NN	1	Zeremoniell
Betragen	NN	1	Betragen
wischend	ADJD	1	wischend
Frauenzimmer	NN	1	Frauenzimmer
Mitschuldiger	NN	1	Mitschuldiger
Beobachter	NN	1	Beobachter
murmeln	VVFIN	1	murmeln
Verlegenheit	NN	1	Verlegenheit
Pfeil	NN	1	Pfeil
freiwillig	ADJD	1	freiwillig
Tu	NE	1	Tu
Begleiter	NN	1	Begleiter
Einsicht	NN	1	Einsichten
einkömmt	VVFIN	1	einkömmt
Abschaum	NN	1	Abschaum
Unschuldigste	NN	1	Unschuldigste
Schurke	NN	1	Schurke
nachdringen	VVINF	1	nachdringen
dringen	VVFIN	1	Dringen
Bursche	NN	1	Bursche
vorwärts	ADV	1	Vorwärts
auffallen	VVFIN	1	auffällt
Seligkeit	NN	1	Seligkeit
nass	ADJA	1	nassen
ausrufen	VVINF	1	ausrufen
strafbar	ADJD	1	strafbar
Gewogenheit	NN	1	Gewogenheit
unverzüglich	ADJD	1	unverzüglich
Bedeuten	NN	1	Bedeuten
Perle	NN	1	Perle
umwenden	VVFIN	1	umwendet
dagegen	PAV	1	dagegen
sonach	ADV	1	sonach
Familie	NN	1	Familie
Not	NN	1	Not
hieran	PAV	1	hieran
Kundschafter	NN	1	Kundschafter
Stimme	NN	1	Stimme
entfahren	VVFIN	1	entfuhr
gemein	ADJA	1	gemeine
Markt	NN	1	Markte
beliebt	ADJD	1	beliebt
Leibwache	NN	1	Leibwache
Blitz	NN	1	Blitz
trägst	ADJD	1	trägst
Gebärde	NN	1	Gebärde
Begierd	NE	1	Begierd
vereinigen	VVINF	1	vereinigen
verblühen	VVINF	1	verblühen
gestehen	VVINF	1	gestehen
übermorgen	ADV	1	übermorgen
betaure	VVFIN	1	betaure
Wichtigere	NN	1	Wichtigeres
Vorsatz	NN	1	Vorsatz
Bedenken	NN	1	Bedenken
prahlen	VVFIN	1	prahlen
malerisch	ADJA	1	malerische
wechseln	VVPP	1	gewechselt
unvergleichlich	ADJD	1	Unvergleichlich
auslaufen	VVPP	1	ausgelaufen
ergeben	ADJA	1	ergebensten
übernehmen	VVFIN	1	übernahm
voritzo	VVFIN	1	voritzo
Pisa	NE	1	Pisa
Schnitzer	NN	1	Schnitzer
wenigste	PIS	1	wenigsten
widersprech	VVFIN	1	widersprech
entgehen	VVPP	1	entgangen
Wispern	NN	1	Wispern
erkläret	VVFIN	1	erkläret
Hui	NE	1	Hui
Land	NN	1	Lande
Nase	NN	1	Nase
denkest	ADJD	1	denkest
begreifen	VVINF	1	begreifen
wahnwitzig	ADJD	1	wahnwitzig
Grazie	NN	1	Grazie
Welle	NN	1	Wellen
plauderst	VVFIN	1	plauderst
empfehlen	VVINF	1	empfehlen
alltäglich	ADJA	1	alltägliche
gewärtig	ADJD	1	gewärtig
kenntest	VVFIN	1	kenntest
ausdenken	VVPP	1	ausgedacht
Aufenthalt	NN	1	Aufenthalt
Dasmal	NN	1	Dasmal
Gewissenhaften	NN	1	Gewissenhaften
rechtschaffnen	ADJA	1	rechtschaffnen
nachdenkend	ADJD	1	Nachdenkend
heiß	ADJA	1	heißesten
worin	PWAV	1	worin
Erfüllung	NN	1	Erfüllung
Folge	NN	1	Folgen
Vertraulichkeit	NN	1	Vertraulichkeit
Einwendung	NN	1	Einwendung
spöttisch	ADJD	1	spöttisch
getrauet	VVFIN	1	getrauet
befürchtend	ADJA	1	befürchtenden
gesund	ADJA	1	gesunder
Belohnung	NN	1	Belohnung
getrauen	VVIMP	1	getrau
ausrichten	VVFIN	1	ausrichtete
öftrer	VVINF	1	öftrer
senken	VVFIN	1	senkte
Zurücknehmen	NN	1	Zurücknehmen
warnen	VVFIN	1	Warnen
rennen	VVFIN	1	rennet
fröhlich	ADJD	1	fröhlich
Taubheit	NN	1	Taubheit
Fodert	VVIMP	1	Fodert
winken	VVFIN	1	winkt
Mitbewerber	NN	1	Mitbewerber
itzigen	ADJA	1	itzigen
trübsinnig	ADJA	1	trübsinniger
eifersüchtig	ADJA	1	eifersüchtigen
beginnen	VVFIN	1	begann
Hochzeittage	NN	1	Hochzeittage
betreten	VVINF	1	betreten
verhöhlen	VVINF	1	verhöhlen
Helfershelfer	NN	1	Helfershelfer
ausnehmen	VVPP	1	ausgenommen
Gewehr	NN	1	Gewehr
red	XY	1	red
Mal|Malen	NN	1	Malen
Galot	NN	1	Galot
tätig	ADJD	1	tätiger
zugehen	VVFIN	1	zugeht
verächtlich	ADJA	1	verächtlicher
bedungen	NN	1	bedungen
Knicker	NN	1	Knicker
wovor	PWAV	1	wovor
Führer	NN	1	Führer
herauf	PTKVZ	1	herauf
vergönne	VVFIN	1	vergönne
Zutun	NN	1	Zutun
Narr	NN	1	Narr
aufschieben	VVINF	1	aufschieben
gedenken	VVFIN	1	gedenke
aufgeben	VVFIN	1	aufgeben
gekränkt	ADJA	1	gekränkte
Spaß	NN	1	Spaß
Paar	NN	1	Paares
starr	ADJA	1	starren
wohlfeil	ADJD	1	wohlfeil
Verurteilung	NN	1	Verurteilung
verbinden	VVINF	1	verbinden
einsam	ADJA	1	einsamen
einbilden	VVFIN	1	einbilde
Unfall	NN	1	Unfall
immerdar	NE	1	immerdar
Pah	NE	1	Pah
Scherz	NN	1	Scherz
fußen	VVINF	1	fußen
Zuflucht	NN	1	Zuflucht
vorhin	ADV	1	vorhin
prächtig	ADJD	1	prächtiger
Lächeln	NN	1	Lächeln
übrig	ADJD	1	übrig
fliegen	VVFIN	1	fliege
Teuerste	NN	1	Teuerste
Mode	NN	1	Mode
Atemzug	NN	1	Atemzuge
verantworten	VVINF	1	verantworten
Kuss|Küssen	NN	1	Küssen
sträuben	VVINF	1	sträuben
erhören	VVPP	1	erhört
Schlaraffenleben	NN	1	Schlaraffenleben
erbrechen	VVPP	1	erbrochen
Werkzeug	NN	1	Werkzeug
vergreifen	VVFIN	1	vergriff
Sonne	NN	1	Sonne
einsprechen	VVINF	1	einsprechen
mannichfaltigen	ADJA	1	mannichfaltigen
entführen	VVPP	1	entführt
Gewalttätigkeit	NN	1	Gewalttätigkeit
gewürdiget	VVPP	1	gewürdiget
grau	ADJA	1	grauen
stimmen	VVPP	1	gestimmt
Schreckenbilder	NN	1	Schreckenbilder
gram	ADJD	1	gram
zeiget	VVFIN	1	zeiget
trauen	VVFIN	1	trauen
bessern	VVFIN	1	bessern
Donner	NN	1	Donner
spotten	VVFIN	1	spotten
jugendlich	ADJA	1	jugendliches
packen	VVFIN	1	Packen
auseinander	ADV	1	auseinander
Gefühl	NN	1	Gefühl
enthalten	VVFIN	1	enthielt
tapfer	ADJD	1	tapfer
gebotest	NN	1	gebotest
aushelfen	VVINF	1	aushelfen
Schwierigkeit	NN	1	Schwierigkeit
überlegen	VVFIN	1	überlegt
drohend	ADJD	1	Drohend
schal	ADJA	1	schale
hinbringen	VVINF	1	hinbringen
Lob	NN	1	Lob
beflügeln	VVFIN	1	beflügelt
Anzeige|Anzeigen	NN	1	Anzeigen
Achsel	NN	1	Achsel
besinnen	VVFIN	1	Besinne
erschossen	ADJA	1	erschossene
geraten|raten	VVPP	1	geraten
ringend	ADJD	1	ringend
besänftigen	VVINF	1	besänftigen
erfodert	VVFIN	1	erfodert
widersetzen	VVFIN	1	widersetzte
scherzen	VVFIN	1	scherzen
Hätt	VVFIN	1	Hätt
hierherum	ADV	1	hierherum
Munterkeit	NN	1	Munterkeit
segnen	VVPP	1	gesegnet
Gespräch	NN	1	Gespräche
Politik	NN	1	Politik
Angaffen	NN	1	Angaffen
Vorstellung	NN	1	Vorstellung
Gesandten	NN	1	Gesandten
gleichgültigsten	ADJA	1	gleichgültigsten
brüllet	VVFIN	1	brüllet
verbessern	VVPP	1	verbessert
Wollüstling	NN	1	Wollüstling
Gerücht	NN	1	Gerüchte
erschüttern	VVPP	1	erschüttert
verbreiten	VVPP	1	verbreitet
gefodert	VVPP	1	gefodert
Verwirrung	NN	1	Verwirrung
genehmigen	VVINF	1	genehmigen
entdecken	VVPP	1	entdeckt
kränken	VVFIN	1	kränke
greifen	VVFIN	1	griff
Gefährt|Gefährte	NN	1	Gefährten
beschreiben	VVINF	1	beschreiben
Hochachtung	NN	1	Hochachtung
bücken	VVFIN	1	bücken
Mordtat	NN	1	Mordtat
wegwerfen	VVFIN	1	wegwirft
umhin	ADV	1	umhin
vermehren	VVINF	1	vermehren
schriftlich	ADJD	1	schriftlich
gleichwohl	ADV	1	Gleichwohl
Eilfertigkeit	NN	1	Eilfertigkeit
martern	VVINF	1	martern
vertrautester	ADJA	1	vertrautester
martere	VVFIN	1	martere
weh	ADJD	1	weh
verwechseln	VVPP	1	verwechselt
Kraft	NN	1	Kräfte
Glückes	NN	1	Glückes
Seitenblick	NN	1	Seitenblick
ergrimmen	VVPP	1	ergrimmt
Beschäftiget	VVFIN	1	Beschäftiget
Schatzmeister	NN	1	Schatzmeister
Gabe	NN	1	Gabe
Eil	NN	1	Eil
Schnitt|Schnitte	NN	1	Schnitte
schade	ADJD	1	Schade
verziehet	VVFIN	1	verziehet
schmachten	VVPP	1	Geschmachtet
treffen|triefen	VVPP	1	getroffen
erleben	VVFIN	1	erlebt
verkennen	VVINF	1	verkennen
beschließen	VVINF	1	beschließen
aussteigen	VVINF	1	aussteigen
rücken	VVINF	1	rücken
zwei	CARD	1	zwei
erlassen	VVFIN	1	erlasse
brünstig	ADJD	1	brünstiger
stier	ADJA	1	stieren
wetten	VVINF	1	wetten
Laune	NN	1	Laune
Rätsel	NN	1	Rätsel
rasch	ADJD	1	rasch
unterwerfen	VVFIN	1	unterwerfe
oben	ADV	1	oben
träumerisch	ADJD	1	träumerischer
rechtfertigen	VVINF	1	rechtfertigen
neidisch	ADJD	1	neidisch
betauern	VVFIN	1	betauern
verehrende	ADJA	1	verehrende
einig	ADJD	1	einig
Tragödie	NN	1	Tragödie
aufmerksam	ADJD	1	aufmerksam
abwesend	ADJA	1	abwesender
verstreichen	VVPP	1	verstrichen
Meisterstreiche	NN	1	Meisterstreiche
Gehirnchen	NN	1	Gehirnchen
derselb	PDAT	1	desselben
herrschaftlich	ADJA	1	herrschaftlichen
Amt	NN	1	Amt
Sorgfalt	NN	1	Sorgfalt
wecken	VVFIN	1	weckte
verschwören	VVFIN	1	verschworen
ungeachtet	APPR	1	ungeachtet
Wald	NN	1	Walde
Vertrauen	NN	1	Vertrauen
Gold	NN	1	Gold
Glanz	NN	1	Glanze
Tätige	NN	1	Tätiger
Medusenaugen	NN	1	Medusenaugen
vornehmlich	ADJD	1	vornehmlich
Rührung	NN	1	Rührung
würd	VVFIN	1	würd
tragen|trügen	VVFIN	1	trüge
loben	VVFIN	1	lobt
allgerechten	ADJA	1	allgerechten
süß	ADJA	1	süßen
Gericht	NN	1	Gerichte
erkanntest	VVFIN	1	erkanntest
Kuppler	NN	1	Kuppler
hierüber	PAV	1	hierüber
genau	ADJD	1	genau
unumschränktesten	ADJA	1	unumschränktesten
bieten|gebieten	VVPP	1	geboten
Tumult	NN	1	Tumult
Beteuerung	NN	1	Beteuerungen
Verbrecherin	NN	1	Verbrecherin
erblicket	VVFIN	1	erblicket
auskratzen	VVFIN	1	auskratzt
unbescholten	ADJA	1	unbescholtene
schminket	VVFIN	1	schminket
Sibylle	NN	1	Sibylle
Törin	NN	1	Törin
lehren	VVPP	1	gelehrt
