Title: Miß Sara Sampson
Number of all lemmas: 10095
Nummber of different lemmas: 2615

Lemma	POS	Frequency	Tokens
Mellefont	ADJD, VVFIN, NN, VVIMP, ADJA, NE, VVINF	144	Mellefont
Miss	NN	120	Miß
Marwood	NE	109	Marwood
lassen	VVIMP, VVFIN, VVPP, VVINF	107	Laß, läßt, lasse, lassen, laß, gelassen, ließ, Lassen, ließen, laßt
sagen	VVFIN, VVINF, VVPP, VVIMP	95	sage, Sagte, sagen, gesagt, Sagen, Sag, sagst, sagt, sagte, sag, Sage, sagtest
sehen	VVINF, VVFIN, VVIMP, VVPP	90	sehen, sehe, Sieh, sieht, Sehen, sieh, sahen, gesehen, siehst, Siehst, sah
Vater	NN	86	Vater, Vaters
wissen	VVFIN, VVINF	76	weiß, wissen, wüßte, wußten, Wisse, Weiß, wußte, wüßten
ach	ITJ	71	Ach, ach
schon	ADV	70	schon, Schon
gut	ADJA, ADJD	67	beste, besser, gut, gute, gutes, Gut, guten, guter, bester, besten, bessere, Gute, Besser, Bester
Lady	NN	67	Lady
gehen	VVINF, VVFIN, VVIMP, VVPP	66	gehen, geht, Geht, Geh, gingen, gehe, geh, Gehen, Gehet, ging, gehet, gegangen
kommen	VVINF, VVFIN, VVIMP, VVPP	64	kommen, komme, Kommen, kam, Komm, komm, gekommen, käme, kamen, Komme
wohl	ADV	63	wohl, Wohl
Liebe	NN	61	Liebe
ja	PTKANT, ADV	60	Ja, ja
mehr	ADV, PIS, PIAT	59	mehr
lieb	ADJD, ADJA	56	lieber, liebster, liebste, Liebste, liebsten, liebe, lieb, Lieber, lieben
Herz	NN	55	Herz, Herzen, Herzens
tun	VVINF, VVFIN, VVPP	55	tun, Tun, getan, tue, tut, Tut, tat
ganz	ADJA, ADV	52	ganzen, ganze, ganz, Ganz, ganzes
warum	PWAV	48	warum, Warum
gewiss	ADJD, ADJA	47	gewiß, gewisse, gewisses, Gewiß, gewisser, gewissen
wer	PWS	46	wer, Wer, Wessen, wem, wessen, wen, Wem, Wen
Sara	NE	44	Sara
Augenblick	NN	43	Augenblicke, Augenblick, Augenblicken
vielleicht	ADV	42	vielleicht, Vielleicht
lieben	VVPP, VVFIN, VVINF	42	geliebt, liebt, lieben, liebten, liebte, liebe, liebet
Hand	NN	42	Hand, Händen, Hände
Waitwell	NE, ADJD, NN	41	Waitwell
Brief	NN	41	Brief, Briefe, Briefes
dürfen	VMFIN, VMINF	40	darfst, dürfen, darf, Darf, dürfte, durfte, dürfe
nein	PTKANT	40	Nein, nein
Tochter	NN	39	Tochter
mögen	VMFIN	37	mag, möchten, möchte, Möchte, mögen, Mochte, möge, Mag, mochte
geben	VVINF, VVFIN, VVIMP, VVPP	36	geben, Geben, gab, Gib, gibt, gebe, gib, gegeben
allein	PTKVZ, ADV	36	allein, Allein
glauben	VVFIN, VVINF	34	glaubt, glauben, Glauben, glaubst, glaube, glaubte, glaubten, Glaubst
vergessen	VVPP, VVINF, VVFIN, VVIMP	33	vergessen, Vergessen, vergesse, vergiß, vergißt, vergaß
eben	ADV	32	eben, Eben
glücklich	ADJD, ADJA	31	glücklich, glücklicher, glücklichen, glückliche, Glücklich, glücklichste, Glückliche
bringen	VVINF, VVFIN, VVPP, VVIMP	30	bringen, bringe, brachten, gebracht, bringt, bring, bringst, Bringe, brachte, brächten
itzt	ADJD, VVFIN	30	itzt
genug	ADV	29	genug, Genug
erst	ADJA, ADV	29	ersten, erste, erst
wahr	ADJA, ADJD	29	wahre, wahr, wahres, wahren
lesen	VVIMP, VVFIN, VVINF, VVPP	29	lies, liest, lasen, lesen, Lesen, gelesen
Leben	NN	29	Lebens, Leben
bleiben	VVFIN, VVINF, VVPP, VVIMP	29	bleibt, Bliebe, bleiben, geblieben, Bleiben, bleib, bleibet, Bleib, bleibst, bleibe
Auge	NN	29	Augen, Auge
bitten	VVFIN, VVINF, VVPP	28	bitte, bitten, bittet, Bitten, gebeten, bat
Tag	NN	28	Tag, Tage, Tagen
Betty	NE	28	Betty
nehmen	VVFIN, VVINF, VVPP	27	nimmt, nehmen, Nehmen, genommen, nehme, nahm
lang	ADJD, ADJA	27	länger, langen, lang, längsten, längste, lange, langem
halten	VVINF, VVFIN, VVPP	27	halten, Halten, gehalten, hielt, hielte, halte, hältst, hält
finden	VVFIN, VVINF, VVPP	26	fand, Fand, finden, finde, gefunden, findet, Finden
sprechen	VVPP, VVINF, VVFIN, VVIMP	26	gesprochen, sprechen, spricht, sprichst, Sprich, sprich
denken	VVFIN, VVINF	26	denke, denken, denkt, dächte, dächten, Denken
stehen	VVFIN, VVINF	26	stehen, Stehen, stand, stehet, steht, stehe, stünde, stehst, Steht
Herr	NN	25	Herren, Herr, Herrn
Sir	NN	25	Sir
ab	PTKVZ	25	ab
wenige	PIS, PIAT	25	wenig, weniger, wenigen
Norton	NE	24	Norton
immer	ADV	24	immer
gleich	ADJD, ADJA	24	gleich, gleichen, gleicher, gleiche
unglücklich	ADJD, ADJA	23	unglücklich, unglücklichen, unglückliches, unglückliche, unglücklicher, unglücklichsten, Unglücklicher
viele	PIS, PIAT	23	viel, vieler, vieles, Vieles, viele, vielen
wünschen	VVINF, VVFIN, VVPP	23	wünschen, wünscht, wünschte, wünsche, gewünscht, wünschten, Wünsche, Wünschen
Welt	NN	23	Welt
nie	ADV	22	nie, Nie
Tugend	NN	22	Tugenden, Tugend
letzt	ADJA	22	letzte, letzten
hören	VVFIN, VVINF, VVIMP	21	höre, hören, hörte, Hören, Höre, hör, Hör, hört, hörst
kennen	VVINF, VVFIN, VVPP	21	kennen, kannten, kenne, gekannt, kennt, Kenne
vergeben	VVINF, VVPP, VVFIN	21	vergeben, vergab, vergibt
alt	ADJA, ADJD	21	alter, alte, alten, alt
Gott	NN	21	Gott, Göttern, Gottes
Fuß	NN	20	Fuße, Fuß, Füßen, Fußes
klein	ADJA, ADJD	20	kleinste, kleinen, kleiner, kleine, klein
lange	ADV	20	lange
Kind	NN	20	Kind, Kindes, Kinder
verlassen	VVPP, VVINF, VVFIN, VVIMP	20	verlassen, Verläßt, Verlaß, verläßt
weit	ADJD, ADJA	20	weit, weiteres
O	NN	20	O
zurück	PTKVZ, ADV	20	zurück
leben	VVPP, VVINF, VVFIN	20	gelebt, leben, Leben, lebe, lebt, Lebt, lebte
neu	ADJA, ADJD	19	neue, neuen, neuem, neuer, neu
wider	APPR	19	wider
Mann	NN	19	Mann, Mannes
verlieren	VVFIN, VVINF, VVPP	19	verlor, verlieren, verloren, verlöre
fühlen	VVFIN, VVINF, VVIMP	19	fühle, fühlte, fühlt, fühlen, Fühlen, fühl
zärtlich	ADJA, ADJD	19	zärtlichen, zärtliche, zärtlichste, zärtlich, zärtlichsten, zärtlicher
setzen	VVFIN, VVINF, VVPP	19	setze, setzen, gesetzt, setzt, Gesetzt, setzte
sterben	VVINF, VVPP, VVIMP, VVFIN	18	sterben, gestorben, stirb, starb, stirbt, sterbe
Wort	NN	18	Wort, Worte, Worten
Name	NN	18	Namen, Name
Himmel	NN	18	Himmels, Himmel
Träne|Tränen	NN	18	Tränen
bald	ADV	18	bald, Bald
erinnern	VVINF, VVFIN, VVPP	17	erinnern, erinnere, Erinnerst, erinnerst, erinnerte, erinnert, Erinnern
grausam	ADJD, ADJA	17	grausamer, grausam, grausame, grausamen, Grausamer, grausamere, Grausame, grausamste, grausamsten
helfen	VVFIN, VVINF, VVIMP	17	hilft, half, helfen, hilf, Hülfe, Hilf
Zweifel	NN	16	Zweifel, Zweifels
Art	NN	16	Arten, Art
einzig	ADJA, ADJD	16	einzige, einziger, einzigen, einziges, Einzige, einzig
erlauben	VVFIN, VVINF, VVPP	16	erlaube, Erlauben, erlauben, erlaubte, erlaubt
Hannah	NE	16	Hannah
Mutter	NN	16	Mutter
Verbrechen	NN	16	Verbrechen, Verbrechens
ruhig	ADJD	16	ruhiger, ruhig, Ruhiger
gar	ADV	16	gar
Frauenzimmer	NN	16	Frauenzimmer
wenigstens	ADV	16	wenigstens, Wenigstens
gern	ADV	16	gern
suchen	VVFIN, VVINF, VVPP	16	suchen, sucht, gesucht, suche
annehmen	VVIZU, VVINF, VVPP	15	anzunehmen, annehmen, angenommen
ewig	ADJA, ADJD	15	ewigen, ewig, ewige
hoffen	VVFIN, VVINF, VVPP	15	hoffe, hoffen, gehofft
möglich	ADJD	15	möglich
Unglück	NN	15	Unglück, Unglücke, Unglücks
eigen	ADJD, ADJA	14	eigen, eignen, eigne, eigenen, eignem, eigner
Arm|Arme	NN	14	Armen, Arme
Zeit	NN	14	Zeit, Zeiten
groß	ADJA, ADJD	14	größten, groß, große, großes, größtes, größer
verzeihen	VVFIN, VVINF	14	verzieh, verzeihen, verzeiht, Verzeihen
Ehre	NN	14	Ehre
elend	ADJA, ADJD	14	elenden, Elenden, elende, Elende, elend, elender, Elender
endlich	ADV, ADJA	14	endlich, Endlich, endliche
nennen	VVFIN, VVINF, VVPP	14	nenne, Nennen, nennen, nennt, genannt, nannte
recht	ADJD	14	recht, Recht
erwarten	VVFIN, VVINF	14	erwarte, erwarten, Erwarten
Gesicht	NN	14	Gesichter, Gesicht, Gesichtern, Gesichte, Gesichts
eher	ADV	14	eher, Eher
davon	PAV, PTKVZ	14	davon
schreiben	VVPP, VVINF, VVFIN	13	geschrieben, schreiben, schreibt, schriebe, schreibet
Vermögen	NN	13	Vermögen, Vermögens
schrecklich	ADJA, ADJD	13	schreckliche, schrecklichsten, schrecklicher, Schreckliche, schrecklichen, schrecklich
wegen	APPO, APPR	13	wegen
verdienen	VVFIN, VVPP, VVINF	13	verdient, verdienen, verdiene
empfinden	VVINF, VVFIN, VVPP	13	empfinden, empfindet, empfand, empfunden, empfinde
Arabellen	NN	13	Arabellen
wagen	VVINF, VVFIN, VVPP, VVIMP	13	wagen, wagten, gewagt, Gewagt, wagte, wag
Freude	NN	13	Freude, Freuden
kömmt	VVFIN, ADJD	13	kömmt
scheinen	VVINF, VVFIN	13	scheinen, Scheine, scheine, scheint, schien
darauf	PAV	13	darauf
Glück	NN	13	Glück, Glücks
Seite	NN	12	Seite, Seiten
fürchten	VVFIN, VVINF, VVPP	12	fürchten, fürchte, gefürchtet
Ende	NN	12	Ende
fehlen	VVINF, VVFIN	12	fehlen, fehlt, fehlte, fehle
fliehen	VVINF, VVFIN, VVIMP	12	fliehen, fliehe, Fliehen, flohen, Flieh, flieht
folgen	VVFIN, VVINF, VVPP	12	folgen, folgt, folgte, folgten, gefolgt, folge
kurz	ADJA, ADJD	12	kurze, kurz, kurzen, kurzer, Kurz
lernen	VVFIN, VVPP, VVIMP, VVINF	12	lernte, gelernt, lern, lernen, lerne
weinen	VVFIN, VVINF, VVPP	12	weinen, weint, weinst, weine, geweint
beide	PIAT, PIS	12	beiden, beide, beides
Vorwurf	NN	12	Vorwürfe, Vorwurf
entdecken	VVPP, VVFIN, VVINF	12	entdeckt, entdecke, entdeckte, entdecken, Entdecken
oft	ADV	12	oft
Mensch	NN	12	Menschen, Mensch
Person	NN	11	Person, Personen
Hülfe	NN, NE	11	Hülfe
Gedanke	NN	11	Gedanken, Gedanke
angenehm	ADJD, ADJA	11	angenehm, angenehme, angenehmer, angenehmen
verstehen	VVFIN, VVINF, VVPP	11	verstehe, verstehen, versteht, verstanden
deswegen	PAV	11	deswegen, Deswegen
werd	VVFIN	11	ward, Ward
ansehen	VVPP, VVINF, VVFIN, VVIZU	11	angesehen, ansehen, ansehe, ansieht, anzusehen
ehe	KOUS	11	ehe
Tod	NN	11	Todes, Tod, Tode
reden	VVFIN, VVINF, VVPP	11	reden, redet, rede, Reden, geredet
Fehler	NN	11	Fehler
Sampson	NN	11	Sampson
danken	VVFIN, VVIMP, VVINF	11	dankt, danke, Dank, danken, Danken
daran	PAV	11	daran
Dolch	NN	10	Dolch, Dolche
Vergnügen	NN	10	Vergnügens, Vergnügen
erhalten	VVINF, VVPP, ADJA, VVFIN	10	erhalten, erhaltenen, Erhalten
Geschlecht	NN	10	Geschlecht, Geschlechte, Geschlechts
führen	VVFIN, VVINF	10	führt, führen, führte
unsre	PPOSAT	10	unsern
leicht	ADJD, ADJA	10	leicht, leichte, leichter
geschwind	ADJD	10	Geschwind, geschwind, geschwinder
erfahren	VVINF, VVFIN, VVPP	10	erfahren, erfuhr
Besuch	NN	10	Besuch, Besuche, Besuchs
Dienst	NN	10	Dienst, Diensten, Dienste
verlangen	VVFIN, VVINF	10	verlange, verlangen, verlangt
Einbildung	NN	10	Einbildungen, Einbildung
Blick	NN	10	Blick, Blicke
versprechen	VVFIN	9	verspreche, versprach, verspricht
brauchen	VVFIN, VVINF	9	braucht, brauchen, brauchte, Brauchen
Empfindung	NN	9	Empfindungen, Empfindung
Schmerz	NN	9	Schmerzes, Schmerzen, Schmerz
schweigen	VVIMP, VVPP, VVFIN	9	schweig, geschwiegen, Schweig, schweigen, schweige
väterlich	ADJA	9	väterliches, väterlichen, väterliche
teuer	ADJA, ADJD	9	Teuerste, teuer, teuerste, teurer
zittern	VVFIN, VVINF	9	zitterte, zittere, Zittern, zittern
gering	ADJA	9	geringsten, geringeres, geringste
Schicksal	NN	9	Schicksal, Schicksale, Schicksals
besitzen	VVINF, VVPP, VVFIN	9	besitzen, besessen, besitze, besäßen, besitzt
List	NN	9	List
bekommen	VVFIN, VVPP, VVINF	9	bekomme, bekommen, bekam
Bediente	NN	9	Bedienter, Bedienten, Bediente
erschrecken	VVFIN, VVINF, VVPP	9	erschrecke, erschrecken, erschrocken
fast	ADV	9	fast, Fast
fallen|gefallen	VVPP	9	gefallen
geschehen	VVINF, VVPP, VVFIN	9	geschehen, geschieht
Seele	NN	9	Seele
Bella	NE	9	Bella
Hoffnung	NN	9	Hoffnung
Kraft	NN	9	Kraft, Kräften, Kräfte
erkennen	VVFIN, VVINF, VVIMP	9	erkannte, erkenne, erkennen, Erkennen, erkenn
natürlich	ADV, ADJA	9	natürlich, natürliche
Sprache	NN	8	Sprache
Antwort	NN	8	Antwort
plötzlich	ADJD, ADJA	8	Plötzlich, plötzlich, plötzliche, plötzlicher
Mädchen	NN	8	Mädchens, Mädchen
William	NE	8	William, Williams
frei	ADJA, ADJD	8	freien, freier, freies, frei, freie
gefährlich	ADJA, ADJD	8	gefährlichen, gefährliche, gefährlich, Gefährlich
durchaus	ADV	8	durchaus
Gewalt	NN	8	Gewalt
dafür	PAV	8	dafür
Verbindung	NN	8	Verbindung, Verbindungen
legen	VVPP, VVFIN, VVINF	8	gelegt, Legen, legen, legte
gönnen	VVFIN, VVINF	8	gönnte, gönnen, gönne, Gönnen
Ha	NE	8	Ha
lieset	VVFIN	8	lieset
tugendhaft	ADJD, ADJA	8	tugendhaft, tugendhafte, tugendhaften, tugendhafter
fort	ADV, PTKVZ	8	fort, Fort
Schwachheit	NN	8	Schwachheiten, Schwachheit
böse	ADJA, ADJD	8	Böse, böse, bösen
behalten	VVINF, VVFIN	8	behalten, Behalten, behalte
schlagen	VVFIN, VVPP	8	schlägt, schlüge, geschlagen, Schlagen
Leute	NN	8	Leute, Leuten
Mitleiden	NN	8	Mitleiden
darin	PAV	8	darin
Jahr	NN	8	Jahre, Jahr, Jahren
Mund	NN	8	Mund, Munde, Mundes
bloß	ADJD, ADJA	8	bloß, Bloß, bloße
Traum	NN	8	Träume, Traumes, Traume, Traum
wohin	PWAV	8	wohin, Wohin
Wut	NN	8	Wut
darüber	PAV	8	darüber, Darüber
Ursache	NN	8	Ursache, Ursachen
Vergebung	NN	8	Vergebung
Zimmer	NN	8	Zimmer, Zimmers
Unglückliche	NN	8	Unglückliche, Unglücklicher
Anverwandte	NN	8	Anverwandte, Anverwandten
Madam	NN	8	Madam
liegen	VVFIN, VVPP	8	liegt, liegen, liege, gelegen
reißen	VVFIN, VVINF	8	reißt, riß, reißen
zeigen	VVINF, VVFIN, VVPP	8	zeigen, gezeigt, zeigt
Solmes	NN	8	Solmes
Freund	NN, NE	8	Freunde, Freund
Nachricht	NN	8	Nachrichten, Nachricht
Haus	NN	8	Haus, Hause
Miene	NN	7	Miene, Mienen
Rache	NN	7	Rache
wann	PWAV	7	wann, Wann
Blut	NN	7	Bluts, Blute
Wille	NN	7	Willen, Willens
falsch	ADJD, ADJA	7	falsch, falschen
weniger	ADV	7	weniger
Gesinnung	NN	7	Gesinnungen
schwach	ADJD, ADJA	7	schwach, schwache, schwächer
enthalten	VVPP, VVFIN, VVINF	7	enthalten, enthielte
kosten	VVPP, VVINF, VVFIN	7	gekostet, kosten, kostet
nunmehr	ADV	7	Nunmehr, nunmehr
Freundin	NN	7	Freundin, Freundinnen
Verstellung	NN	7	Verstellung
Gerechtigkeit	NN	7	Gerechtigkeit
außer	APPR, KOUS	7	außer
Vorstellung	NN	7	Vorstellungen, Vorstellung
Klage|Klagen	NN	7	Klagen
Nacht	NN	7	Nacht
Wollust	NN	7	Wollust
fragen	VVFIN, VVINF, VVIMP	7	fragen, Frag, Fragen, fragst
nötig	ADJD	7	nötig, nötiger
Gift	NN	7	Gift
eilen	VVFIN, VVINF	7	eilt, Eilt, eile, eilen, eilte
Mühe	NN	7	Mühe
Gewissen	NN	7	Gewissen, Gewissens
werfen	VVFIN, VVPP, VVINF	7	warfen, geworfen, werfen
fallen	VVFIN, VVINF, VVIMP	7	fiel, falle, fallen, fall
vollkommen	ADJD, ADJA	7	vollkommen, Vollkommen, vollkommenste
genießen	VVINF, VVPP	7	genießen, genossen
arm	ADJA	7	armen, arme, Armes
seh	XY, NE, FM	7	seh
heute	ADV	7	heute
Natur	NN	7	Natur
vermuten	VVFIN	7	vermuten, vermute, vermutete
allzu	PTKA	7	allzu
verführen	VVPP, VVFIN, VVINF	7	verführt, verführte, verführen
aufopfern	VVPP, VVIZU, VVINF	7	aufgeopfert, aufzuopfern, Aufzuopfern, aufopfern
dahin	PAV	7	dahin
erklären	VVINF, VVFIN, VVPP	7	erklären, erkläre, erklärt, erklärten
befehlen	VVFIN, VVPP, VVINF	7	befahl, befohlen, befehlen, befiehlt
schön	ADJA, ADJD	7	schönste, schönes, schöne, schönen, schön
Aufenthalt	NN	7	Aufenthalte, Aufenthalt
Gefahr	NN	7	Gefahr
verbinden	VVFIN, VVPP, VVINF	7	verband, verbunden, verbinden
aufhören	VVPP, VVFIN, VVINF	7	aufgehört, aufhöre, aufhören
Geist	NN	7	Geist, Geister
weder	KON	7	weder
jung	ADJA, ADJD	7	jungen, junges, jung, junge
jemals	ADV	6	jemals
vorwerfen	VVIZU, VVINF, VVFIN	6	vorzuwerfen, vorwerfen, vorwerfe
sicher	ADJD	6	sicher, sichersten, sicherer, sichrer
kehren	VVFIN, VVINF	6	kehre, kehrtest, kehren, Kehre
nahe	PTKVZ	6	nahe
verraten	VVPP, VVFIN	6	verraten, verrät, verrieten
anfangen	VVFIN, VVINF	6	anfange, anfangen
fangen	VVFIN, VVINF	6	fängt, fangen
fest	ADJA, ADJD	6	festesten, festes, fest, festen
Schande	NN	6	Schande
kalt	ADJA, ADJD	6	kalter, kalt, kaltem, kalte
erscheinen	VVPP, VVINF, VVFIN	6	erschienen, erscheinen, erscheint, Erscheint
Tat	NN	6	Taten, Tat
Flucht	NN	6	Flucht
Absicht	NN	6	Absichten, Absicht
verbergen	VVINF, VVFIN	6	verbergen, verbarg, verbirgt
gnädig	ADJA, ADJD	6	Gnädiger, gnädiger, gnädig
aufhalten	VVFIN, VVINF	6	aufhält, aufhalten
tadeln	VVFIN, VVINF	6	Tadle, tadelt, tadeln, tadle
schuldig	ADJD, ADJA	6	schuldig, schuldige
befinden	VVINF, VVFIN, VVPP	6	befinden, befindest, befinde, befanden, befunden
Laster	NN	6	Laster
traurig	ADJA, ADJD	6	traurigen, traurig, Trauriger
antworten	VVPP, VVINF	6	geantwortet, antworten
merken	VVFIN, VVINF	6	merke, merken, merkte
fallen|fällen	VVFIN	6	fällt
je	ADV	6	Je, je
Sache	NN	6	Sache, Sachen
sogleich	ADV	6	sogleich
dabei	PAV	6	dabei
London	NE	6	London
darum	PAV	6	darum
Schritt	NN	6	Schritten, Schritte, Schritt
unruhig	ADJA, ADJD	6	unruhige, unruhig, unruhiger
hassen	VVFIN, VVINF	6	haßt, hasse, hassen
messen|missen	VVIMP	6	Miß
schlafen	VVFIN, VVINF	6	schläft, schlafen, schlief
meinig	PPOSS	6	meinigen, Meinigen, meinige
empfangen	VVINF, VVPP	6	empfangen
Reue	NN	6	Reue
dadurch	PAV	6	Dadurch, dadurch
unschuldig	ADJA, ADJD	6	unschuldigste, unschuldig, unschuldige
Freundschaft	NN	6	Freundschaft
meinetwegen	ADV	6	meinetwegen, Meinetwegen
verursachen	VVINF, VVPP	6	verursachen, verursacht
nah	ADJA, ADJD	6	nähere, näher, näherer
Zug	NN	6	Zug, Züge
gestehen	VVINF	6	gestehen
Bedenken	NN	6	Bedenken
Folge	NN	6	Folge, Folgen
Woche	NN	6	Wochen, Woche
Anteil	NN	6	Anteil
selten	ADJD	6	selten
retten	VVFIN, VVINF	6	rettete, retten, Retten
Gelegenheit	NN	6	Gelegenheit, Gelegenheiten
freilich	ADV	6	freilich, Freilich
zweifeln	VVFIN, VVINF, VVPP	6	zweifeln, gezweifelt, zweifle
süß	ADJA, ADJD	6	süßesten, süße, süß, süßen
vortrefflich	ADJD, ADJA	6	Vortrefflich, vortrefflich, vortrefflichste, vortreffliche
spät	ADJA, ADJD	5	späte, später, spät
laß	ADJD	5	laß
wirklich	ADJA, ADJD	5	wirkliche, wirklich
niemand	PIS	5	niemand, Niemand
tragen	VVINF, VVFIN, VVPP	5	tragen, Tragen, getragen
geliebt	ADJA	5	geliebten, geliebteste
Rede|Reden	NN	5	Reden
bitter	ADJD, ADJA	5	bitter, bittere
schenken	VVINF, VVFIN	5	schenken, schenkt
Abscheu	NN	5	Abscheu
Grund	NN	5	Grunde, Grund, Gründen
Hälfte	NN	5	Hälfte
schließen	VVFIN, VVINF	5	schloß, schließen, schließe
niemals	ADV	5	niemals
Leidenschaft	NN	5	Leidenschaften, Leidenschaft
Angst	NN	5	Angst
trennen	VVINF, VVFIN	5	trennen, trennten
Wohltat	NN	5	Wohltat, Wohltaten
wiederholen	VVFIN	5	wiederholte, Wiederhole, wiederholen
Morgen	NN	5	Morgen, Morgens
Verlangen	NN	5	Verlangen
Glückseligkeit	NN	5	Glückseligkeiten, Glückseligkeit
würdig	ADJD, ADJA	5	würdig, würdigen, würdiger
still	ADJD	5	Still, still
halb	ADJD	5	halb
Schrecken	NN	5	Schrecken
Schlinge	NN	5	Schlinge
fassen	VVINF, VVFIN, VVPP	5	fassen, Fassen, gefaßt
betrachten	VVINF, VVPP, VVFIN	5	betrachten, betrachtet, Betrachte
großmütig	ADJA, ADJD	5	großmütigen, großmütig, großmütiger, großmütige
Qual	NN	5	Qualen
Zwang	NN	5	Zwang
schnell	ADJD, ADJA	5	Schnell, schnell, schnellen
Stich	NN	5	Stiche, Stich
teilen	VVPP, VVFIN, VVINF	5	geteilt, Teilen, teilen, teile
warten	VVFIN, VVINF	5	wartet, warten, warte
sauer	ADJA, ADJD	5	sauern, saurer, sauer
schicken	VVPP, VVFIN	5	geschickt, schicken, schickt, schickte
Itzt	ADJD, NE	5	Itzt
stark	ADJA, ADJD	5	stärkere, stärksten, stark
Schönheit	NN	5	Schönheit
Bitte|Bitten	NN	5	Bitten
Sohn	NN	5	Sohn
Strafe	NN	5	Strafe
Wert	NN	5	Wert
krank	ADJD	5	krank
Vergeben	NN	5	Vergebens, Vergeben
edel	ADJD, ADJA	5	edel, edler, edelste
Geliebte	NN	5	Geliebten, Geliebte
Anblick	NN	5	Anblick, Anblicke
tausend	CARD	5	tausend
Mut	NN	5	Mut
ersparen	VVINF, VVPP	5	ersparen, erspart
heißen	VVFIN, VVINF	5	heißt, heißen
Verführer	NN	5	Verführer
zufrieden	ADJD	5	zufrieden
anwenden	VVINF, VVFIN	5	anwenden, anwende, anwendet
Umstand	NN	5	Umstand, Umständen, Umstände
Freiheit	NN	5	Freiheit
scheinet	VVFIN	5	scheinet
strafen	VVINF	5	strafen
Dank	NN	5	Dank, Danke
göttlich	ADJA, ADJD	5	göttlichen, göttlicher, Göttliche
Begierde	NN	5	Begierden, Begierde
früh	ADJD	5	früh
schmeicheln	VVFIN	5	schmeichelt, schmeichle, Schmeicheln
morgen	ADV	5	morgen, Morgen
gleichgültig	ADJD, ADJA	5	gleichgültig, gleichgültigen
Beleidigung	NN	5	Beleidigungen, Beleidigung
entschließen	VVPP	5	entschlossen
aufgeben	VVINF, VVIZU	5	aufgeben, aufzugeben
umsonst	ADV	5	Umsonst, umsonst
übrig	ADJA, ADJD	5	übrigen, übrig
rege	ADJD	5	rege
vorstellen	VVPP, VVIZU, VVINF, VVFIN	5	vorgestellt, vorzustellen, vorstellen, vorstellte, vorstelltest
Schmeichelei	NN	5	Schmeichelei, Schmeicheleien
fremd	ADJA	5	fremden, fremde
überlegen	VVFIN	5	überlegen, überlegte
vergebens	ADV	5	vergebens
treten	VVPP, VVFIN, VVINF	5	getreten, trat, treten, Treten
längst	ADV	5	längst
ziehen	VVFIN, VVINF	5	zog, ziehen
handeln	VVFIN, VVINF	5	handle, handeln, handelt
Diener	NN	5	Diener
Vergleich	NN	5	Vergleich, Vergleichs, Vergleiche
Denkungsart	NN	4	Denkungsart
fürchterlich	ADJD, ADJA	4	fürchterlich, fürchterlichen, fürchterliche
vorig	ADJA	4	vorigen, vorige, voriger
Arabella	NE	4	Arabella
überzeugen	VVPP, VVINF	4	überzeugt, überzeugen
Recht|Rechte	NN	4	Rechten, Rechte
Acht	NN	4	Acht
Weise	NN	4	Weise, Weisen
sahe	VVFIN	4	sahe
schmeichelhaft	ADJD, ADJA	4	schmeichelhaft, schmeichelhafte
Erbschaft	NN	4	Erbschaft
entschuldigen	VVINF, VVFIN	4	entschuldigen, entschuldigt
Einfall	NN	4	Einfall
Sarchen	NN	4	Sarchen
Unwille	NN	4	Unwillens, Unwillen, Unwille
wenig	ADV	4	wenig
desto	KON	4	desto
wenden	VVFIN, VVINF	4	wandte, wenden
gefällig	ADJD, ADJA	4	gefällig, gefällige
Stahl	NN	4	Stahl
widerfahren	VVPP, VVINF, VVFIN	4	widerfahren
verschwinden	VVINF, VVPP	4	verschwinden, verschwunden
Drohung	NN	4	Drohungen
überwinden	VVPP, VVINF	4	überwunden, überwinden
Genuss	NN	4	Genusses, Genuß
Betrübnis	NN	4	Betrübnis
erholen	VVINF, VVFIN	4	erholen, erholten, erholt
Bitte	NN	4	Bitte
Wirkung	NN	4	Wirkung, Wirkungen
Vetter	NN	4	Vetters, Vetter
umarmen	VVPP, VVINF, VVFIN	4	umarmt, umarmen
Verderben	NN	4	Verderben
ungern	ADV	4	ungern
Stelle	NN	4	Stelle
etwa	ADV	4	etwa, Etwa
erweisen	VVPP, VVINF	4	erwiesen, erweisen
Verräter	NN	4	Verräter
schlecht	ADJA, ADJD	4	schlechte, schlechter, schlecht
freuen	VVINF, VVFIN	4	freuen, freue
Busen	NN	4	Busen
bereits	ADV	4	bereits
schwer	ADJA, ADJD	4	schwere, schwer, schwerer
Hitze	NN	4	Hitze
Güte	NN	4	Güte
zugleich	ADV	4	zugleich
seufzen	VVINF, VVFIN	4	seufzen, seufze
Erbarmen	NN	4	Erbarmen
Luft	NN	4	Luft
erzeigen	VVINF, ADJD, VVFIN	4	erzeigen
wozu	PWAV	4	wozu, Wozu
diejenig	PDAT	4	diejenige, derjenigen
her	PTKVZ	4	her
gleichwohl	ADV	4	Gleichwohl, gleichwohl
zitternd	ADJA, ADJD	4	zitternde, zitternd, zitterndes
treffen	VVINF, VVFIN	4	treffen, trifft
aufs	APPRART	4	aufs, Aufs
weißen	VVFIN	4	weißt
Alter	NN	4	Alters, Alter
Zorn	NN	4	Zorn, Zorne
Mörderin	NN	4	Mörderin, Mörderinnen
bedenken	VVFIN, VVINF	4	Bedenken, bedenken
erstarren	VVFIN	4	erstarre, erstarrt
Zettel	NN	4	Zettel
begierig	ADJA, ADJD	4	begieriger, begierig
kostbar	ADJA, ADJD	4	kostbaren, kostbarer, kostbares
verschweigen	VVPP, VVFIN	4	verschwiegen, verschweigen
tot	ADJD	4	tot
Ohnmacht	NN	4	Ohnmacht
erkaufen	VVINF	4	erkaufen
treiben	VVPP, VVINF	4	getrieben, treiben
Inhalt	NN	4	Inhalt
zwingen	VVPP, VVINF, VVFIN	4	gezwungen, zwingen, zwang
bewegen	VVFIN, VVPP, VVINF	4	bewegte, bewegt, bewegen
herein	ADV, PTKVZ	4	herein
brechen	VVINF, VVFIN	4	brechen, bricht, breche
Besitz	NN	4	Besitze, Besitz
schaffen	VVINF, VVFIN	4	schaffen, Schaffe
Geheimnis	NN	4	Geheimnisse, Geheimnis
Buhlerin	NN	4	Buhlerin
Seligkeit	NN	4	Seligkeit, Seligkeiten
strafbar	ADJA, ADJD	4	strafbarer, strafbar, strafbare
rauben	VVINF, VVFIN, VVPP	4	rauben, raubten, geraubt
gemein	ADJA	4	gemeiner, gemeinen, gemeine
reich	ADJD, ADJA	4	reich, reichen, reichere, reiche
zornig	ADJD, ADJA	4	Zornig, zorniger, zornigen
entsagen	VVINF, VVFIN	4	entsagen, entsagt
Mannsperson	NN	4	Mannspersonen, Mannsperson
fahren|führen	VVFIN	4	führe, Führe
Teil	NN	4	Teil, Teile
kaum	ADV	4	Kaum, kaum
Anfang	NN	4	Anfang
verächtlich	ADJA, ADJD	4	verächtlichen, Verächtlich, verächtlich
gedenken	VVFIN, VVINF	4	gedenken, gedenkt
einander	PRF	4	einander
begehen	VVINF, VVPP	4	begehen, begangen
unwürdig	ADJD, ADJA	4	unwürdig, unwürdiges
Gefühl	NN	4	Gefühl, Gefühls
Schwierigkeit	NN	4	Schwierigkeit, Schwierigkeiten
allezeit	ADV	4	allezeit
lasterhaft	ADJA, ADJD	4	lasterhaften, lasterhafte, lasterhaft
Sturm	NN	4	Sturm, Sturms
Mörder	NN	4	Mörder, Mörders
Verzweiflung	NN	4	Verzweiflung
Reiz	NN	4	Reize
feurig	ADJA	4	feurigsten, feurigen, feurige
fahren	VVPP, VVFIN, VVINF	4	gefahren, fuhr, fährt, fahren
Segen	NN	4	Segen
erbrechen	VVFIN, VVPP	4	erbricht, erbrochen, erbrechen, erbrach
voraus	PTKVZ, ADV	3	voraus
Grenze	NN	3	Grenzen
Andenken	NN	3	Andenken
Misstrauen	NN	3	Mißtrauens, Mißtrauen
vorher	ADV	3	vorher
Vorteil	NN	3	Vorteil
Verzögerung	NN	3	Verzögerung
Wirt	NN	3	Wirt
Lebensart	NN	3	Lebensart
springen	VVFIN, VVINF	3	sprang, springen, springt
Gegenstand	NN	3	Gegenstande, Gegenstände
billig	ADJD	3	billig
Bande	NN	3	Bande, Banden
antun	VVIZU, VVFIN, VVINF	3	anzutun, antut, antun
Sinn|Sinnen	NN	3	Sinnen
armselig	ADJA, ADJD	3	armselige, armselig, armseligen
darnach	ADV	3	darnach
lauter	PIAT	3	lauter
Närrin	NN	3	Närrin
laufen	VVFIN, VVINF	3	läuft, laufen
Gleichgültigkeit	NN	3	Gleichgültigkeit
vorüber	ADV, PTKVZ	3	vorüber
leugnen	VVINF, VVFIN	3	leugnen, leugne
Band	NN	3	Band
entschuldiget	VVFIN	3	entschuldiget
gemäß	ADJD, APPO	3	gemäß
Strenge	NN	3	Strenge
Geschenk	NN	3	Geschenke, Geschenk
erfüllen	VVFIN, VVPP	3	erfülle, erfüllt
erzählen	VVINF, VVFIN	3	erzählen, erzählte
Lächeln	NN	3	Lächeln
stoßen	VVFIN, VVPP	3	stieß, stößt, gestoßen
Tyrann	NN	3	Tyrannen, Tyrann
unnatürlich	ADJA, ADJD	3	unnatürlichen, unnatürliche, unnatürlich
alsdann	VVFIN, ADJD	3	alsdann
Zeuge	NN	3	Zeugen, Zeuge
Zärtlichkeit	NN	3	Zärtlichkeit
Punkt	NN	3	Punkt
Grab	NN	3	Grabe, Grab
nochmals	ADV	3	nochmals
Beste	NN	3	Beste, Besten
Falle	NN	3	Falle
Eifersucht	NN	3	Eifersucht
Klugheit	NN	3	Klugheit
gehören	VVFIN	3	gehört
Vorsprecher	NN	3	Vorsprecher
Aussicht	NN	3	Aussicht
locken	VVFIN, VVPP	3	lockten, locken, gelockt
zuziehen	VVINF, VVPP	3	zuziehen, zugezogen
versuchen	VVPP, VVFIN, VVINF	3	versucht, versuche, versuchen
schmerzhaft	ADJA, ADJD	3	schmerzhafte, schmerzhaft
versöhnen	VVPP	3	versöhnt
entfernen	VVPP, VVINF	3	entfernt, entfernen
Sage	NE, NN	3	Sage
unmöglich	ADJD	3	Unmöglich, unmöglich
stolz	ADJA, ADJD	3	stolzen, stolze, stolz
schrecken	VVFIN	3	schreckt
entbehren	VVINF	3	entbehren
meiste	PIS	3	meisten
vorbei	ADV, PTKVZ	3	vorbei
unselig	ADJA	3	unselige, unseligen, Unselige
drücken	VVFIN, VVINF	3	Drücken, drückt, drücken
Stand	NN	3	Stande, Stand
Höchste	NN	3	Höchsten
Begriff	NN	3	Begriff, Begriffe
aufheben	VVPP, VVINF	3	aufgehoben, aufheben
Gattin	NN	3	Gattin
erröten	VVINF	3	erröten
beschämen	VVPP, VVFIN	3	beschämt, Beschämen
unterdessen	ADV	3	unterdessen, Unterdessen
Glied	NN	3	Glied, Glieder
besorgen	VVFIN, VVINF	3	besorge, besorgen
Trost	NN	3	Trost
grässlich	ADJA	3	gräßlichen, gräßlichsten, gräßlichste
verachten	VVPP, VVINF	3	verachtet, verachten
rasen	VVINF, VVFIN	3	rasen, rase
herablassen	VVINF	3	herablassen
einfallen	VVINF, VVFIN	3	einfallen, einfällt
verlustig	ADJD	3	verlustig
hernach	ADV	3	hernach
herum	PTKVZ, APZR	3	herum
betrüben	VVINF, VVFIN	3	betrüben, Betrübe
eigennützig	ADJA, ADJD	3	eigennütziges, eigennützige, eigennützig
Regung	NN	3	Regungen
Ungeheuer	NN	3	Ungeheuer
Höflichkeit	NN	3	Höflichkeit, Höflichkeiten
lehren	VVINF	3	lehren
nachdem	KOUS	3	Nachdem, nachdem
Zeile	NN	3	Zeilen
Gnade	NN	3	Gnade
Haupt	NN	3	Haupt
Engel	NN, NE	3	Engel
zurückkehren	VVINF	3	zurückkehren
unvermutet	ADJA	3	unvermutete, unvermuteter
Betrachtung	NN	3	Betrachtung, Betrachtungen
sterbend	ADJA	3	sterbenden, sterbendes, sterbende
Zweck	NN	3	Zweck, Zwecke
überzeugt	ADJD	3	überzeugt, überzeugter
Waffe	NN	3	Waffen
schätzen	VVINF	3	schätzen
leisten	VVFIN, VVINF	3	leistet, leisten
Exempel	NN	3	Exempel
Vermächtnis	NN	3	Vermächtnis
empfindlich	ADJA, ADJD	3	empfindlichste, empfindliche, empfindlich
richtig	ADJD	3	richtig, Richtig, richtigsten
übel	ADJD	3	übel
Rest	NN	3	Rest
begleiten	VVINF, VVPP	3	begleiten, begleitet
Kleinigkeit	NN	3	Kleinigkeit, Kleinigkeiten
Körper	NN	3	Körper
heben	VVFIN, VVPP	3	Hebt, gehoben, hebt
Bekanntschaft	NN	3	Bekanntschaft
vernichten	VVINF	3	vernichten
Ton	NN	3	Ton, Tone
Teufel	NN	3	Teufel
äußer	ADJA	3	äußerstes, äußersten
Ader	NN	3	Ader, Adern
zurückholen	VVINF	3	zurückholen
Recht	NN	3	Recht
teils	ADV	3	teils
bestimmen	VVPP, VVINF	3	bestimmt, bestimmen
vermag	VVFIN	3	vermag
treulos	ADJA, ADJD	3	treuloser, treulos, treulose
irren	VVFIN	3	irrte, irren, irrst
Schranke	NN	3	Schranken
Unrecht	NN	3	Unrecht
überlassen	VVPP, VVINF	3	überlassen
Achtung	NN	3	Achtung
Undank	NN	3	Undank
Träne	NN	3	Träne
Schöpfer	NN	3	Schöpfer
aussetzen	VVINF, VVIZU, VVPP	3	aussetzen, auszusetzen, ausgesetzt
Zukunft	NN	3	Zukunft
Unruhe	NN	3	Unruhe
verwandeln	VVINF, VVFIN	3	verwandeln
vergehen	VVFIN, VVINF	3	vergeht, vergehen
Irrtum	NN	3	Irrtum
richten	VVFIN, VVINF	3	richten
Gegenwart	NN	3	Gegenwart
beleidiget	VVFIN	3	beleidiget
Betrieger	NN	3	Betrieger
stellen	VVFIN, VVINF	3	stelle, stellen, stellte
gelingen	VVFIN, VVPP	3	gelingt, gelungen
Kummer	NE, NN	3	Kummer, Kummers
voll	ADJD	3	voll
Bote	NN	3	Bote
acht	CARD	3	acht
daraus	PAV	3	daraus
menschlich	ADJA	3	menschlichen, menschliche
gewähren	VVINF, VVFIN	3	gewähren
willen	APPO	3	Willen, willen
sichern	VVFIN, VVPP, VVINF	3	sichert, gesichert, sichern
Abwesenheit	NN	3	Abwesenheit
Ruhe	NN	3	Ruhe
Stimme	NN	3	Stimme
anhören	VVIZU, VVFIN, VVINF	3	anzuhören, anhöre, anhören
verdanken	VVINF	3	verdanken
gütig	ADJD	3	gütiger, gütig
Ort	NN	3	Ort, Orte
Seufzer	NN	3	Seufzern, Seufzer
Marter|Martern	NN	3	Martern
Veränderung	NN	3	Veränderung
Verstand	NN	3	Verstandes, Verstand
tief	ADJA, ADJD	3	tiefen, tief, tiefer
ausdrücken	VVINF, VVFIN	3	ausdrücken, ausdrücke
erstaunen	VVFIN, VVINF	3	erstaune, erstaunen
Vaterland	NN	3	Vaterlande, Vaterland
Arzt	NN	3	Ärzte
Zunge	NN	3	Zunge
gewaltsam	ADJA	3	gewaltsamen
schämen	VVINF, VVFIN	3	schämen, schämte
heilig	ADJA, ADJD	3	heilige, heilig
Verwünschung	NN	3	Verwünschungen
wodurch	PWAV	3	Wodurch
dünken	VVPP, VVINF, VVFIN	3	dünkt, dünken, deucht
aufrichtig	ADJA, ADJD	3	aufrichtiges, aufrichtig
Zuflucht	NN	3	Zuflucht
Wohnung	NN	3	Wohnung
Zeremonie	NN	3	Zeremonie
gefallen	VVINF	3	gefallen
bessern	VVFIN	3	bessern
Schatten	NN	3	Schatten
Harte	NN	3	Hartes
Untreue	NN	3	Untreue
untröstlich	ADJD	3	untröstlich
Wahrheit	NN	3	Wahrheit, Wahrheiten
heimlich	ADJD, ADJA	3	heimlich, heimlicher
Anmut	NN	3	Anmut
Verwirrung	NN	3	Verwirrung
hierauf	PAV	3	Hierauf, hierauf
Unbäßlichkeit	NN	3	Unbäßlichkeit
bewundern	VVPP, VVINF	3	bewundert, bewundern
verfluchen	VVFIN	3	Verfluche, verfluche, verfluchen
Bösewicht	NN	3	Bösewicht
Weibsbild	NN	3	Weibsbildern, Weibsbilder, Weibsbild
Lieset	NN	3	Lieset
martern	VVFIN	3	marterten, Martern
unterbrechen	VVFIN	3	unterbricht
beschließen	VVFIN, VVPP, VVINF	3	beschließen, beschlossen
denken|gedenken	VVPP	3	gedacht
betäuben	VVINF, VVPP	3	betäuben, betäubt
eins	CARD	3	eins, einer
geheim	ADJD, ADJA	3	geheim, geheimste
Pein	NN	3	Pein
melden	VVINF, VVFIN	3	melden, Melden
seit	APPR	3	seit
vorsätzlich	ADJA	3	vorsätzliche, vorsätzlichen
versagen	VVINF, VVFIN	3	versagen, versagte
ungeachtet	APPO	3	ungeachtet
Zurückkunft	NN	2	Zurückkunft
nieder	ADJD, PTKVZ	2	nieder
neun	CARD	2	neun
nichtswürdigsten	ADJA	2	nichtswürdigsten
vertraut	ADJD, ADJA	2	vertraut, vertrauteste
recht|rechts	ADJA	2	rechten
Umgang	NN	2	Umgang, Umgangs
frühsten	ADJA	2	frühsten
schöpfen	VVINF	2	schöpfen
verfolgen	VVPP, VVINF	2	verfolgt, verfolgen
zuletzt	ADV	2	zuletzt
nachdenken	VVPP, VVIZU	2	nachgedacht, nachzudenken
verkennen	VVPP, VVFIN	2	verkannt, verkennen
ungefähr	ADJD	2	ungefähr
Mangel	NN	2	Mangel, Mangels
himmlisch	ADJA	2	Himmlische, himmlische
reichen	VVFIN	2	reichen, Reiche
Gefälligkeit	NN	2	Gefälligkeiten
nichtswürdig	ADJA	2	nichtswürdigen, nichtswürdige
Szene	NN	2	Szene
verschwenden	VVINF, VVPP	2	verschwenden, verschwendet
wollüstige	ADJA	2	wollüstige
hintergehen	VVINF	2	hintergehen
nachteilig	ADJA	2	nachteilige, nachteiligen
eng	ADJA	2	enge, engen
erstemal	ADV	2	erstemal
Aufrichtigkeit	NN	2	Aufrichtigkeit
anklagen	VVFIN, VVIZU	2	anklagt, anzuklagen
Stunde	NN	2	Stunde
Monat	NN	2	Monat
Gestalt	NN	2	Gestalt
abspenstig	ADJD	2	abspenstig
Ziel	NN	2	Ziel, Ziele
entreißen	VVFIN	2	entreißen, Entreißen
gerächet	VVPP, ADJD	2	gerächet
abziehen	VVIZU, VVINF	2	abzuziehen, abziehen
verleiten	VVINF, VVPP	2	verleiten, verleitet
schluchzend	ADJD	2	Schluchzend
müßig	ADJD	2	müßig
anzeigen	VVPP, VVINF	2	angezeigt, anzeigen
vorbereiten	VVINF, VVPP	2	vorbereiten, vorbereitet
zubringen	VVINF	2	zubringen
geliebet	VVPP	2	geliebet
raten	VVFIN	2	Raten, raten
Ahnung	NN	2	Ahnungen
vorziehen	VVINF, VVPP	2	vorziehen, vorgezogen
zaudern	VVFIN, VVPP	2	zaudern, gezaudert
Mellefonts	NN	2	Mellefonts
besuchen	VVFIN, VVINF	2	besuchte, besuchen
Vernunft	NN	2	Vernunft
dasjenige	PDS	2	dasjenige
unterlassen	VVINF, VVPP	2	unterlassen
Fehltritt	NN	2	Fehltritt
verweilen	VVINF	2	verweilen
Verführung	NN	2	Verführung
Papier	NN	2	Papier
Schlag	NN	2	Schläge
Bestreben	NN	2	Bestreben
überschreiten	VVPP, VVINF	2	überschritten, überschreiten
segnen	VVFIN	2	Segne, segne
Verfinsterung	NN	2	Verfinsterung
vielmehr	ADV	2	vielmehr
aufsuchen	VVIZU	2	aufzusuchen
schimpflich	ADJA	2	schimpflichen
Ungetreuen	NN	2	Ungetreuen
hiesig	ADJA	2	hiesigen
bekannt	ADJA, ADJD	2	bekannten, bekannt
argwohnen	ADJD, VVINF	2	argwohnen
Lassen	NN	2	Lassen
Lasterhafte	NN	2	Lasterhafte
Verachtung	NN	2	Verachtung
Brust	NN	2	Brust
Wendung	NN	2	Wendung
Kunstgriff	NN	2	Kunstgriffen, Kunstgriffe
entzweien	VVINF	2	entzweien
Wange	NN	2	Wange
Handlung	NN	2	Handlung
Sieg	NN	2	Sieg
vernünftig	ADJA, ADJD	2	vernünftige, vernünftig
ankleiden	VVINF	2	ankleiden
Reichtum	NN	2	Reichtümer
Schlaf	NN	2	Schlaf, Schlafe
Faust	NN	2	Faust
anrechnen	VVINF	2	anrechnen
brennen	VVINF	2	brennen
trocknen	VVFIN	2	Trocknen, trocknet
gewinnen	VVFIN	2	gewann, gewinne
weise	ADJA	2	weises, weisere
lebhaft	ADJD, ADJA	2	lebhaft, lebhaftesten
Annäherung	NN	2	Annäherungen
beunruhigen	VVFIN, VVINF	2	beunruhige, beunruhigen
hierher	PAV, PTKVZ	2	hierher
Arm	NN	2	Arm
bereit	ADJD	2	bereit
entbrechen	VVINF, NN	2	entbrechen
mehrern	NN, ADJA	2	mehrern
mehrere	PIS	2	mehrere
weiblich	ADJA	2	weiblichen
vertraulich	ADJD, ADJA	2	vertraulich, vertrauliche
abgematteten	ADJA	2	abgematteten
Nachsicht	NN	2	Nachsicht
stecken	VVINF, VVFIN	2	stecken, steckt
fern	ADJD	2	ferner, fern
unterliegen	VVINF	2	unterliegen
Unschuld	NN	2	Unschuld
leiden	VVPP, VVINF	2	gelitten, leiden
Beschützer	NN	2	Beschützer
gemach	ADV	2	gemach
dritt	ADJA	2	dritten, dritte
unwert	ADJD	2	unwert
Marwoods	NE	2	Marwoods
Glosse	NN	2	Glossen, Glosse
scharf	ADJD	2	scharf
Phantasie	NN	2	Phantasie
quälen	VVINF, VVFIN	2	quälen
entzücken	VVFIN	2	entzücken, entzückt
zeihen|ziehen	VVFIN	2	zieht
Grausamkeit	NN	2	Grausamkeit
schmerzlich	ADJD	2	schmerzlich, schmerzlicher
Versprechen	NN	2	Versprechen, Versprechens
streng	ADJA	2	strengste
Rank	NN	2	Ränke
zuvorkommen	VVINF, VVPP	2	zuvorkommen, zuvorgekommen
verschmähen	VVFIN	2	verschmähet, verschmäht
ehrlich	ADJA	2	ehrlicher
Falschheit	NN	2	Falschheit
Unschuldige	NN	2	Unschuldige, Unschuldigen
Preis	NN	2	Preis
Grausame	NN	2	Grausame, Grausamen
bezeigen	VVFIN, VVINF	2	bezeigte, bezeigen
Feld	NN	2	Feld
herab	ADV, PTKVZ	2	herab
Unterschied	NN	2	Unterschied
plump	ADJA, ADJD	2	plumpe, plump
entfernet	VVFIN	2	entfernet
Glaube	NN	2	Glauben, Glaube
verborgen	ADJA	2	verborgensten
Verdacht	NN	2	Verdacht
töten	VVINF, VVFIN	2	töten
Gesellschaft	NN	2	Gesellschaft
geb	VVFIN, NE	2	geb
Unwissenheit	NN	2	Unwissenheit
Stärke	NN	2	Stärke
drohen	VVFIN	2	drohten, drohen
wiedergeben	VVINF	2	wiedergeben
erwerben	VVINF	2	erwerben
ergreifen	VVINF, VVFIN	2	ergreifen
kindlich	ADJA	2	kindlichen, kindliche
Wesen	NN	2	Wesen
Licht	NN	2	Lichte, Lichtes
ihrige	PPOSAT	2	Ihrige
Frechheit	NN	2	Frechheit
Anstalt	NN	2	Anstalt
völlig	ADJA	2	völlige
doppeln	VVPP	2	gedoppelt
ähnlich	ADJA	2	ähnlichen
Verbindlichkeit	NN	2	Verbindlichkeit, Verbindlichkeiten
beben	VVFIN	2	bebe
Feuer	NN	2	Feuer
fordern	VVFIN	2	Fordern, fordern
Kurz	NE	2	Kurz
Möglichkeit	NN	2	Möglichkeit
Bekenntnis	NN	2	Bekenntnis, Bekenntnisse
bestehen	VVFIN, PTKVZ	2	bestehen
vertrauen	VVINF	2	vertrauen
vornehm	ADJA	2	vornehmsten, vornehmen
Überlegenheit	NN	2	Überlegenheit
Hals	NN	2	Hals
fertig	ADJD	2	fertig
zutrauen	VVFIN, VVINF	2	zutrauten, zutrauen
Furcht	NN	2	Furcht
Redlichkeit	NN	2	Redlichkeit
betriegt	VVFIN	2	betriegt
Fessel|Fesseln	NN	2	Fesseln
Trennung	NN	2	Trennung
Bereitwilligkeit	NN	2	Bereitwilligkeit
tötender	ADJA	2	tötender
Umarmung	NN	2	Umarmungen
erzürnen	VVPP	2	erzürnt
Rückkehr	NN	2	Rückkehr
wütend	ADJD	2	wütend
behutsam	ADJD, ADJA	2	behutsam, behutsamste
abstatten	VVINF	2	abstatten
Frucht	NN	2	Früchte
Anspruch	NN	2	Anspruch, Ansprüche
ehrfurchtsvoll	ADJA	2	ehrfurchtsvolle
Werk	NN	2	Werke, Werk
anbelangen	VVPP	2	anbelangt
Glücke	NN	2	Glücke
besorgt	ADJD	2	besorgt
verdammen	VVFIN, VVINF	2	verdammt, verdammen
Grobheit	NN	2	Grobheiten
eitel	ADJD	2	eitel
Eigensinn	NN	2	Eigensinn
Gemahl	NN	2	Gemahls, Gemahl
schmachtend	ADJA	2	schmachtenden
gerührt	ADJA, ADJD	2	gerührten, gerührt
vergrößern	VVINF, VVFIN	2	vergrößern, vergrößerten
Vatermörderin	NN	2	Vatermörderin
erwachen	VVFIN, VVINF	2	erwachte, erwachen
beredt	ADJA, ADJD	2	beredte, beredt
Verschulden	NN	2	Verschulden
Verteidigung	NN	2	Verteidigung
siegen	VVPP, VVINF	2	gesiegt, siegen
öffentlich	ADJA	2	öffentliche
seufzet	VVFIN	2	seufzet
Ankunft	NN	2	Ankunft
Abend	NN	2	Abend, Abende
dasmal	ADV	2	dasmal
bereden	VVINF	2	bereden
begegnen	VVINF	2	begegnen
Ausgang	NN	2	Ausgang
Gebieterin	NN	2	Gebieterin
hieher	NN	2	hieher
anständig	ADJA	2	anständiger, anständigen
schwankend	ADJA	2	schwankenden, schwankendes
unangenehm	ADJA	2	unangenehme
befreien	VVINF	2	befreien
Eile	NN	2	Eile
verschieden	ADJA	2	verschiedenen
diejenigen	PDAT, PDS	2	diejenigen
Meinung	NN	2	Meinung
rühmen	VVFIN, VVINF	2	rühme, rühmen
teilhaft	ADJD	2	teilhaft
Beruhigung	NN	2	Beruhigung
rechnen	VVINF, VVFIN	2	rechnen, Rechne
widerstehen	VVINF, VVPP	2	widerstehen, widerstanden
ängstlich	ADJA	2	ängstlichen, ängstliches
sobald	KOUS	2	sobald
getrost	ADV	2	getrost
fußfällig	ADJD	2	fußfällig
eigentlich	ADV	2	eigentlich, Eigentlich
schleifen	VVPP	2	geschliffen
Verdruss	NN	2	Verdruß
heftig	ADJA, ADJD	2	heftigsten, heftig
Eltern	NN	2	Eltern
Stille	NN	2	Stille
Stunde|Stunden	NN	2	Stunden
Vorzug	NN	2	Vorzüge
Heilige	NN	2	Heilige
tödlich	ADJA	2	tödlicher, tödliche
Salz	NN	2	Salz
Unvorsichtigkeit	NN	2	Unvorsichtigkeit
Reise	NN	2	Reise
einfältig	ADJA	2	einfältiger, einfältigen
Schreck	NN	2	Schreck
hervor	PTKVZ, ADV	2	hervor
unterstehen	VVINF, VVPP	2	unterstehen, unterstanden
Liebhaber	NN	2	Liebhabers, Liebhaber
Verzeihung	NN	2	Verzeihung
fehl	PTKVZ	2	fehl
hinaus	ADV, PTKVZ	2	hinaus
Türe	NN	2	Türe
meist	PIAT	2	meiste
Tor	NN	2	Toren, Tor
nachkommen	VVPP, VVFIN	2	nachgekommen, nachkomme
wehmütig	ADJA	2	wehmütiger, wehmütiges
taub	ADJD	2	taub
ablegen	VVIZU, VVFIN	2	abzulegen, ablegten
Schuldigkeit	NN	2	Schuldigkeit
reuende	ADJA	2	reuende
Grille	NN	2	Grille
trösten	VVINF, VVFIN	2	trösten, Tröste
angehen	VVFIN	2	angeht
Erde	NN	2	Erde
Nerv	NN	2	Nerve
warnend	ADJD, ADJA	2	Warnend, warnender
schallen	VVFIN	2	schallt
kräftig	ADJD	2	kräftiger, kräftig
Geschehene	NN	2	Geschehene, Geschehenen
närrisch	ADJD, ADJA	2	närrisch, närrische
verehren	VVFIN, VVINF	2	verehre, verehren
Verleumdung	NN	2	Verleumdungen, Verleumdung
Hölle	NN	2	Hölle
ernsthaft	ADJD	2	ernsthaft
hart	ADJD	2	hart
Betrug	NN	2	Betrug
aufbringen	VVPP, VVIZU	2	aufgebracht, aufzubringen
sehnen	VVIMP, VVFIN	2	sehn, sehne
Mittel	NN	2	Mittel
Bedingung	NN	2	Bedingung
überall	ADV	2	überall
Vergehungen	NN	2	Vergehungen
übereilt	ADJA	2	übereilte, Übereilte
Erfahrung	NN	2	Erfahrung
Vorwande	NN	2	Vorwande
Sterbende	NN	2	Sterbende, Sterbenden
zerreißen	VVINF, VVFIN	2	zerreißen, Zerreißt
erbarmen	VVFIN, VVPP	2	Erbarmen, erbarmt
küssen	VVINF	2	küssen
Großmut	NN	2	Großmut
finster	ADJA	2	finsterer, finstere
zeitlich	ADJA	2	zeitliche
Notwendigkeit	NN	2	Notwendigkeit
beruhigen	VVINF, VVFIN	2	beruhigen
allerlieb	ADJD	2	Allerliebst, allerliebst
Furie	NN	2	Furie
arg	ADJD	2	arg, ärger
stumm	ADJA	2	stummen, stumme
Nichtswürdigen	NN	2	Nichtswürdigen
Reich|Reiche	NN	2	Reiche
ernstlich	ADJD	2	ernstlich
Nein	NN	2	Nein
stürzen	VVPP, VVINF	2	gestürzt, stürzen
Lüge	NN	2	Lüge
Schlimmste	NN	2	Schlimmste
erraten	VVFIN, VVINF	2	errieten, erraten
verwundern	VVINF	2	verwundern
nachgebracht	VVPP	2	nachgebracht
beleidigen	VVINF	2	beleidigen
Unterredung	NN	2	Unterredung
fließen	VVFIN	2	floß, fließen
gehören|hören	VVPP	2	gehört
urteilen	VVINF	2	urteilen
Übereilung	NN	2	Übereilung
bedachen|bedenken	VVPP	2	bedacht
andermal	ADV	2	andermal
unendlich	ADJD	2	unendlich
bemerken	VVINF, VVFIN	2	bemerken, bemerkte
ungewiss	ADJD, ADJA	2	ungewiß, ungewisser
stärken	VVFIN, VVINF	2	stärkte, stärken
reizend	ADJA, ADJD	2	reizenden, reizend
fesseln	VVINF, VVPP	2	fesseln, gefesselt
verändern	VVPP, VVFIN	2	verändert, verändern
Weibchen	NN	2	Weibchen
nichtig	ADJA	2	nichtigen, Nichtige
Heftigkeit	NN	2	Heftigkeit
schonen	VVFIN, VVINF	2	schonen
umfassen	VVFIN, VVINF	2	umfassen
ungestüm	ADJA	2	ungestüme, ungestümen
Bild	NN	2	Bilder
Arzenei	NN	2	Arzenei
hitzig	ADJA, ADJD	2	hitziges, hitzig
Gefallen	NN	2	Gefallen
versüßen	VVINF, VVPP	2	versüßen, versüßt
argwöhnen	VVINF, VVFIN	2	argwöhnen, argwöhnten
verderben	VVINF, VVFIN	2	verderben, verderbt
durchstoßen	VVINF	2	durchstoßen
besonders	ADV	2	besonders, Besonders
Feind	NN	2	Feind, Feinde
Fügung	NN	2	Fügungen
toben	VVINF, VVFIN	2	toben, tobt
nachdenkend	ADJD	2	nachdenkend, Nachdenkend
Stuhl	NN	2	Stuhl, Stuhle
Mal	NN	2	Male, Mal
dringen	VVFIN, VVPP	2	dringt, gedrungen
argwöhnisch	ADJD	2	argwöhnisch
holen	VVFIN, VVINF	2	holte, holen
unverzüglich	ADJD	2	unverzüglich
ausstehen	VVINF, VVPP	2	ausstehen, ausgestanden
wiederkommen	VVINF	2	wiederkommen
dagegen	PAV	2	dagegen
Familie	NN	2	Familie
Nebenbuhlerin	NN	2	Nebenbuhlerin
Kunst	NN	2	Kunst, Künste
begnügen	VVFIN	2	Begnügen
Pflicht	NN	2	Pflichten
Summe|Summen	NN	2	Summen
Vorsatz	NN	2	Vorsatz
erzeigt	VVFIN	2	erzeigt
Wunsch	NN	2	Wunsch, Wünschen
ergeben	VVPP, VVFIN	2	ergeben, ergab
sehnlich	ADJD, ADJA	2	sehnlich, sehnlichsten
Fleck	NN	2	Fleck
willkommen	ADJD	2	Willkommen, willkommen
entgehen	VVINF	2	entgehen
verwickeln	VVINF	2	verwickeln
verschonen	VVINF	2	verschonen
Gut	NN	2	Güter
Jammer	NN	2	Jammer
liebenswürdig	ADJD, ADJA	2	liebenswürdig, liebenswürdigsten
vergnügen	VVFIN, VVPP	2	vergnügt
zeitig	ADJD	2	zeitig
hindern	VVFIN	2	hindert
rechtschaffnen	ADJA	2	rechtschaffnen
Opfer	NN	2	Opfer
Stachel	NN	2	Stachel
Vertraulichkeit	NN	2	Vertraulichkeit
hoch	ADJA	2	höchste
Sinn	NN	2	Sinn
zehn	CARD	2	zehn
Strahl	NN	2	Strahl
zurücklassen	VVFIN, VVINF	2	zurückläßt, zurücklassen
Flecken	NN	2	Flecken
unbekannt	ADJA	2	unbekanntes, unbekannten
Vergehen	NN	2	Vergehen
Feder	NN	2	Feder
eifersüchtig	ADJD	2	eifersüchtig
Beispiel	NN	2	Beispiele
Blick|Blicken	NN	2	Blicken
bekennen	VVFIN, VVPP	2	bekennen, bekannt
Übel	NN	2	übeln, Übel
derjenige	PDS	2	demjenigen, desjenigen
geraten	VVINF, VVFIN	2	geraten
auslassen	VVINF	2	auslassen
forschen	VVINF, VVFIN	2	forschen, forsche
los	PTKVZ, ADJD	2	los
dasjenig	PDAT	2	dasjenige
Ewigkeit	NN	2	Ewigkeit
störest	VVFIN	2	störest
gelten	VVFIN, VVINF	2	galt, gelten
überdrüssig	ADJD	2	überdrüssig
Irrtume	NN	2	Irrtume
Umgange	NN	2	Umgange
Rede	NN	2	Rede
ungeduldig	ADJA, ADJD	2	ungeduldige, ungeduldig
Ausschweifung	NN	2	Ausschweifungen
Gefangene	NN	2	Gefangener
wegnehmen	VVPP, VVFIN	2	weggenommen, wegnimmt
jemand	PIS	2	jemanden, jemand
aushalten	VVINF	2	aushalten
erwecken	VVINF	2	erwecken
Pöbel	NN	2	Pöbel
Umfang	NN	2	Umfang
gewürdiget	VVFIN, VVPP	2	gewürdiget
wichtig	ADJA, ADJD	2	wichtigsten, wichtiger
Entschluss	NN	2	Entschluß
schleichen	VVFIN, VVPP	2	schleicht, geschlichen
zerrüttet	ADJA	2	zerrüttete, zerrütteten
verhindern	VVPP, VVFIN	2	verhindert, verhinderte
Gesetz	NN	2	Gesetze
Stütze	NN	2	Stütze
aufgebracht	ADJA	2	aufgebrachter, aufgebrachten
besinnen	VVFIN, VVINF	2	Besinnen, besinnen
ah	ITJ	2	Ah
wegbegeben	VVINF, VVFIN	2	wegbegeben
Entfernung	NN	2	Entfernung
unmenschlich	ADJA	2	unmenschliche
Rechtfertigung	NN	2	Rechtfertigung
Hochachtung	NN	2	Hochachtung
verlernen	VVFIN, VVPP	2	verlernen, verlernt
Unsinn	NN	2	Unsinn
Standhaftigkeit	NN	2	Standhaftigkeit
worauf	PWAV	2	worauf
neunt	ADJA	2	neunte
vorschlagen	VVINF, VVIZU	2	vorschlagen, vorzuschlagen
verhärten	VVINF	2	verhärten
verhärtet	ADJA	2	verhärteten, verhärtete
ersuchen	VVPP, VVFIN	2	ersucht, ersuche
womit	PWAV	2	womit, Womit
Sampsons	NN	2	Sampsons
Vermutung	NN	2	Vermutung
genau	ADJD	2	genauer, genau
vermissen	VVPP, VVINF	2	vermißt, vermissen
Jugend	NN	2	Jugend
neidisch	ADJA, ADJD	2	neidische, neidisch
betauern	NN, VVINF	2	betauern
hiervon	PAV	2	hiervon
Vertrauen	NN	2	Vertrauen
benehmen	VVINF, VVPP	2	benehmen, benommen
Geschöpf	NN	2	Geschöpf, Geschöpfe
Ihrigen	NN	2	Ihrigen
barmherzig	ADJA	2	barmherzige, barmherzigen
Reihe	NN	2	Reihe
Lust	NN	2	Lust
Überschlag	NN	1	Überschlag
öfter	ADV	1	öfter
dern	VVINF	1	dern
auspreßten	VVFIN	1	auspreßten
Ehe	NN	1	Ehe
beobachten	VVINF	1	beobachten
gesteh	VVFIN	1	gesteh
verrucht	ADJA	1	verruchte
niedersetzen	VVINF	1	niedersetzen
bemächtiget	VVFIN	1	bemächtiget
entstehend	ADJA	1	entstehenden
schwärmen	VVFIN	1	schwärmten
gänzlich	ADJD	1	gänzlich
niederträchtig	ADJA	1	niederträchtige
Charakter	NN	1	Charakter
zukömmt	VVFIN	1	zukömmt
überlästig	ADJD	1	überlästig
niederzufallen	VVFIN	1	niederzufallen
Abgeschickter	NN	1	Abgeschickter
pflegen	VVFIN	1	pflege
ungeneigt	ADJD	1	ungeneigt
Richter	NN	1	Richters
abfertigen	VVIZU	1	abzufertigen
wahrhaftig	ADJD	1	wahrhaftig
Mitternacht	NN	1	Mitternacht
wiederschenkte	VVFIN	1	wiederschenkte
versäumen	VVINF	1	versäumen
tändelnde	ADJA	1	tändelnde
durchbohren	VVINF	1	durchbohren
beraubet	VVFIN	1	beraubet
entwaffnen	VVINF	1	entwaffnen
Flattergeist	NN	1	Flattergeist
Anstößige	NN	1	Anstößige
Kindheit	NN	1	Kindheit
Dankbarkeit	NN	1	Dankbarkeit
aufstehen	VVINF	1	aufstehen
verwahren	VVFIN	1	verwahren
Überfluss	NN	1	Überfluß
bezahlen	VVPP	1	bezahlt
drei	CARD	1	drei
angeloben	VVFIN	1	angeloben
freundschaftlich	ADJA	1	freundschaftlichsten
wahrlich	ADV	1	Wahrlich
Drückungen	NN	1	Drückungen
anstatt	KOUI	1	anstatt
Fülle	NN	1	Fülle
Felsen	NN	1	Felsen
unerkannt	ADJD	1	unerkannt
Offenherzig	NN	1	Offenherzig
unleidlich	ADJD	1	unleidlich
vergleichen	VVPP	1	verglichen
Satan	NN	1	Satan
verurteilt	ADJA	1	verurteilter
drauf	PAV	1	drauf
Mittel|Mitteln	NN	1	Mitteln
Erziehung	NN	1	Erziehung
vermögen	VVINF	1	vermögen
sterb	VVFIN	1	sterb
voraussagen	VVINF	1	voraussagen
Vorbeigehn	NN	1	Vorbeigehn
unbedächtiges	ADJA	1	unbedächtiges
gährende	ADJA	1	gährende
Verleumderin	NN	1	Verleumderin
bewusst	ADJD	1	bewußt
giftig	ADJA	1	giftige
Menschliche	NN	1	Menschliche
hold	ADJA	1	holde
Erstarren	NN	1	Erstarren
aufbrechen	VVINF	1	aufbrechen
Geschäft	NN	1	Geschäfte
erwünscht	ADJD	1	erwünscht
zielet	ADJD	1	zielet
donnre	VVFIN	1	donnre
Übertretung	NN	1	Übertretungen
Vorbereitung	NN	1	Vorbereitung
unterhalten	VVINF	1	unterhalten
satt	ADJD	1	satt
sinnlos	ADJA	1	sinnlosen
vergeb	VVFIN	1	vergeb
Neugierde	NN	1	Neugierde
Greis	NN	1	Greise
Abfoderung	NN	1	Abfoderung
überhaupt	ADV	1	überhaupt
Händeringen	NN	1	Händeringen
übersehend	ADJA	1	übersehenden
Fieber	NN	1	Fieber
gleitete	VVFIN	1	gleitete
hüten	VVINF	1	hüten
Reiz|Reizen	NN	1	Reizen
wegkommen	VVINF	1	wegkommen
Winkel	NN	1	Winkel
hoffnungslos	ADJA	1	hoffnungslose
schneiden	VVINF	1	schneiden
Glückliche	NN	1	Glückliche
Frage	NN	1	Frage
ehrlosen	ADJA	1	ehrlosen
erblaßt	ADJA	1	erblaßte
zittre	ADJD	1	zittre
beklagen	VVINF	1	beklagen
Anverwandter	ADJA	1	Anverwandter
schreckhaftes	ADJA	1	schreckhaftes
beklaget	VVFIN	1	beklaget
Antrag	NN	1	Antrag
berühren	VVINF	1	berühren
Achselzucken	NN	1	Achselzucken
erwähnen	VVFIN	1	erwähnte
zucken	VVFIN	1	zuckte
klingen	VVFIN	1	klang
Edlern	NN	1	Edlern
zweideutig	ADJA	1	zweideutiges
einnehmen	VVPP	1	eingenommen
Desto	NN	1	Desto
Unterhaltung	NN	1	Unterhaltung
geistlich	ADJD	1	geistlich
wahrscheinlich	ADJA	1	wahrscheinlicher
anfangs	ADV	1	Anfangs
Stirne	NN	1	Stirne
stutzig	ADJD	1	stutzig
abwehren	VVIZU	1	abzuwehren
unternehmen	VVPP	1	unternommen
beladen	VVPP	1	beladen
Anbetern	NN	1	Anbetern
unterscheiden	VVFIN	1	unterscheiden
unheilig	ADJA	1	unheilige
Richtschnur	NN	1	Richtschnur
verlierest	VVFIN	1	verlierest
kömmst	VVFIN	1	kömmst
Ernste	NN	1	Ernste
irdisch	ADJA	1	irdische
unempfindlich	ADJD	1	Unempfindlich
Schuldige	NN	1	Schuldigen
mürrisch	ADJD	1	mürrisch
ungeheuer	ADJD	1	Ungeheuer
vorgehen	VVPP	1	vorgegangen
beschäftigt	ADJA	1	beschäftigten
Dasein	NN	1	Daseins
verbannen	VVINF	1	verbannen
versteckt	ADJA	1	versteckten
tod	ADJD	1	tod
Wette	NN	1	Wette
erreichen	VVFIN	1	erreichten
unterschiedenes	ADJA	1	unterschiedenes
Zuckung	NN	1	Zuckungen
Gegenliebe	NN	1	Gegenliebe
albern	ADJA	1	albernes
bedanken	VVFIN	1	bedanke
See	NN	1	See
Feier	NN	1	Feier
Gang	NN	1	Gang
unverfolgt	ADJD	1	unverfolgt
leihen	VVFIN	1	leihen
Berührung	NN	1	Berührung
nachfolgen	VVINF	1	nachfolgen
unsträflicher	ADJA	1	unsträflicher
künftig	ADJA	1	künftiges
hingehen	VVINF	1	hingehen
Anschlag	NN	1	Anschläge
ausschicken	VVPP	1	ausgeschickt
ansteckend	ADJA	1	ansteckende
auslernen	VVPP	1	ausgelernt
vergrößre	VVFIN	1	vergrößre
lächeln	VVINF	1	lächeln
Sicherheit	NN	1	Sicherheit
Vermählung	NN	1	Vermählung
Räuber	NN	1	Räuber
schlüpfrigsten	ADJA	1	schlüpfrigsten
Prozess	NN	1	Prozeß
Wand	NN	1	Wand
Weigern	NN	1	Weigern
schleunig	ADJA	1	schleunige
Mutterteil	NN	1	Mutterteil
Himmlische	NN	1	Himmlisches
mitten	ADV	1	Mitten
Ihrentwegen	NN	1	Ihrentwegen
Mache	NN	1	Mache
ausgeben	VVINF	1	ausgeben
einschiffen	VVPP	1	eingeschifft
Törichte	NN	1	Törichte
sies	VVFIN	1	sies
Knie	NE	1	Knie
Schrecklichkeit	NN	1	Schrecklichkeit
Erbteile	NN	1	Erbteile
verirrt	ADJA	1	verirrten
Neubegierde	NN	1	Neubegierde
Aufruhr	NN	1	Aufruhr
Giftpulver	NN	1	Giftpulver
verteidiget	VVFIN	1	verteidiget
Sanftmut	NN	1	Sanftmut
Todbette	NN	1	Todbette
Betauern	NN	1	Betauern
rechtschaffen	ADJD	1	rechtschaffen
Aas	NN	1	Aas
Höherm	NN	1	Höherm
Augenlid	NN	1	Augenlidern
Betäubung	NN	1	Betäubung
ungültig	ADJA	1	ungültiger
sinken	VVFIN	1	sank
Wein|Weinen	NN	1	Weinen
schroffsten	ADJA	1	schroffsten
blicken	VVFIN	1	blicken
Bedeutung	NN	1	Bedeutung
beschimpfen	VVPP	1	beschimpft
ertappen	VVINF	1	ertappen
plagen	VVINF	1	plagen
Ruf	NN	1	Ruf
Ehrgeiz	NN	1	Ehrgeiz
rufen	VVFIN	1	riefen
Geschicklichkeit	NN	1	Geschicklichkeit
durchdringen	VVPP	1	durchdrungen
rollen	VVFIN	1	rollen
Aufschrift	NN	1	Aufschrift
parteiisch	ADJD	1	parteiisch
erquickend	ADJA	1	erquickende
hätt	VVFIN	1	hätt
Hütte	NN	1	Hütte
zueilen	VVINF	1	zueilen
verzerren	VVINF	1	verzerren
vermache	VVFIN	1	vermache
untersagen	VVINF	1	untersagen
Stoß	NN	1	Stoß
ungesäumt	ADJD	1	ungesäumt
erleben	VVFIN	1	erlebe
Vergleichung	NN	1	Vergleichung
Vertraute	NN	1	Vertraute
Überzeugung	NN	1	Überzeugung
Herumführen	NN	1	Herumführen
Schweig	NE	1	Schweig
erstechen	VVFIN	1	ersticht
gültig	ADJD	1	gültig
belieben	VVFIN	1	beliebten
eingeschlossen	ADJD	1	eingeschlossen
blutig	ADJA	1	blutige
hülflose	ADJA	1	hülflose
freundlich	ADJA	1	freundliches
Aufmerksamkeit	NN	1	Aufmerksamkeit
ängstigen	VVINF	1	ängstigen
verflucht	ADJA	1	verfluchten
entfliehen	VVINF	1	entfliehen
Aufsicht	NN	1	Aufsicht
sittlich	ADJA	1	sittlichen
Vorurteil	NN	1	Vorurteilen
Verdienst	NN	1	Verdienst
Erlaubnis	NN	1	Erlaubnis
Fall|Fällen	NN	1	Fällen
Schwester	NN	1	Schwester
Führung	NN	1	Führung
Eroberung	NN	1	Eroberungen
Ferse	NN	1	Ferse
Verräterin	NN	1	Verräterin
verharret	NE	1	verharret
Scherz	NN	1	Scherze
Schweiß	NN	1	Schweiß
nachbrausen	VVFIN	1	nachbrausen
allzugern	NN	1	allzugern
zärtlichern	ADJA	1	zärtlichern
Trunkenheit	NN	1	Trunkenheit
geirret	ADJD	1	geirret
kürzern	NN	1	kürzern
gedrohet	VVFIN	1	gedrohet
abgeredeter	ADJA	1	abgeredeter
ankommen	VVINF	1	ankommen
weichen	VVINF	1	weichen
Ungewissheit	NN	1	Ungewißheit
gekommen	ADJD	1	gekommen
Vereinigung	NN	1	Vereinigung
betreffen	VVFIN	1	betrifft
Lehre|Lehren	NN	1	Lehren
Zukünftige	NN	1	Zukünftige
belohnen	VVINF	1	belohnen
Nutz	NN	1	Nutze
Streit	NN	1	Streit
Beweis	NN	1	Beweis
beunruhiget	VVFIN	1	beunruhiget
Ausweichung	NN	1	Ausweichung
aufspringen	VVFIN	1	aufspringt
leichtgläubig	ADJA	1	leichtgläubige
Flamme	NN	1	Flammen
billiget	VVFIN	1	billiget
Schwärmerin	NN	1	Schwärmerin
dankbar	ADJA	1	dankbare
Wink	NN	1	Winke
Bewunderung	NN	1	Bewunderung
Haufe	NN	1	Haufen
Verschwindung	NN	1	Verschwindung
Angesichte	NN	1	Angesichte
erschöpfen	VVPP	1	erschöpft
Besänftigung	NN	1	Besänftigung
Wind	NN	1	Wind
unzertrennlich	ADJD	1	unzertrennlich
Vogel	NN	1	Vogel
eingewurzelt	ADJA	1	eingewurzelte
schwarz	ADJA	1	schwarzen
verwünschet	ADJD	1	verwünschet
erzwungen	ADJA	1	erzwungene
stützen	VVFIN	1	stützte
Anstand	NN	1	Anstand
vollends	ADV	1	vollends
niedrig	ADJA	1	niedrige
Beschäftigung	NN	1	Beschäftigungen
sinnreich	ADJD	1	sinnreich
Liebkosung	NN	1	Liebkosungen
geweiht	ADJA	1	geweihten
hundertmal	ADV	1	hundertmal
He	NE	1	He
Palaste	NN	1	Palaste
Unparteilichkeit	NN	1	Unparteilichkeit
binden	VVINF	1	binden
Argwohn	NN	1	Argwohn
Gram	NN	1	Gram
Grad	NN	1	Grades
tyrannisieren	VVPP	1	tyrannisiert
Zeitlang	NE	1	Zeitlang
darunter	PAV	1	darunter
Faser	NN	1	Faser
Bankozettel	NN	1	Bankozettel
o	ADJA	1	o
seltner	ADJD	1	seltner
gründen	VVFIN	1	gründe
missbrauchen	VVINF	1	mißbrauchen
herbringen	VVPP	1	hergebracht
woran	PWAV	1	Woran
beneidenswürdigsten	ADJA	1	beneidenswürdigsten
Geschichte	NN	1	Geschichte
Billigkeit	NN	1	Billigkeit
Unmensch	NN	1	Unmenschen
strafend	ADJA	1	strafende
vorkommen	VVIZU	1	vorzukommen
Blüte	NN	1	Blüte
verbitten	VVFIN	1	verbitte
Morgenröte	NN	1	Morgenröte
unentbehrlich	ADJD	1	unentbehrlich
demütigen	VVINF	1	demütigen
mitbringen	VVPP	1	mitgebracht
erbrich	NN	1	erbrich
leider	ADV	1	leider
höllisch	ADJD	1	höllischer
Dunkle	NN	1	Dunkle
stürmisch	ADJA	1	stürmische
Geduld	NN	1	Geduld
unbiegsame	ADJA	1	unbiegsame
gemacht	ADJA	1	gemachten
Geständnis	NN	1	Geständnisse
lösen	VVINF	1	lösen
dringend	ADJA	1	dringendes
Betriegerin	NN	1	Betriegerin
umsiehst	VVFIN	1	umsiehst
entgegenrauschen	VVFIN	1	entgegenrauschen
ungernsten	ADJD	1	ungernsten
ungeschehen	ADJD	1	ungeschehen
Erbteil	NN	1	Erbteil
unbesonnen	ADJA	1	unbesonnene
vergebne	ADJA	1	vergebne
zurechte	NN	1	zurechte
Obstand	NN	1	Obstand
ergehen	VVINF	1	ergehen
Erniedrigung	NN	1	Erniedrigung
Verdrießlichers	NN	1	Verdrießlichers
ermattet	ADJA	1	ermatteten
verweint	ADJA	1	verweinten
verdächtig	ADJD	1	verdächtig
gefühlt	ADJA	1	gefühlte
Unbedachtsamkeit	NN	1	Unbedachtsamkeit
gehorchen	VVFIN	1	gehorche
unerfahrne	ADJA	1	unerfahrne
herzlich	ADJD	1	herzlich
Gewissensbiss	NN	1	Gewissensbisse
Wiedererstattung	NN	1	Wiedererstattung
Stube	NN	1	Stube
nachsagen	VVINF	1	nachsagen
gewöhnen	VVINF	1	gewöhnen
Gastwirt	NN	1	Gastwirt
erbieten	VVPP	1	erboten
Zutritt	NN	1	Zutritt
wählen	VVPP	1	gewählt
schwerlich	ADJD	1	schwerlich
dienstfertig	ADJD	1	dienstfertig
Rang	NN	1	Rang
Wahl	NN	1	Wahl
Zittre	ADJD	1	Zittre
wimmernd	ADJA	1	wimmernden
ausforschen	VVIZU	1	auszuforschen
bestellen	VVPP	1	bestellt
Groll	NN	1	Groll
Lage	NN	1	Lage
Gute	NN	1	Gutes
zurückweisen	VVPP	1	zurückgewiesen
Zufall	NN	1	Zufall
Sittenlehre	NN	1	Sittenlehre
zuziehet	VVFIN	1	zuziehet
Sonne	NN	1	Sonne
gähling	NN	1	gähling
Fleiß	NN	1	Fleiß
geheimnisvoll	ADJA	1	geheimnisvollsten
Gütigkeit	NN	1	Gütigkeit
zerfließe	VVFIN	1	zerfließe
losgehen	VVFIN	1	losgeht
Kniee	NN	1	Kniee
Ihretwegen	NN	1	Ihretwegen
einsprechen	VVINF	1	einsprechen
bange	ADJA	1	bange
Entschuldigung	NN	1	Entschuldigung
blühende	ADJA	1	blühende
schaden	VVPP	1	geschadet
Gemälde	NN	1	Gemälde
Nachtluft	NN	1	Nachtluft
Falte|Falten	NN	1	Falten
stören	VVPP	1	gestört
gefühlet	VVPP	1	gefühlet
zerfleischen	VVFIN	1	Zerfleischt
zeugen	VVINF	1	zeugen
verlieben	VVFIN	1	verliebe
gesollt	ADJD	1	gesollt
Sehen	NN	1	Sehen
darein	ADV	1	darein
Entzücken	NN	1	Entzücken
regen	VVFIN	1	regt
gedrungen	ADJD	1	gedrungen
drehend	ADJD	1	drehend
worüber	PWAV	1	worüber
würdigen	VVINF	1	würdigen
Beteurungen	NN	1	Beteurungen
anstehen	VVINF	1	anstehen
umschließen	VVINF	1	umschließen
sieben	CARD	1	sieben
Angesicht	NN	1	Angesicht
gestern	ADV	1	gestern
hinterlassen	VVFIN	1	hinterließ
wanken	VVFIN	1	wankte
Verfassung	NN	1	Verfassung
dulden	VVINF	1	dulden
unüberlegt	ADJA	1	unüberlegte
willigen	VVFIN	1	willigte
Sorte	NN	1	Sorten
fügen	VVFIN	1	füge
Geisel	NN	1	Geisel
versprech	VVFIN	1	versprech
schieben	VVINF	1	schieben
beruhen	VVFIN	1	beruhe
Tröstliche	NN	1	Tröstliches
Geblüt	NN	1	Geblüts
erträglich	ADJD	1	erträglicher
unwidersprechlich	ADJD	1	unwidersprechlich
Galanterie	NN	1	Galanterie
schlimm	ADJA	1	schlimmste
Bebung	NN	1	Bebung
dienlich	ADJD	1	dienlich
schuldigern	NN	1	schuldigern
Probe	NN	1	Probe
süßen	VVFIN	1	süße
Neue	NN	1	Neues
buhlerhaftesten	ADJA	1	buhlerhaftesten
unwiderstehlich	ADJA	1	unwiderstehliche
wirksam	ADJD	1	wirksam
Begleitung	NN	1	Begleitung
Abschiedsbrief	NN	1	Abschiedsbriefe
Larve	NN	1	Larven
Bitterste	NN	1	Bitterste
halt	ADV	1	Halt
ringst	VVFIN	1	ringst
Torheit	NN	1	Torheit
Fall	NN	1	Falls
schlau	ADJD	1	schlau
trotzig	ADJD	1	trotzig
ruhen	VVFIN	1	ruhten
spielen	VVFIN	1	spiele
Strick|Stricken	NN	1	Stricken
Beding	NN	1	Beding
Verlass	NN	1	Verlaß
Gelassenheit	NN	1	Gelassenheit
kosen|kosten	VVFIN	1	koste
Vollziehung	NN	1	Vollziehung
spielet	VVFIN	1	spielet
ei	FM	1	Ei
abschlagen	VVINF	1	abschlagen
auftragen	VVINF	1	auftragen
Suche	NN	1	Suche
bekömmt	VVFIN	1	bekömmt
gestrost	ADV	1	gestrost
Ordnung	NN	1	Ordnung
Vorsatze	NN	1	Vorsatze
Kostbarste	NN	1	Kostbarste
allerelendeste	ADJA	1	allerelendeste
Verborgnen	NN	1	Verborgnen
Finsternis	NN	1	Finsternis
unanständig	ADJD	1	unanständig
Affekt	NN	1	Affekts
Theater	NN	1	Theater
Lauf	NN	1	Lauf
Unstern	NN	1	Unstern
Plauderer	NN	1	Plauderer
vorrechnen	VVFIN	1	vorrechneten
krümmet	NE	1	krümmet
Ansehen	NN	1	Ansehen
Langmut	NN	1	Langmut
schwatzhaft	ADJA	1	schwatzhafte
öde	ADJD	1	öde
Erinnerung	NN	1	Erinnerung
umsehen	VVINF	1	umsehen
liefern	VVINF	1	liefern
blind	ADJA	1	blinden
bedächtig	ADJD	1	bedächtiger
Sklaverei	NN	1	Sklaverei
zurückbleiben	VVPP	1	zurückgeblieben
freundschaftlichste	ADJA	1	freundschaftlichste
murren	VVINF	1	murren
Stellung	NN	1	Stellung
geseufzet	VVFIN	1	geseufzet
sterblich	ADJA	1	sterblichen
Atem	NN	1	Atem
Abschwächung	NN	1	Abschwächung
Barbar	NN	1	Barbar
aufwären	VVINF	1	aufwären
anvertrauet	VVFIN	1	anvertrauet
ansehnlich	ADJA	1	ansehnliche
dienest	ADJA	1	dienest
unrein	ADJA	1	unreine
anvertrauen	VVINF	1	anvertrauen
ermorden	VVINF	1	ermorden
abreisen	VVINF	1	abreisen
Bewenden	NN	1	Bewenden
Närrchen	NN	1	Närrchen
verstattete	VVFIN	1	verstattete
Anstrengung	NN	1	Anstrengung
Halt	NN	1	Halt
hingehören|hinhören	VVPP	1	hingehört
Bein	NN	1	Beine
Verlust	NN	1	Verlust
Erleuchtung	NN	1	Erleuchtung
Bescheidenheit	NN	1	Bescheidenheit
trauest	VVFIN	1	trauest
Höhe	NN	1	Höhe
Unwürdigkeit	NN	1	Unwürdigkeit
Sünder	NN	1	Sünder
Erinnern	NN	1	Erinnern
nachsehen	VVINF	1	nachsehen
verdient	ADJA	1	verdiente
Unglaubliche	NN	1	Unglaubliches
Auskommens	NN	1	Auskommens
frostig	ADJA	1	frostiger
aufzudringen	VVIZU	1	aufzudringen
Schwert	NN	1	Schwerter
anliegen	VVFIN	1	anlag
Tadel	NN	1	Tadel
Huld	NN	1	Huld
dick	ADJA	1	dickste
erleichtern	VVINF	1	erleichtern
beurteilen	VVINF	1	beurteilen
bringet	VVFIN	1	bringet
bekümmern	VVFIN	1	bekümmert
seinige	PPOSAT	1	seinige
raset	VVFIN	1	raset
ehemalig	ADJA	1	ehemaligen
mörderisch	ADJA	1	mörderischen
Befreiung	NN	1	Befreiung
erzürnet	VVFIN	1	erzürnet
Gerechte	NN	1	Gerechten
verachtet	ADJA	1	verachteten
gen	APPR	1	gen
gegefühlt	VVPP	1	gegefühlt
ausgebrauset	VVPP	1	ausgebrauset
beschäftigen	VVINF	1	beschäftigen
Gewisse	NN	1	Gewisse
herabströmen	VVFIN	1	herabströmen
Joch	NN	1	Joch
Nichtswürdige	NN	1	Nichtswürdige
eifrig	ADJD	1	eifriger
Verlassen	NN	1	Verlassen
erkundiget	VVFIN	1	erkundiget
erkundigen	VVINF	1	erkundigen
schreien	VVFIN	1	schrie
Gegenwärtige	NN	1	Gegenwärtige
Erhaltungen	NN	1	Erhaltungen
Bewegung	NN	1	Bewegung
Stillschweigen	NN	1	Stillschweigen
barbarisch	ADJA	1	barbarische
wegreiseten	VVFIN	1	wegreiseten
versichern	VVPP	1	versichert
erstrecken	VVINF	1	erstrecken
austoben	VVINF	1	austoben
unordentlich	ADJD	1	unordentlich
langsamres	ADJA	1	langsamres
herumtragen	VVPP	1	herumgetragen
Vorsprecherin	NN	1	Vorsprecherin
entweder	KON	1	entweder
zugegen	ADJD	1	zugegen
gehörig	ADJA	1	gehörigen
Pfand	NN	1	Pfandes
Anrede	NN	1	Anrede
damals	ADV	1	damals
verdammt	ADJA	1	Verdammter
mördrische	ADJA	1	mördrische
Kuss	NN	1	Kuß
wohlgemeint	ADJA	1	wohlgemeinte
Versüßung	NN	1	Versüßung
aufführen	VVINF	1	aufführen
Ausrufung	NN	1	Ausrufung
Heftige	NN	1	Heftiges
offenherzig	ADJD	1	offenherzig
Bett	NN	1	Bett
Kreatur	NN	1	Kreaturen
Hässlichkeit	NN	1	Häßlichkeit
zustellen	VVINF	1	zustellen
genugsam	ADV	1	genugsam
verwahrlosete	ADJA	1	verwahrlosete
abtrotzen	VVIZU	1	abzutrotzen
gewünscht	ADJA	1	gewünschte
Unverschämte	NN	1	Unverschämte
gelangen	VVINF	1	gelangen
dergleichen	PIS	1	dergleichen
bestürmen	VVFIN	1	Bestürmen
Lallen	NN	1	Lallen
auspreßte	VVFIN	1	auspreßte
frohlocken	VVINF	1	frohlocken
Inbrunst	NN	1	Inbrunst
Vorhaben	NN	1	Vorhaben
zustoßen	VVPP	1	zugestoßen
Ungehorsam	NN	1	Ungehorsams
Abreise	NN	1	Abreise
triumphierend	ADJD	1	triumphierend
weihen	VVPP	1	geweiht
Ruhige	NN	1	Ruhiges
Vollmacht	NN	1	Vollmacht
Quäker	NN	1	Quäker
verwundet	ADJA	1	verwundetes
verwunden	VVINF	1	verwunden
betrognen	ADJA	1	betrognen
Führerin	NN	1	Führerin
schwächen	VVPP	1	geschwächt
Anlasse	NN	1	Anlasse
schimpfliche	ADJA	1	schimpfliche
jammernd	ADJA	1	jammernde
herausreißen	VVFIN	1	herausrissen
bewaffnet	ADJA	1	bewaffneten
Meineidiger	ADJA	1	Meineidiger
Unbekannte	NN	1	Unbekannter
Schuld	NN	1	Schuld
Widerwille	NN	1	Widerwille
Befehl	NN	1	Befehle
Kreisbewegung	NN	1	Kreisbewegung
Verfahren	NN	1	Verfahren
ausstrecken	VVPP	1	ausgestreckt
entstehen	VVINF	1	entstehen
aussehen	VVPP	1	ausgesehen
Wallung	NN	1	Wallungen
summen	VVINF	1	summen
Lesung	NN	1	Lesung
Gebäude	NN	1	Gebäude
bluten	VVINF	1	bluten
Ausdrückungen	NN	1	Ausdrückungen
teilhaftig	ADJD	1	teilhaftig
unerwartet	ADJD	1	unerwartet
geschlossen	ADJA	1	geschlossenen
erlassen	VVFIN	1	erlasse
Beurteilung	NN	1	Beurteilung
geschickt	ADJD	1	geschickt
Ruf|Rufen	NN	1	Rufen
entdeckt	ADJA	1	entdeckter
Folgerung	NN	1	Folgerungen
Fremde	NN	1	Fremde
verschloßnen	ADJA	1	verschloßnen
Lehnstuhl	NN	1	Lehnstuhl
einschließen	VVINF	1	einschließen
gesinnet	ADJD	1	gesinnet
gebeugtes	ADJA	1	gebeugtes
getreuste	ADJA	1	getreuste
Eigennützigen	NN	1	Eigennützigen
befördern	VVPP	1	befördert
fühlend	ADJA	1	fühlenden
flohe	VVFIN	1	flohe
Anspielung	NN	1	Anspielungen
Medea	NE	1	Medea
bemühen	VVINF	1	bemühen
Geringste	NN	1	Geringste
Verruchter	NN	1	Verruchter
Friedensbote	NN	1	Friedensboten
jagen	VVPP	1	gejagt
entgegen	PTKVZ	1	entgegen
schamhaft	ADJA	1	schamhafte
größern	VVINF	1	größern
misslingen	VVINF	1	mißlingen
nochmalig	ADJA	1	nochmaliges
allzufreien	ADJA	1	allzufreien
fein	ADJD	1	fein
rührend	ADJD	1	rührend
Neigung	NN	1	Neigungen
Retterin	NN	1	Retterin
woll	ADJD	1	woll
einlassen	VVINF	1	einlassen
ungehorsam	ADJD	1	ungehorsam
bergen	VVPP	1	geborgen
zürnen	VVFIN	1	zürnen
Beruhigende	NN	1	Beruhigendes
abziehn	VVFIN	1	abziehn
zugeeilet	VVPP	1	zugeeilet
immerwährend	ADJA	1	immerwährendes
beleidigt	ADJA	1	beleidigten
abkürzen	VVIZU	1	abzukürzen
täglich	ADJA	1	täglichen
fodern	VVINF	1	fodern
Wurm	NN	1	Wurm
Muttermörderin	NN	1	Muttermörderin
eingehen	VVIZU	1	einzugehen
mechanisch	ADJA	1	mechanische
beßres	NN	1	beßres
bereichern	VVINF	1	bereichern
Aussöhnung	NN	1	Aussöhnung
langwierig	ADJD	1	langwierig
Erfindungskraft	NN	1	Erfindungskraft
sündig	ADJA	1	sündige
Aufwartung	NN	1	Aufwartung
Unentschlossenheit	NN	1	Unentschlossenheit
kleiden	VVFIN	1	Kleide
gelinde	ADJA	1	gelinde
Reichern	NN	1	Reichern
hinzu	PTKVZ	1	hinzu
Pferd	NN	1	Pferde
aufwachen	VVINF	1	aufwachen
unüberschwengliche	ADJA	1	unüberschwengliche
Mördereisen	NN	1	Mördereisen
gestrig	ADJA	1	gestrigen
Widersprich	VVIMP	1	Widersprich
Äußerste	NN	1	Äußerste
Madame	NN	1	Madame
Wagen	NN	1	Wagen
Hafen	NN	1	Hafen
Alsdann	ADJD	1	Alsdann
notwendig	ADJD	1	notwendig
würdigern	NN	1	würdigern
Maßregel	NN	1	Maßregeln
Gewebe	NN	1	Gewebe
Beßrung	NN	1	Beßrung
Entsagung	NN	1	Entsagung
Fräulein	NN	1	Fräulein
Moor	NN	1	Moor
Wirklichkeit	NN	1	Wirklichkeiten
dienen	VVFIN	1	dienen
zerfließet	VVFIN	1	zerfließet
gestehen|stehen	VVPP	1	gestanden
zerfließen	VVFIN	1	zerfließt
Schwindel	NN	1	Schwindel
te	VVFIN	1	te
Parallel	NN	1	Parallel
geziemen	VVFIN	1	geziemen
minder	ADJD	1	minder
vereiteln	VVINF	1	vereiteln
erziehen	VVINF	1	erziehen
hinein	ADV	1	hinein
Lebenssatt	NN	1	Lebenssatt
worden	ADJA	1	gewordenen
gewahr	ADJD	1	gewahr
eingeben	VVINF	1	eingeben
Kränkung	NN	1	Kränkungen
laut	ADJD	1	lauter
Oklaff	NE	1	Oklaff
viert	ADJA	1	vierten
sehnliches	ADJA	1	sehnliches
missgönnen	VVINF	1	mißgönnen
Falsch	NN	1	Falsch
Trieb	NN	1	Triebe
ausweichen	VVINF	1	ausweichen
leid	ADJD	1	leid
Hirngespinst	NN	1	Hirngespinst
verzweifeln	VVPP	1	verzweifelt
betäubt	ADJA	1	betäubten
Barmherzigkeit	NN	1	Barmherzigkeit
fühlbar	ADJD	1	fühlbar
Empfinden	NN	1	Empfinden
senden	VVPP	1	gesandt
übern	APPRART	1	übern
ferne	ADV	1	ferne
zurückhalten	VVPP	1	zurückgehalten
liebreichste	ADJA	1	liebreichste
heilen	VVINF	1	heilen
rächen	VVINF	1	rächen
Bedenklichkeit	NN	1	Bedenklichkeiten
streiten	VVFIN	1	stritt
erheben	VVFIN	1	erhebt
fortdauernd	ADJA	1	fortdauernden
verlieret	VVFIN	1	verlieret
beifallen	VVPP	1	beigefallen
vergrößert	ADJA	1	vergrößerten
reizen	VVINF	1	reizen
sorgsam	ADJA	1	sorgsame
klagen	VVFIN	1	Klagen
allererste	ADJA	1	allerersten
Folter	NN	1	Folter
herunter	PTKVZ	1	herunter
gelehrt	ADJA	1	gelehrte
schmeichelst	VVFIN	1	schmeichelst
überschreiben	VVPP	1	überschrieben
widersprechen	VVFIN	1	widerspricht
befürchten	VVINF	1	befürchten
Küste	NN	1	Küsten
redte	VVFIN	1	redte
drohet	VVFIN	1	drohet
Betrübte	NN	1	Betrübte
übergehen	VVINF	1	übergehen
Biss	NN	1	Bisse
abhelfen	VVIZU	1	abzuhelfen
verscherzen	VVINF	1	verscherzen
zügelloses	ADJA	1	zügelloses
Setze	NN	1	Setze
entheiligest	VVFIN	1	entheiligest
Tausch	NN	1	Tausche
verschlingen	VVINF	1	verschlingen
beschleuniget	VVFIN	1	beschleuniget
heiraten	VVINF	1	heiraten
unbeweglich	ADJD	1	unbeweglich
Leib	NN	1	Leibe
abhalten	VVPP	1	abgehalten
ankündigen	VVIZU	1	anzukündigen
ihrentwegen	ADV	1	ihrentwegen
abgehen	VVINF	1	abgehen
Ehegattin	NN	1	Ehegattin
voran	ADV	1	voran
Hass	NN	1	Hasse
ruchloser	ADJD	1	ruchloser
Besorget	VVFIN	1	Besorget
unverbrüchlichsten	ADJA	1	unverbrüchlichsten
gebären	VVPP	1	geboren
Käfig	NN	1	Käfig
Landmädchen	NN	1	Landmädchen
entfernt	ADJD	1	entfernt
bequemen	VVINF	1	bequemen
rechtschaffner	ADJA	1	rechtschaffner
Besserm	NN	1	Besserm
niederwirft	VVFIN	1	niederwirft
Ritter	NE	1	Ritter
Rat	NN	1	Rat
Bessers	NN	1	Bessers
erstere	PIS	1	erstere
Lippe	NN	1	Lippen
unverdient	ADJA	1	unverdienten
Schlimmers	NN	1	Schlimmers
vertauschen	VVINF	1	vertauschen
begeben	VVFIN	1	begebe
stillen	VVFIN	1	stille
verstellen	VVINF	1	verstellen
Geliebt	NN	1	Geliebt
nimmermehr	ADV	1	nimmermehr
abnehmen	VVPP	1	abgenommen
Bewundrung	NN	1	Bewundrung
ungeschickt	ADJA	1	ungeschickten
Buchstabe	NN	1	Buchstaben
Frevlerin	NN	1	Frevlerin
Witwe	NN	1	Witwe
Schatz	NN	1	Schätze
Besserung	NN	1	Besserung
Flüchtling	NN	1	Flüchtling
Henker	NN	1	Henker
fesselnd	ADJA	1	fesselnden
zurückkommen	VVIZU	1	zurückzukommen
fromm	ADJA	1	frommen
wofür	PWAV	1	Wofür
Dorkas	NE	1	Dorkas
freudigern	ADJA	1	freudigern
Sympathie	NN	1	Sympathie
Stimme|Stimmen	NN	1	Stimmen
Erzählung	NN	1	Erzählung
verfehlen	VVINF	1	verfehlen
heuen	VVFIN	1	heut
herannahend	ADJA	1	herannahende
schmerzhaftere	ADJA	1	schmerzhaftere
rebellisch	ADJA	1	rebellische
Raub	NN	1	Raub
Raum	NN	1	Raum
zurückeilen	NN	1	zurückeilen
vernehmlich	ADJD	1	vernehmlich
tötend	ADJA	1	tötenden
allzugewohnt	VVFIN	1	allzugewohnt
Zügel	NN	1	Zügel
Geringschätzung	NN	1	Geringschätzung
Unglücklichste	NN	1	Unglücklichste
Entzückungen	NN	1	Entzückungen
abtrocknen	VVFIN	1	abtrocknet
unverschämt	ADJA	1	unverschämte
Zufriedenheit	NN	1	Zufriedenheit
überreden	VVPP	1	überredet
zurechnen	VVPP	1	zugerechnet
innerlich	ADJA	1	innerlichen
blendend	ADJA	1	blendenden
Verrichtung	NN	1	Verrichtungen
dank	APPR	1	Dank
äußern	VVFIN	1	äußern
vertun	VVFIN	1	vertat
ungehalten	ADJD	1	ungehalten
gehend	ADJA	1	gehenden
mangeln	VVPP	1	gemangelt
reiben	VVFIN	1	reiben
gerühret	VVPP	1	gerühret
weichherziges	ADJA	1	weichherziges
unrecht	ADJD	1	unrecht
entflamme	NN	1	entflamme
Neuigkeit	NN	1	Neuigkeit
eisern	ADJA	1	eiserne
hintergangen	ADJD	1	hintergangen
siech	ADJA	1	siechen
trostlos	ADJA	1	trostlosen
bewährt	ADJA	1	bewährte
Verbrecher	NN	1	Verbrecher
abtreten	VVIZU	1	abzutreten
weltlich	ADJD	1	weltlich
unsinnig	ADJA	1	Unsinniges
Erfolg	NN	1	Erfolg
Hören	NN	1	Hören
Verwahrung	NN	1	Verwahrung
ermüden	VVPP	1	ermüdet
reuet	VVFIN	1	reuet
Kleinmut	NN	1	Kleinmut
verzehrend	ADJD	1	Verzehrend
frisch	ADJA	1	frische
Schwäche	NN	1	Schwäche
glühen	VVFIN	1	glühen
Ermanglung	NN	1	Ermanglung
hülflos	ADJD	1	hülflos
Narrheit	NN	1	Narrheit
vergnügt	ADJD	1	vergnügt
Reich	NN	1	Reich
furchtsam	ADJA	1	furchtsame
Schauder|Schaudern	NN	1	Schaudern
Titel	NN	1	Titel
zulassen	VVFIN	1	zuläßt
beruhiget	VVFIN	1	beruhiget
rechtschaffne	ADJA	1	rechtschaffne
entwandtest	NN	1	entwandtest
vollenden	VVINF	1	vollenden
Gehorsam	NN	1	Gehorsams
scheuen	VVINF	1	scheuen
Straße	NN	1	Straße
hingeben	VVINF	1	hingeben
Königreiche	NN	1	Königreiche
schuldigen	VVFIN	1	schuldige
Nichtswürdigem	NN	1	Nichtswürdigem
bemeistern	VVINF	1	bemeistern
Ursach	NN	1	Ursach
erniedrigend	ADJA	1	erniedrigende
unschätzbarste	ADJA	1	unschätzbarste
freudig	ADJA	1	freudige
fortsetzen	VVINF	1	fortsetzen
Sanfte	NN	1	Sanftes
Undankbare	NN	1	Undankbare
Rachsucht	NN	1	Rachsucht
Leutseligkeit	NN	1	Leutseligkeit
schwören	VVPP	1	geschworen
vorlassen	VVIZU	1	vorzulassen
Entschlage	VVFIN	1	Entschlage
gesetzmäßiges	ADJA	1	gesetzmäßiges
zusammen	PTKVZ	1	zusammen
eilig	ADJD	1	eilig
voraussehen	VVINF	1	voraussehen
Sünde	NN	1	Sünde
Zusammenkunft	NN	1	Zusammenkunft
zwinget	VVFIN	1	zwinget
erhaben	ADJD	1	erhaben
Spieler	NN	1	Spielern
beständig	ADJD	1	beständig
Nachwelt	NN	1	Nachwelt
gewöhnlich	ADJA	1	gewöhnliche
näher	PTKVZ	1	näher
vorausbezahlen	VVPP	1	vorausbezahlt
Bitterkeit	NN	1	Bitterkeit
Raserei	NN	1	Raserei
Vermehrung	NN	1	Vermehrung
opfern	VVPP	1	geopfert
heutig	ADJA	1	heutigen
feilen	VVFIN	1	feilen
Entdeckung	NN	1	Entdeckung
auflegen	VVPP	1	aufgelegt
erbitten	VVINF	1	erbitten
unaussprechlich	ADJD	1	unaussprechlich
eingeschmiedet	VVPP	1	eingeschmiedet
bestrafen	VVPP	1	bestraft
Gunstbezeigungen	NN	1	Gunstbezeigungen
Rate	FM	1	Rate
Kenntnis	NN	1	Kenntnis
aufwachsen	VVINF	1	aufwachsen
vollziehen	VVPP	1	vollzogen
Eindruck	NN	1	Eindruck
Witz	NN	1	Witz
sanft	ADJA	1	sanften
unglaublich	ADJD	1	unglaublich
Rettung	NN	1	Rettung
Last	NN	1	Last
Vermaledeite	ADJA	1	Vermaledeite
Schämen	NN	1	Schämen
Liebeshändel	NN	1	Liebeshändeln
sitzen	VVFIN	1	sitzt
niedergeschlagen	ADJD	1	niedergeschlagen
weiß	PTKVZ	1	weiß
unausbleiblich	ADJD	1	unausbleiblich
Gemahlin	NN	1	Gemahlin
Erschlagene	NN	1	Erschlagenen
vermeiden	VVINF	1	vermeiden
wachend	ADJD	1	Wachend
überführen	VVINF	1	überführen
wiedersehen	VVINF	1	wiedersehen
Schiff	NN	1	Schiff
Fluch	NN	1	Flüche
sorgen	VVINF	1	sorgen
Wunder	NN	1	Wunder
Städtchen	NN	1	Städtchen
Bosheit	NN	1	Bosheit
allgemein	ADJA	1	allgemeinen
seinetwegen	ADV	1	seinetwegen
Uneigennützigkeit	NN	1	Uneigennützigkeit
Dame	NN	1	Dame
unvollendet	ADJA	1	unvollendeten
Brett	NN	1	Brett
verziehen	VVINF	1	verziehen
entwenden	VVPP	1	entwendet
Schanze	NN	1	Schanze
verhängtem	ADJA	1	verhängtem
knirschend	ADJA	1	knirschende
ausdrücklich	ADJD	1	ausdrücklich
Vollendung	NN	1	Vollendung
verleugnen	VVPP	1	verleugnet
weitläuftige	ADJA	1	weitläuftige
Verstoßene	NN	1	Verstoßene
dauern	VVPP	1	gedauert
Maß	NN	1	Maßen
ablassen	VVINF	1	ablassen
fruchtlos	ADJA	1	fruchtlosen
gehorsam	ADJA	1	gehorsame
Ehrenstellen	NN	1	Ehrenstellen
nähern	VVFIN	1	nähern
ohnmächtig	ADJA	1	ohnmächtigen
vorbringen	VVINF	1	vorbringen
betrogen	ADJA	1	betrogene
Temperament	NN	1	Temperament
ausschütten	VVPP	1	ausgeschüttet
tobet	ADJD	1	tobet
erlangen	VVINF	1	erlangen
verdrießlich	ADJD	1	verdrießlich
Ansehung	NN	1	Ansehung
sowohl	KON	1	sowohl
Beibehaltung	NN	1	Beibehaltung
verrauchen	VVPP	1	verraucht
gesehn	VVPP	1	gesehn
Überdrusse	NN	1	Überdrusse
aufbieten	VVFIN	1	aufbietet
Verlegenheit	NN	1	Verlegenheit
freiwillig	ADJA	1	freiwilligen
ohnedies	ADV	1	ohnedies
Ehmaligen	ADJA	1	Ehmaligen
Verweis	NN	1	Verweise
Erscheinung	NN	1	Erscheinung
mächtig	ADJD	1	mächtig
Schüchternheit	NN	1	Schüchternheit
vorgestellet	VVPP	1	vorgestellet
Erwarten	NN	1	Erwarten
Versicherung	NN	1	Versicherung
ungelesen	ADJD	1	ungelesen
Vornehmern	NN	1	Vornehmern
Itzo	NE	1	Itzo
Beklemmung	NN	1	Beklemmung
langsam	ADJA	1	langsame
ungebraucht	ADJD	1	ungebraucht
ausschlagen	VVPP	1	ausgeschlagen
Juwel	NN	1	Juwelen
Balsam	NN	1	Balsam
verwirren	VVPP	1	Verwirrt
zulegen	VVINF	1	zulegen
hinreichen	VVFIN	1	hinreichte
Eingeschmiedet	VVPP	1	Eingeschmiedet
Anmerkung	NN	1	Anmerkung
erschallen	VVFIN	1	erschalle
ersehen	VVPP	1	ersehen
Verschmähung	NN	1	Verschmähung
Verstehest	VVFIN	1	Verstehest
reizet	VVFIN	1	reizet
Abgrund	NN	1	Abgrund
Bestürzung	NN	1	Bestürzung
beweisen	VVFIN	1	beweisen
abgemattet	ADJA	1	abgemattet
Weib	NN	1	Weibern
Schlange	NN	1	Schlange
Verzögerns	NN	1	Verzögerns
verknüpfen	VVPP	1	verknüpft
neigen	VVPP	1	geneigt
begriffen	ADJA	1	begriffene
bestreben	VVPP	1	bestrebt
ungerner	ADJD	1	ungerner
einflößen	VVINF	1	einflößen
Blitz	NN	1	Blitz
getretner	ADJA	1	getretner
verstummst	VVFIN	1	verstummst
Gemüt	NN	1	Gemüte
geschrieben	ADJA	1	geschriebenen
eigensinnig	ADJA	1	eigensinnigen
anfechten	VVINF	1	anfechten
Bruder	NN	1	Bruder
Schilderung	NN	1	Schilderung
Liebste	NN	1	Liebster
Wichtigerm	NN	1	Wichtigerm
Lebendige	NN	1	Lebendigen
prahlen	VVINF	1	prahlen
Einwilligung	NN	1	Einwilligung
herausgerissen	ADJA	1	herausgerissenen
aufschlagen	VVFIN	1	aufschlugen
vertragen	VVPP	1	vertragen
Arzeneien	NN	1	Arzeneien
feindselig	ADJA	1	feindselige
Übertreibung	NN	1	Übertreibungen
überhin	ADV	1	überhin
obschon	KOUS	1	obschon
dunkel	ADJA	1	dunkle
Belford	NE	1	Belford
nachsetzte	VVFIN	1	nachsetzte
Frankreich	NE	1	Frankreich
sachte	ADV	1	Sachte
Hut	NN	1	Hut
aufrichtigste	ADJA	1	aufrichtigste
Land	NN	1	Lande
Überfall	NN	1	Überfalle
Angriff	NN	1	Angriff
gerecht	ADJA	1	Gerechter
erkaltend	ADJA	1	erkaltende
buhlerische	ADJA	1	buhlerische
begreifen	VVINF	1	begreifen
Ja	NN	1	Ja
Wirtshaus	NN	1	Wirtshause
vergraben	VVPP	1	vergraben
Starke	NN	1	Starken
unverletzt	ADJD	1	unverletzt
Versöhnung	NN	1	Versöhnung
Beschreibung	NN	1	Beschreibung
Streich	NN	1	Streich
sammeln	VVINF	1	sammeln
empfehlen	VVINF	1	empfehlen
zurückwarfen	VVFIN	1	zurückwarfen
nachdenklich	ADJA	1	nachdenkliche
Dasmal	NN	1	Dasmal
ziemlich	ADV	1	ziemlich
Roman	NN	1	Roman
überstehen	VVINF	1	überstehen
Abgott	NN	1	Abgott
worin	PWAV	1	worin
Übergang	NN	1	Übergang
Feierliche	NN	1	Feierliche
unabsehliches	ADJA	1	unabsehliches
Angelobungen	NN	1	Angelobungen
Einwendung	NN	1	Einwendung
häufen	VVINF	1	häufen
rühmlich	ADJA	1	rühmliche
umgehen	VVIZU	1	umzugehen
verteidigen	VVFIN	1	verteidigen
wundern	VVFIN	1	wundre
vertilgen	VVPP	1	vertilgt
gesund	ADJA	1	gesunden
Belohnung	NN	1	Belohnung
Beute	NN	1	Beute
Forderung	NN	1	Forderung
anlächeln	VVFIN	1	anlächelt
schätzbarer	ADJA	1	schätzbarer
einschläfern	VVPP	1	eingeschläfert
fröhlich	ADJA	1	fröhlichen
lachen	VVFIN	1	lachen
ablaufen	VVPP	1	abgelaufen
itzigen	NN	1	itzigen
matt	ADJD	1	matt
wandeln	VVFIN	1	wandelte
bitte	ADV	1	bitte
ungenossene	ADJA	1	ungenossene
wach	ADJD	1	wach
unbemerkt	ADJD	1	unbemerkt
Meer	NN	1	Meer
vorgeschriebnen	ADJA	1	vorgeschriebnen
Versprechung	NN	1	Versprechungen
Abschied	NN	1	Abschied
wovon	PWAV	1	wovon
geruhige	ADJA	1	geruhige
vergangne	ADJA	1	vergangne
herauf	PTKVZ	1	herauf
Auftritt	NN	1	Auftritte
Pause	NN	1	Pause
Vorrecht	NN	1	Vorrechte
Narr	NN	1	Narr
unentschlüssig	ADJD	1	unentschlüssig
wunderlich	ADJA	1	wunderliche
Unsinnige	NN	1	Unsinnige
Warnung	NN	1	Warnung
vorenthalten	VVINF	1	vorenthalten
Frau	NN	1	Frau
Tier	NN	1	Tiere
Verflucht	NN	1	Verflucht
weinend	ADJA	1	weinenden
starr	ADJA	1	starren
eindränge	VVFIN	1	eindränge
Innerste	NN	1	Innersten
gerüstete	ADJA	1	gerüstete
ausbleichet	VVFIN	1	ausbleichet
vergnügtesten	ADJD	1	vergnügtesten
Darzwischenkunft	NN	1	Darzwischenkunft
weiset	VVFIN	1	weiset
verpflichten	VVPP	1	verpflichtet
ichs	ADJD	1	ichs
gesättiget	VVPP	1	gesättiget
Landstreicher	NN	1	Landstreichern
Schmach	NN	1	Schmach
prächtig	ADJA	1	prächtigsten
ists	VVFIN	1	ists
eingebildet	ADJA	1	eingebildete
anheften	VVPP	1	angeheftet
Ernst	NN	1	Ernst
betrügen	VVPP	1	betrogen
verantworten	VVINF	1	verantworten
fähig	ADJD	1	fähig
zurückreisen	VVINF	1	zurückreisen
gelegentlich	ADJD	1	gelegentlich
unerbittlich	ADJD	1	unerbittlich
Kordialpulver	NN	1	Kordialpulver
theologisch	ADJA	1	theologischen
beimessen	VVINF	1	beimessen
Schluss	NN	1	Schlüssen
fortbegeben	VVINF	1	fortbegeben
Werkzeug	NN	1	Werkzeuge
feierlichste	ADJA	1	feierlichste
stündlich	ADJD	1	stündlich
heimsuchen	VVFIN	1	heimsucht
nachziehen	VVFIN	1	nachzieht
Buche	NN	1	Buche
neugierig	ADJA	1	neugierige
Gast	NN	1	Gäste
stammelnd	ADJA	1	stammelnde
Prüfung	NN	1	Prüfungen
schütteln	VVFIN	1	schüttelst
Abschiedskompliment	NN	1	Abschiedskompliment
Paroxysmo	NN	1	Paroxysmo
vorweg	ADV	1	vorweg
berechtiget	VVFIN	1	berechtiget
gebunden	ADJD	1	gebunden
Anhalten	NN	1	Anhalten
strahlen	VVFIN	1	strahlte
Gebet	NN	1	Gebete
Danksagung	NN	1	Danksagung
verlorne	ADJA	1	verlorne
Abzuge	NN	1	Abzuge
Unvorsichtige	NN	1	Unvorsichtige
Blutgericht	NN	1	Blutgericht
gießen	VVPP	1	gegossen
Donner	NN	1	Donner
spotten	VVINF	1	spotten
rechen	VVPP	1	gerecht
empfindungsloses	ADJA	1	empfindungsloses
entübriget	ADJA	1	entübriget
Zufriednes	NN	1	Zufriednes
kindisch	ADJA	1	kindischen
bezaubern	VVPP	1	bezaubert
durchkreuzen	VVINF	1	durchkreuzen
gemeinschaftlich	ADJA	1	gemeinschaftliche
Niederträchtige	NN	1	Niederträchtige
Tropfen	NN	1	Tropfen
Klägliche	NN	1	Klägliches
sparen	VVINF	1	sparen
mündlich	ADJD	1	mündlich
drum	PAV	1	Drum
büßen	VVINF	1	büßen
Rolle	NN	1	Rollen
Kaltsinn	NN	1	Kaltsinn
erneuern	VVINF	1	erneuern
Knecht	NN	1	Knechte
überleget	ADJD	1	überleget
Scheusal	NN	1	Scheusal
Lob	NN	1	Lobe
verklagende	ADJA	1	verklagende
Anverwandtin	VVFIN	1	Anverwandtin
Liebeshandel	NN	1	Liebeshandel
unglücklichern	ADJA	1	unglücklichern
sträflich	ADJD	1	sträflicher
besänftigen	VVINF	1	besänftigen
erfodert	VVPP	1	erfodert
widersetzen	VVFIN	1	widersetzen
scherzen	VVINF	1	scherzen
vors	APPRART	1	vors
Gedächtnis	NN	1	Gedächtnis
besänftiget	VVFIN	1	besänftiget
Wichtigkeit	NN	1	Wichtigkeit
Rechnung	NN	1	Rechnung
Gespräch	NN	1	Gespräch
wütender	ADJD	1	wütender
Stadt	NN	1	Stadt
Erniedrigende	NN	1	Erniedrigendes
fortfahren	VVFIN	1	fortfährt
Verwünschtes	ADJA	1	Verwünschtes
ehmaligen	ADJA	1	ehmaligen
blutdürstig	ADJA	1	blutdürstige
trostsuchende	ADJA	1	trostsuchende
mühsam	ADJA	1	mühsame
melancholisch	ADJA	1	melancholische
erschüttern	VVPP	1	erschüttert
Überraschung	NN	1	Überraschungen
Schmerzhafte	NN	1	Schmerzhaftes
erhören	VVPP	1	erhört
zweifelhaft	ADJA	1	zweifelhaften
bestürzen	VVPP	1	bestürzt
ändern	VVFIN	1	Ändre
förmlich	ADJA	1	förmliches
Gespenst	NN	1	Gespenst
kränken	VVPP	1	gekränkt
Kopf	NN	1	Kopf
Muskel	NN	1	Muskeln
durchgehen	VVPP	1	durchgegangen
Ehrfurcht	NN	1	Ehrfurcht
Weigerung	NN	1	Weigerung
allzuviel	PIS	1	allzuviel
eingehändiget	VVFIN	1	eingehändiget
Prophet	NN	1	Propheten
entfärben	VVPP	1	entfärbt
schändlich	ADJA	1	schändliche
Angenehme	NN	1	Angenehmes
bahnen	VVINF	1	bahnen
Errötendes	NN	1	Errötendes
untersuchen	VVINF	1	untersuchen
vermehren	VVINF	1	vermehren
wehen	VVIMP	1	Weh
vorübergehn	ADJD	1	vorübergehn
Irrweg	NN	1	Irrwegen
vorbeistreichen	VVINF	1	vorbeistreichen
tobend	ADJA	1	tobende
Eilfertigkeit	NN	1	Eilfertigkeit
Donnerschlag	NN	1	Donnerschlag
bereuen	VVINF	1	bereuen
Eigentum	NN	1	Eigentum
Eindrucke	NN	1	Eindrucke
Ankläger	NN	1	Ankläger
gereichen	VVINF	1	gereichen
Gabe	NN	1	Gabe
Wespe	NN	1	Wespe
abmessen	VVPP	1	abgemessen
herabgestoßen	VVPP	1	herabgestoßen
treffen|triefen	VVPP	1	getroffen
Regel	NN	1	Regeln
erschrecklicher	ADJA	1	erschrecklicher
unmerklich	ADJD	1	unmerklich
streichen	VVFIN	1	streicht
dreist	ADJD	1	dreist
zwei	CARD	1	zwei
Verschiebung	NN	1	Verschiebung
nachgeben	VVINF	1	nachgeben
nahend	ADJA	1	nahenden
Rätsel	NN	1	Rätsel
Schalk	NN	1	Schalk
Beschimpfung	NN	1	Beschimpfung
rührte	VVFIN	1	rührte
unterwerfen	VVPP	1	unterworfen
oben	ADV	1	oben
Geld	NN	1	Geld
äußerlich	ADJD	1	äußerlich
rechtfertigen	VVFIN	1	rechtfertigen
Besorgnis	NN	1	Besorgnis
betauert	VVPP	1	betauert
Gleichnis	NN	1	Gleichnis
diejenige	PDS	1	derjenige
Erbin	NN	1	Erbin
verlöschen	VVPP	1	verlöscht
herausbringen	VVPP	1	herausgebracht
Vorsorge	NN	1	Vorsorge
versiegelt	ADJA	1	versiegelte
Erwartung	NN	1	Erwartung
Entzückung	NN	1	Entzückung
inner	ADJA	1	inneres
Flatterhaftigkeit	NN	1	Flatterhaftigkeit
wecken	VVFIN	1	weckten
hängen	VVFIN	1	hängt
hastig	ADJD	1	hastig
ha	NE	1	ha
Gold	NN	1	Golde
gestrafte	ADJA	1	gestrafte
Glanz	NN	1	Glanze
Vorsicht	NN	1	Vorsicht
wär	VVFIN	1	wär
geweinet	VVFIN	1	geweinet
armseligste	ADJA	1	armseligste
manchmal	ADV	1	manchmal
fortdauern	VVINF	1	fortdauern
Vaterteil	NN	1	Vaterteil
Anbeter	NN	1	Anbeter
Geschmack	NN	1	Geschmack
Welle	NN	1	Welle
gutherzig	ADJA	1	gutherzigen
Buhlerinnen	NN	1	Buhlerinnen
Nachteil	NN	1	Nachteile
Testament	NN	1	Testamente
prangen	VVFIN	1	prangte
Mäßigung	NN	1	Mäßigung
Dover	NN	1	Dover
begleitend	ADJA	1	begleitenden
Verbrecherin	NN	1	Verbrecherin
Verräterei	NN	1	Verräterei
