Title: Damon, oder die wahre Freundschaft
Number of all lemmas: 2727
Nummber of different lemmas: 1253

Lemma	POS	Frequency	Tokens
versteh	NN	49	versteh
Leander	NN, NNP	47	Leander
Freund	NNS, NN, NNP	47	Freunde, Freund
Damon	NN, NNP	42	Damon
wohl	RB, RP, IN	35	wohl
Versteh	NN	30	Versteh
Freundschaft	NN, JJ	27	Freundschaft
sagen	VB, RB, VBN, RP	24	sagen, sage, sagt, gesagt
Herr	NN, JJ	20	Herr
Frau	NN	20	Frau
Vetter	NN, NNP	19	Vetter
weeissen	VB	19	weiß
Liebe	NN, JJ	18	Liebe
gut	JJ	16	gut, guter, guten, gute
meine	PRP$	15	meine
gewiss	NN, JJ	14	gewiß, gewissen
soen	VBN, RB	14	so
andern	JJ, DT, RB	14	andern
ha	NN	14	ha
Himmel	NN	14	Himmel
Schiff	NN, NNS	13	Schiff, Schiffe
Ehre	NN	13	Ehre
Unglück	NN	12	Unglück
Ach	NN	12	Ach
Vermögen	NN	11	Vermögen
Herz	NN, NNS	11	Herz, Herzen
Gott	NN	11	Gott
wenig	RB, IN	11	wenig
eben	WRB, RB	10	eben
glauben	VB	10	glauben, glaube, geglaubt
wahr	RP, RB, JJ	10	wahr
genug	RB, RP	10	genug
lieb	NN, JJ, VB	10	lieben, lieber, liebe
Lisette	NN	10	Lisette
Recht	NN	9	Recht
kömmen	MD	9	kömmt
itzo	NN	9	itzo
bekommen	VB, VBN	9	bekommen
erst	RP, RB, JJ	9	erst, ersten
alsdenn	RB, RP, IN	8	alsdenn
erklären	VB, VBN	8	erklären, erklärten, erklärt, erkläret, erklärte
Leandern	NN	8	Leandern
reden	VB, PRP$	8	redet, reden
dazuen	VB	8	dazu
Nachricht	NN	8	Nachricht
sehen	VBN, VB	8	sehen, gesehen, sieht
setzen	VB, RP	8	gesetzt, setzen
Zeit	NN	8	Zeit
bald	WRB, RB, RP	8	bald
ist	VB, RB, JJ	8	ist
Ihrem	NN	7	Ihrem
glücklich	JJ	7	glücklich
gern	VBN, RB, IN, RP	7	gern
Neigung	NN, NNS	7	Neigung, Neigungen
Reden	NN, NNP	7	Reden
Witwe	NN	7	Witwe
Vergnügen	NN	7	Vergnügen
liebster	NN	7	liebster
verzeihen	VB	7	verzeihen
suchen	VB	7	suchen, sucht, suchten
gar	RB	7	gar
unglücklich	JJ	7	unglücklich
zwei	CD	7	zwei
Ha	NN	7	Ha
verlieren	VB	6	verliert, verlieren, verlöre
Freundes	NN	6	Freundes
hören	VB	6	hören, höre
Gedanke	NNS	6	Gedanken
Handel	NN	6	Handel
klein	JJ	6	kleiner, klein, kleines, kleine
Absichten	NN	6	Absichten
Art	NN	6	Art
vielleicht	RB	6	vielleicht
fein	JJ	6	fein
verstehen	VB	6	verstehen, verstehe
Leben	NN	5	Leben
Madam	JJ	5	Madam
denken	VB	5	denkt, denken
heiraten	VB	5	heiraten
glücklichsten	NN	5	glücklichsten
kann	VB, RB, JJ	5	kann
Wort	NN	5	Wort
bitten	VB	5	bitten, bitte
nehmen	VB	5	nahm, nehmen
Ursache	NN	5	Ursache
selb	DT	5	selber
finden	VB, VBN	5	finden, gefunden
verlor	JJ	5	verloren
Glück	NN	5	Glück
rechen	VB	5	recht, rechten
sonst	RB	5	sonst
beleidigen	VB, RP	5	beleidigen, beleidigt
beleidiget	NN	5	beleidiget
kennen	VB	5	kenne, kennen
meines	JJ, NN	5	meines
helfen	VB	5	hilft, helfen
Welt	NN	5	Welt
leicht	JJ	5	leicht, leichter
jung	JJ	5	jungen, junge
niederträchtig	JJ	4	niederträchtig
Pflicht	NN	4	Pflicht
Freier	NN	4	Freier
aufs	NN	4	aufs
grösst	JJ	4	größte, größten
Person	NN	4	Person
mirs	NN	4	mirs
Beleidigungen	NN	4	Beleidigungen
niemand	DT	4	niemand
Leanders	NN	4	Leanders
zeigen	VB, VBN	4	zeigen
danken	VB	4	danken
andermal	RB, NNP, RP	4	andermal
warten	VB, VBN	4	warten
grossmütig	JJ	4	großmütig, großmütigen
gehabt	NN	4	gehabt
untergehen	VBN, RP, VB	4	untergegangen
angenehm	JJ	4	angenehme, angenehm
zärtlich	JJ	4	zärtlichen, zärtlich
verdriesslich	JJ	4	verdrießlich
antworen	VB	4	antworten
einander	PRP	4	einander
sehe	PRP$	4	sehe
schwach	JJ	4	schwach
sehn	NN	4	sehn
Tonne	NN, NNS	4	Tonne, Tonnen
verlassen	VB	4	verlassen
Schande	NN	4	Schande
Reichtum	NN	4	Reichtum
nie	RB	4	nie
dächte	NN	4	dächte
verziehen	VB	4	verziehen
Nebenbuhler	NN	4	Nebenbuhler
Geld	NN	4	Geld
ach	UH	4	ach
lieben	VB	4	lieben, liebe
Hand	NN	4	Hand
hübsch	JJ	4	hübsch, hübsche, hübschen
Goldes	NN	4	Goldes
Herrn	NN	4	Herrn
andre	NN	3	andre
Hälfte	NN	3	Hälfte
deswegen	RB	3	deswegen
glücklichste	NN	3	glücklichste
übel	JJ	3	übel
ichs	NN, NNP	3	ichs
Augen	NN	3	Augen
gestehen	VB	3	gestehen
Liebhaber	NN	3	Liebhaber
verliere	NN	3	verliere
Verzeihung	NN	3	Verzeihung
neu	JJ	3	neue
Unglücke	NN	3	Unglücke
sind	VB, JJ	3	sind
Seele	NN	3	Seele
Wohl	RP, RB	3	Wohl
Hui	NN	3	Hui
zuwider	NN	3	zuwider
entreissen	NN	3	entreißen
Vorschlag	NN	3	Vorschlag
Probe	NN	3	Probe
Augenblick	NN	3	Augenblick
verlangen	VB, VBN, RP	3	verlangen, verlangt
Frage	NN	3	Frage
bloss	JJ, IN	3	bloßer, bloß, bloße
halb	JJ, CD	3	halbe, halb
Verstehn	NN	3	Verstehn
Sachen	NN	3	Sachen
unterscheiden	VBN, VB	3	unterschieden, unterscheiden
Himmels	NN	3	Himmels
Scham	NN	3	Scham
vollkomm	JJ	3	vollkommen
behalten	VBN, RP	3	behalten
einerlei	IN, RB	3	einerlei
heuen	VB	3	heute
Paar	NN, JJ	3	Paar
Aufführung	NN	3	Aufführung
dasjenig	DT	3	dasjenige
umsonst	RB	3	umsonst
ihrem	PRP$	3	ihrem
verbinden	RP, VBN	3	verbunden
Rede	NN	3	Rede
aufrichtig	JJ	3	aufrichtig
Überlegen	NN	3	Überlegen
Vielleicht	RB	3	Vielleicht
süsse	NN	3	süße
anfangen	VB	3	anfangen
ganzes	NN	3	ganzes
empfindlichen	VBN	3	empfindlich
Gesetzt	NN	3	Gesetzt
Dank	IN, RP	3	Dank
zweifeln	VB	3	zweifeln
Kann	NNP	3	Kann
allezeit	NN	3	allezeit
Glücke	NN	3	Glücke
Untreue	NN	3	Untreue
dadurch	RB	3	dadurch
wider	RP, IN	3	wider
Ihres	NN	3	Ihres
gleichviel	NN	3	gleichviel
Madame	NN	3	Madame
Erbe	NNS	3	Erben
Zweifeln	NN	3	Zweifeln
Hätte	NN	3	Hätte
fällen	VB	3	fällt, gefällt
weg	RB, RP	3	weg
auszuüben	NN	3	auszuüben
bereden	NN	3	bereden
wissen	VB	3	wissen
Gelegenheit	NN	3	Gelegenheit
verstehn	NN	3	verstehn
Entschluss	JJ, NN	3	Entschluß
allzu	RB, IN	3	allzu
wünschen	VB	3	wünschen, wünschte
schicken	VB	3	geschickt, schicken
endlich	RB	3	endlich
vorkommen	VB	3	vorkommen
erhalten	VBN, VB	3	erhalten
Vermögens	NN	3	Vermögens
gross	JJ	3	groß, große
etwan	NN	3	etwan
St	PRP$	3	St
Verdruss	NN	3	Verdruß
notwendig	JJ	3	notwendig
unsrer	PRP$	2	unsrer
Traum	NNS	2	Träume
dienen	VB	2	dienen, dient
gesteh	NN	2	gesteh
empfindlich	JJ	2	empfindlich
Sprache	NN	2	Sprache
reizender	NN	2	reizender
Eure	NN	2	Eure
voraus	JJ	2	voraus
vergessen	RP	2	vergessen
betrübt	NN, JJ	2	betrübt, betrübte
vertraue	NN	2	vertraue
Weder	NN	2	Weder
wohin	WRB, RB	2	wohin
billig	JJ, RB	2	billig
Wahl	NN	2	Wahl
erfahren	VBN, RP	2	erfahren
Eidschwur	NN	2	Eidschwur
fehlen	VB	2	fehlt
schenken	VBN, VB	2	geschenkt, schenken
möglichstes	NN	2	möglichstes
versuchen	VB	2	versuchen
annehmen	VB	2	annehmen
daraufen	RB, VB	2	darauf
Gesichte	NN	2	Gesichte
Irrung	NN	2	Irrung
Gütigkeit	NN	2	Gütigkeit
lustig	JJ	2	lustig
banqueroute	NN	2	banqueroute
besitzen	VB	2	besitzen
Fünfmalten	VBN	2	Fünfmal
gewissenhaft	JJ	2	gewissenhaft
Lebens	JJ, NN	2	Lebens
liebte	NN, NNP	2	liebte
grossmütigen	NN	2	großmütigen
Grillenfänger	NN	2	Grillenfänger
Soen	RB	2	So
sachte	PRP$	2	sachte
Mensch	NN	2	Mensch
wertester	NN, JJ	2	wertester
Pflichten	NN	2	Pflichten
Gut	NN	2	Gut
muss	VB, JJ	2	muß
Habe	NN	2	Habe
zweifle	NN	2	zweifle
edel	JJ	2	edel
bestreben	VB	2	bestrebte, bestreben
wussten	NN	2	wußten
unbekannen	VBN	2	unbekannt
Ausschlag	NN	2	Ausschlag
Güter	NN	2	Güter
unmöglich	JJ	2	unmöglich
zugleich	RB	2	zugleich
anstehen	VB, NN	2	ansteht, anstehen
Würde	NN	2	Würde
schmeicheln	VB	2	schmeicheln
Gegenstand	NN	2	Gegenstand
deutlich	JJ	2	deutlich
teils	NN	2	teils
Verdacht	NN	2	Verdacht
nochen	VB	2	noch
lässt	VB	2	läßt
betrügen	VB	2	betrügen
Sturme	NN	2	Sturme
eigen	JJ	2	eigenen
munt	JJ	2	munter
hoffen	VB	2	hoffe
vergelte	NN	2	vergelte
schändlich	JJ	2	schändlichen, schändlich
versichre	NN	2	versichre
geweissen	VB	2	gewiß
Rat	NN	2	Rat
nötigen	VB, VBN	2	nötigen, nötig
befürchte	NN	2	befürchte
schimpfen	VB, RP	2	schimpfen, geschimpft
hart	JJ	2	harte, harten
Verstand	NN	2	Verstand
entschloss	JJ	2	entschlossen
zürnen	VB	2	zürnen
manch	DT	2	mancher, manchem
weniger	RB	2	weniger
Ei	NN	2	Ei
Henker	NN	2	Henker
blind	JJ	2	blinden, blind
wagen	VB	2	wagt, gewagt
gedenken	VB	2	gedenken
Eur	JJ	2	Eure
Banqueroute	NN	2	Banqueroute
raten	VB	2	raten
nennen	VB	2	nennen, nennt
jen	DT	2	jener, jenen
Närrin	NN	2	Närrin
Ihrige	NN	2	Ihrige
bewussten	NN	2	bewußten
wenigstens	RB, RP	2	wenigstens
angetroffen	NN	2	angetroffen
tue	NN	2	tue
empfinde	NN	2	empfinde
fünf	CD	2	fünf
einbilden	NN	2	einbilden
alles	RB	2	alles
aufrichtige	NN, JJ	2	aufrichtige
Erklären	NN	2	Erklären
derohalben	NN	2	derohalben
desgleich	VB	2	desgleichen
Denkt	NN	2	Denkt
anzufangen	VB	2	anzufangen
überlassen	VB	2	überlassen
Mode	NN	2	Mode
verdienen	VB	2	verdient
Liebsten	NN	2	Liebsten
Weg	NN	2	Weg
Hören	NN	2	Hören
Mache	NN	2	Mache
ungegründeten	NN, NNP	2	ungegründeten
bekümmert	NN	2	bekümmert
vorstellen	VB, VBN	2	vorstellen, vorgestellt
begehen	VB, RP	2	begangen
weswegen	WRB	2	weswegen
Händen	NN	2	Händen
Sanftmut	NN	2	Sanftmut
leugnen	VB	2	leugnen
vergnügt	JJ	2	vergnügt
etwa	IN	2	etwa
Zweifel	NN	2	Zweifel
ersen	VB	2	erste, ersten
gefallen	VB, RP	2	gefallen
trauen	VB	2	trauen
bessern	VBN, RP	2	besser
Pöbel	NN	2	Pöbel
unsre	PRP$	2	unsre
schreiben	VBN	2	geschrieben
stumm	JJ	2	stumme
best	JJ	2	besten
seh	VB, PRP$	2	sehen, seh
niemanden	NN	2	niemanden
Reichtümer	NN	2	Reichtümer
Geschenk	NN	2	Geschenk
Tausch	NN	2	Tausch
bestürzt	NN	2	bestürzt
Schaden	NN	2	Schaden
Höre	NN	2	Höre
Wahrheit	NN	2	Wahrheit
Tage	NN	2	Tage
Testamente	NN	2	Testamente
einzig	VB	2	einzige
abern	VBN, VB	2	aber
Heirat	NNS, NN	2	Heiraten, Heirat
eitle	NN	2	eitle
verlasse	NNP	2	verlasse
scheinbar	JJ	2	scheinbare, scheinbar
Handlung	NN	2	Handlung
redlich	JJ	2	redliche, redlich
denjenig	DT	2	denjenigen
erzählen	VB	2	erzähle, erzählen
Ihrigen	NN	2	Ihrigen
schwören	VB	2	schwören, geschworen
zittere	NN	2	zittere
alleine	NN	2	alleine
stellen	VB, RP	2	stellt, gestellt
besorge	NN	2	besorge
angekommen	NN	2	angekommen
sprechen	VB, VBN	2	spricht, gesprochen
just	JJ	2	just
Wollte	NN	2	Wollte
Mutter	NN	2	Mutter
lese	NN	2	lese
Einfall	NN	2	Einfall
hab	NN	2	hab
gerühret	NN	2	gerühret
Schimpf	NN	2	Schimpf
meinigen	NN	2	meinigen
Drum	NN	2	Drum
Umständen	NN	2	Umständen
läng	JJ	2	länger
anwenden	VB	2	anwenden
erwarten	VB	2	erwarten
Spöttereien	NN	2	Spöttereien
bös	JJ	2	böse
meinig	DT	2	meinige
handeln	VB	2	handeln
Grossmut	NN	2	Großmut
besser	RB	2	besser
Klugheit	NN	2	Klugheit
Eurer	NN	2	Eurer
hieher	NN	2	hieher
redet	VB, JJ	2	redet
besondre	NN	2	besondre
itzt	DT	2	itzt
fragen	VB	2	fragen
habe	RB	2	habe
Mannspersonen	NN	2	Mannspersonen
verunglückt	NN	2	verunglückt
gestünde	NN	2	gestünde
Seines	PRP$	2	Seines
Ostindien	NN	2	Ostindien
empfinden	VB	2	empfinden
Wasser	NN	2	Wasser
ehe	CC	2	ehe
Kapital	NN, NNS	2	Kapital, Kapitale
liesse	NN	2	ließe
besorgen	VB	2	besorgte
schweigen	RB, VB	2	schweigt, schweigen
wär	JJ, NN	2	wäre, wär
Wissen	NN	2	Wissen
edler	NN	2	edler
Haus	NN	2	Haus
Schade	NN	2	Schade
lang	JJ	2	lang
ausschlagen	NN	2	ausschlagen
Ers	NNP	2	Ers
Exempel	NN	2	Exempel
Lust	NN	2	Lust
unser	PRP$	2	unser
trennen	VB	2	trennen
Leichtsinnigkeit	NN	2	Leichtsinnigkeit
werfen	VB	1	werfen
wären	VB	1	wären
verhungern	NN	1	verhungern
Nase	NN	1	Nase
edl	JJ	1	edle
Ehe	NN	1	Ehe
alt	JJ	1	alten
Falschheit	NN	1	Falschheit
Winter	NN	1	Winter
verstehst	NN	1	verstehst
eigennützig	JJ	1	eigennützig
aufhelfen	NN	1	aufhelfen
könnte	VB	1	könnte
Habt	NN	1	Habt
gescheute	JJ	1	gescheute
gescheiter	NN	1	gescheiter
bissgen	NN	1	bißgen
übrigens	RP	1	übrigens
verliebt	JJ	1	verliebt
brächten	NN	1	brächten
spielte	NN	1	spielte
Übereilung	NN	1	Übereilung
philosophisch	JJ	1	philosophisch
Fein	NN	1	Fein
Glauben	NN	1	Glauben
schwerlich	JJ	1	schwerlich
untreu	JJ	1	untreu
schade	NN	1	schade
gemein	JJ	1	gemein
Not	NN	1	Not
Gewinst	NN	1	Gewinst
gestern	IN	1	gestern
verrichten	VB	1	verrichten
Rang	NN	1	Rang
gröblich	JJ	1	gröblich
vernünftigsten	NN	1	vernünftigsten
beliebt	JJ	1	beliebt
gewahr	NN	1	gewahr
Kreaturen	NN	1	Kreaturen
Angelegenheiten	NN	1	Angelegenheiten
weien	VBN	1	weit
verbieten	VBN	1	verboten
täte	NN	1	täte
ungegründet	NN	1	ungegründet
selben	VBN	1	selbst
erhabenen	NN	1	erhabenen
He	NN	1	He
reichlich	JJ	1	reichlicher
mächtiger	NN	1	mächtiger
Frisch	JJ	1	Frisch
Kleinigkeit	NN	1	Kleinigkeit
belebt	JJ	1	belebter
gottesvergessen	NN	1	gottesvergessen
stünde	NN	1	stünde
vereinigen	VB	1	vereinigen
würde	RB	1	würde
Brief	NNS	1	Briefe
gütig	JJ	1	gütig
Gegenwart	NN	1	Gegenwart
rate	NN	1	rate
schuldig	JJ	1	schuldig
süssen	NN	1	süßen
Leb	NN	1	Leb
übermorgen	RB	1	übermorgen
sieht	VB	1	sieht
Grams	NN	1	Grams
wiederholen	VB	1	wiederholen
Unrecht	NN	1	Unrecht
seinig	DT	1	seinige
Muss	NN	1	Muß
warteten	NN	1	warteten
verleumden	VB	1	verleumden
Rückkunft	NN	1	Rückkunft
trotzt	NN	1	trotzt
erdulden	NN	1	erdulden
vollends	NN	1	vollends
hegen	NN	1	hegen
edlere	NN	1	edlere
übereinstimmte	NN	1	übereinstimmte
törichten	NN	1	törichten
Summe	NN	1	Summe
Reichtume	NN	1	Reichtume
Liebeserklärung	NN	1	Liebeserklärung
schänden	VB	1	schänden
liebenswürdigsten	NN	1	liebenswürdigsten
überzeugen	VB	1	überzeugt
Stolze	NN	1	Stolze
Angst	NN	1	Angst
Seeln	VB	1	Seelen
treffen	VB	1	treffen
herbestellet	NN	1	herbestellet
ergeben	VBN	1	ergeben
heeissen	RB	1	heißt
Verdienst	NN	1	Verdienst
liebenswürdige	NN	1	liebenswürdige
Darnach	RB	1	Darnach
unglücklichste	NN	1	unglücklichste
Beschäftigung	NN	1	Beschäftigung
mengest	NN	1	mengest
schadet	VB	1	schadet
Hoffnung	NN	1	Hoffnung
Pfui	NN	1	Pfui
vorplaudern	NN	1	vorplaudern
Mühe	NN	1	Mühe
zuging	FW	1	zuging
Lügen	NN	1	Lügen
Ton	NN	1	Ton
Kräften	NN	1	Kräften
bleibe	NNP	1	bleibe
untereinander	NN	1	untereinander
mache	NN	1	mache
Schimpfe	NN	1	Schimpfe
banquerout	NN	1	banquerout
liebern	VB	1	lieber
hieren	VBN	1	hier
widerlegen	VB	1	widerlegen
bezeigen	VBN	1	bezeigte
Begriffen	NN	1	Begriffen
verfahren	VB	1	verführen
uneinig	JJ	1	uneinig
unsers	PRP$	1	unsers
stünden	NN	1	stünden
worüber	RB	1	worüber
würdigen	VB	1	würdigen
besässe	NN	1	besäße
vorschlagen	VB	1	vorschlagen
liebst	JJ	1	liebster
Verziehen	NN	1	Verziehen
unsere	PRP$	1	unsere
Lasst	NN	1	Laßt
Schwierigkeit	NN	1	Schwierigkeit
unserm	PRP$	1	unserm
taub	JJ	1	taub
halte	NN	1	halte
blieb	NN	1	blieb
Sage	NN	1	Sage
würdig	JJ	1	würdig
Rache	NN	1	Rache
selig	JJ	1	selig
gegründet	JJ	1	gegründeter
Glücksgüter	NN	1	Glücksgüter
Zuwurf	NN	1	Zuwurf
Unsre	NN	1	Unsre
neidisch	JJ	1	neidisch
widerführe	NN	1	widerführe
Unterschied	NN	1	Unterschied
Worinne	NN	1	Worinne
zwölf	CD	1	zwölf
beitragen	VB	1	beitragen
eigennützige	NNP	1	eigennützige
Schwärmereien	NN	1	Schwärmereien
Euer	NN	1	Euer
Gasthof	NN	1	Gasthof
zärtlichen	VBN	1	zärtlich
Bezeigen	NN	1	Bezeigen
Beinahe	NN	1	Beinahe
liebenswürdig	JJ	1	liebenswürdig
anbringen	RP	1	angebracht
Gunst	NN	1	Gunst
satt	JJ	1	satt
Notwendig	JJ	1	Notwendig
höre	VB	1	höre
verschwenderisch	JJ	1	verschwenderische
Womit	NN	1	Womit
Legen	NN	1	Legen
beruhen	VB	1	beruht
zugegriffen	NN	1	zugegriffen
getröste	NN	1	getröste
seltsam	JJ	1	seltsam
Fall	NN	1	Fall
unterdrückt	JJ	1	unterdrückt
verschwiegen	NN	1	verschwiegen
entdecken	VB	1	entdecken
Kummer	NNP	1	Kummer
Verlassenschaft	NN	1	Verlassenschaft
jemals	IN	1	jemals
verliebten	JJ	1	verliebten
zehnmal	IN	1	zehnmal
Taten	NN	1	Taten
schwärmst	NN	1	schwärmst
Gasthofe	NN	1	Gasthofe
genau	RB	1	genau
zärtlicher	NN	1	zärtlicher
unterstehen	NN	1	unterstehen
wählen	VB	1	wählen
verliebter	NN	1	verliebter
Vorwürfe	NN	1	Vorwürfe
versehen	VB	1	versehen
Gesellschaft	NN	1	Gesellschaft
gedient	NN	1	gedient
unzähligen	NN	1	unzähligen
Empfindlichkeit	NN	1	Empfindlichkeit
Wände	NN	1	Wände
beschliessen	VBN	1	beschlossen
nachlässiger	NNP	1	nachlässiger
kurz	JJ	1	kurzem
Seiner	PRP$	1	Seiner
Armen	NN	1	Armen
Aufrichtigkeit	NN	1	Aufrichtigkeit
ferner	IN	1	ferner
bestimmen	VB	1	bestimmen
gereuen	NN	1	gereuen
Erfüllung	NN	1	Erfüllung
ausfündig	JJ	1	ausfündig
horchen	VB	1	horchen
erwählen	NN	1	erwählen
ungestümes	NN	1	ungestümes
vernünftig	JJ	1	vernünftig
schallen	VB	1	schallen
Freierei	NN	1	Freierei
getreust	JJ	1	getreuste
gescheh	JJ	1	geschehen
Misstrauen	NN	1	Mißtrauen
unersetzlich	JJ	1	unersetzlichen
Jener	NNP	1	Jener
scheint	JJ	1	scheint
wundern	RP	1	gewundert
ohngeachtet	NN	1	ohngeachtet
Hase	NNS	1	Hasen
aufrichtiger	NN	1	aufrichtiger
tragen	VB	1	tragen
Verzeihungen	NN	1	Verzeihungen
närrisch	JJ	1	närrischen
tauschen	VB	1	tauschen
höret	VB	1	höret
aufrichtigen	NN	1	aufrichtigen
quält	NN	1	quält
flüchtig	JJ	1	flüchtig
ungetreuer	NN	1	ungetreuer
morgen	RB	1	morgen
Gelder	NN	1	Gelder
Begreifen	VB	1	Begriffe
traurige	NN	1	traurige
Nötiges	NN	1	Nötiges
Erschrecken	NN	1	Erschrecken
übereinstimmen	VB	1	übereinstimmen
Alles	NN	1	Alles
Könntet	NN	1	Könntet
Widern	VB	1	Wider
aufzuhelfen	NN	1	aufzuhelfen
tausend	CD	1	tausend
empfindlichern	VB	1	empfindlicher
Rechts	NN	1	Rechts
Seite	NN	1	Seite
verborgen	VBN	1	verborgen
verblendenden	NN	1	verblendenden
stolze	NN	1	stolze
erwählt	NN	1	erwählt
inständig	JJ	1	inständig
Unwürdigen	NN	1	Unwürdigen
nachteilige	NN	1	nachteilige
versuchten	NN	1	versuchten
tot	JJ	1	tot
drauf	RB	1	drauf
naseweis	JJ	1	naseweis
rasend	JJ	1	rasend
Erleichterung	NN	1	Erleichterung
kützeln	NN	1	kützeln
Findet	NN	1	Findet
genennet	NN	1	genennet
bekömmt	NN	1	bekömmt
zuschreiben	VB	1	zuschreiben
zugestehen	VB	1	zugestehen
erstaunet	NN	1	erstaunet
schämen	VB	1	schämen
Verräterei	NN	1	Verräterei
Galgenschwengeln	NNP	1	Galgenschwengeln
Mühle	NN	1	Mühle
werde	RB	1	werde
Erfahrung	NN	1	Erfahrung
Verzeihen	NN	1	Verzeihen
tadeln	VB	1	tadeln
liebenswürdigen	JJ	1	liebenswürdigen
frei	JJ	1	frei
meinern	VB	1	meiner
unerträglich	JJ	1	unerträglich
Niederträchtig	JJ	1	Niederträchtig
suchte	NN	1	suchte
Vielleichen	VBN	1	Vielleicht
Teil	NN	1	Teil
geliebt	NN	1	geliebt
begleiten	PRP$	1	begleiten
zukommen	PRP$	1	zukommen
lässen	VB	1	läßt
hinlänglich	JJ	1	hinlänglich
Licht	NN	1	Licht
ausschütten	VB	1	ausschütten
Haar	NN	1	Haar
hinderlich	JJ	1	hinderlich
Abschied	NN	1	Abschied
12000	CD	1	12000
Füssen	NNP	1	Füßen
irren	VB	1	irren
hassen	VB	1	hassen
gesunden	PRP$	1	gesunden
schlüge	NN	1	schlüge
auszuhalten	NN	1	auszuhalten
Geniessen	NN	1	Genießen
unnötig	JJ	1	unnötig
schlimm	JJ	1	schlimm
dahinter	RB	1	dahinter
Stark	NN	1	Stark
Narr	NN	1	Narr
Fehlers	NN	1	Fehlers
falle	NN	1	falle
wunderlich	JJ	1	wunderlich
erschrecken	VB	1	erschrecken
einzusehen	NN	1	einzusehen
Gleichgewichte	NN	1	Gleichgewichte
dahin	RB	1	dahin
vermögend	JJ	1	vermögend
Dienerin	NN	1	Dienerin
ankommen	VB	1	ankommen
anwendeten	NN	1	anwendeten
wodurch	WRB	1	wodurch
weisst	NN	1	weißt
Herzens	NN	1	Herzens
vielmalten	VBN	1	vielmal
bittet	VB	1	bittet
Feuer	NN	1	Feuer
schlecht	JJ	1	schlecht
beschimpfen	VB	1	beschimpfet
erzürnet	NN	1	erzürnet
abzuwaren	VB	1	abzuwarten
Kurz	NN	1	Kurz
Gegenliebe	NN	1	Gegenliebe
albern	JJ	1	albern
nahe	RP	1	nahe
Hause	NN	1	Hause
schamhaft	NN	1	schamhaft
vollkommen	JJ	1	vollkommene
Verflucht	NN	1	Verflucht
Gemüt	NN	1	Gemüt
Leute	NN	1	Leute
welchem	WP	1	welchem
Behüte	NN	1	Behüte
vorteilhaftesten	NN	1	vorteilhaftesten
Geschlechts	NN	1	Geschlechts
Gegengunst	NN	1	Gegengunst
umschreiben	VB	1	umschreiben
Liebeserklärungen	NN	1	Liebeserklärungen
zärtlichst	JJ	1	zärtlichste
erwägen	VB	1	erwägen
genennt	NN	1	genennt
niederträchtigen	NN	1	niederträchtigen
stärk	JJ	1	stärker
Erklärungen	NN	1	Erklärungen
ewig	JJ	1	ewig
kaltsinnig	RB	1	kaltsinnig
unüberwindlich	JJ	1	unüberwindlichen
verpflichten	VBN	1	verpflichtet
entzückende	NN	1	entzückende
durchaus	RB	1	durchaus
uneigennützigst	JJ	1	uneigennützigsten
Verschwiegenheit	NN	1	Verschwiegenheit
Tauschen	VB	1	Tauschen
Versuchen	NN	1	Versuchen
Kapitalten	VB	1	Kapitalen
Scherz	NN	1	Scherz
zaudern	NN	1	zaudern
hättest	WRB	1	hättest
ausschweifende	NN	1	ausschweifende
Umstand	NNS	1	Umstände
dumm	JJ	1	dumme
entschuldigen	VB	1	entschuldigen
Halt	NN	1	Halt
anderern	VB	1	anderer
Gunstbezeigungen	NN	1	Gunstbezeigungen
übrigen	VBN	1	übrig
vorhin	RB	1	vorhin
Streich	JJ	1	Streich
balden	VBN	1	bald
Glücklichste	NN	1	Glücklichste
solle	NN	1	solle
besonder	JJ	1	besonderes
beinahe	WRB	1	beinahe
Galimathias	NNP	1	Galimathias
Vollkommen	NN	1	Vollkommen
grösstes	NN	1	größtes
oft	IN	1	oft
Seit	IN	1	Seit
Schelmstück	NN	1	Schelmstück
Vorwande	NN	1	Vorwande
recht	VB	1	recht
hintergangen	NN	1	hintergangen
jemand	DT	1	jemand
darbien	VB	1	darbieten
menschlich	JJ	1	menschlichen
schätzte	NN	1	schätzte
Mitleiden	NN	1	Mitleiden
auchen	VBN	1	auch
beschämt	JJ	1	beschämt
kostbar	JJ	1	kostbare
Einfallen	NN	1	Einfallen
aushalten	NN	1	aushalten
Leibesbeschaffenheit	NN	1	Leibesbeschaffenheit
müd	JJ	1	müde
geleg	JJ	1	gelegen
ausholen	VB	1	ausholen
Dienste	NN	1	Dienste
Verbrechen	NN	1	Verbrechen
Soldatenmode	NN	1	Soldatenmode
lernen	VB	1	lernen
unserer	PRP$	1	unserer
einsehen	VB	1	einsehen
ausstehen	NN	1	ausstehen
stehen	VB	1	steht
Jahre	NN	1	Jahre
Hab	NN	1	Hab
Wen	NN	1	Wen
Schluss	NN	1	Schluß
zugestossen	NN	1	zugestoßen
schimpfte	NNP	1	schimpfte
Stande	NN	1	Stande
Glücklichsten	NN	1	Glücklichsten
allerliebster	NN	1	allerliebster
wirst	WRB	1	wirst
güldne	NN	1	güldne
Einöde	NN	1	Einöde
nunmehr	IN	1	nunmehr
Entschlusses	NN	1	Entschlusses
verinteressiert	NN	1	verinteressiert
dagegen	RB	1	dagegen
beurteilen	VB	1	beurteilt
Königin	NN	1	Königin
Heute	RB	1	Heute
Gemüter	NN	1	Gemüter
besen	NN	1	beste
vermuteten	NN	1	vermuteten
hintergehen	NN	1	hintergehen
Bestreben	NN	1	Bestreben
Ansehung	NN	1	Ansehung
merken	VB	1	merke
beschieden	NN	1	beschieden
schwiegen	NN	1	schwiegen
anzuvertrauen	VB	1	anzuvertrauen
Bauersfrau	NN	1	Bauersfrau
Vertrauen	NN	1	Vertrauen
Reich	VB	1	Reichen
eifersüchtigen	VBN	1	eifersüchtig
gleichwo	NN	1	gleichwo
nachzusetzen	NN	1	nachzusetzen
geh	NN	1	geh
fliehen	VB	1	fliehen
Notwendigkeit	NN	1	Notwendigkeit
Waage	NN	1	Waage
nichte	NN	1	nichte
falsch	JJ	1	falsche
Munde	JJ	1	Munde
Anhalten	NN	1	Anhalten
standhafte	NN	1	standhafte
ungesund	NN	1	ungesund
schwer	JJ	1	schwerer
beschwerlich	JJ	1	beschwerlich
Freunden	NN	1	Freunden
Knall	NN	1	Knall
Madamen	JJ	1	Madam
Lieben	NN	1	Lieben
gehe	NN	1	gehe
schüchtern	JJ	1	schüchtern
eingelaufen	NN	1	eingelaufen
Zeug	NNS	1	Zeuge
Verdriessliche	JJ	1	Verdrießliche
blindlings	IN	1	blindlings
beizustehen	NN	1	beizustehen
stehet	NN	1	stehet
Verlassen	NN	1	Verlassen
übereilet	NN	1	übereilet
Wolfe	NN	1	Wolfe
gäbe	NN	1	gäbe
erkundigen	VB	1	erkundigen
herausfordern	NN	1	herausfordern
liebsten	NN	1	liebsten
schimpft	NN	1	schimpft
bösen	NN	1	bösen
fähig	JJ	1	fähig
setzten	NN	1	setzten
beisteh	DT	1	beistehen
unvergeblich	JJ	1	unvergeblich
Wählen	NN	1	Wählen
Angesicht	NN	1	Angesicht
Notlügen	NN	1	Notlügen
klug	JJ	1	klug
Philosophin	NN	1	Philosophin
mitbringen	VB	1	mitbringen
Entschlusse	NN	1	Entschlusse
verhasst	NN	1	verhaßt
nützlich	JJ	1	nützlich
Reue	NN	1	Reue
Vater	NN	1	Vater
geschwind	RP	1	geschwind
versichert	NN	1	versichert
gottlose	NN	1	gottlose
Ohre	NN	1	Ohre
würfeln	VB	1	würfeln
verzeiht	NNP	1	verzeiht
Antwort	NN	1	Antwort
Schale	NN	1	Schale
ostindisch	JJ	1	ostindische
Anblick	NN	1	Anblick
lass	JJ	1	laß
finde	NN	1	finde
Gerechter	NN	1	Gerechter
vorhalte	NN	1	vorhalte
Neugierigkeit	NN	1	Neugierigkeit
Tode	NN	1	Tode
Versichern	NN	1	Versichern
Fehler	NN	1	Fehler
Urteilen	NN	1	Urteilen
Frauenzimmers	NN	1	Frauenzimmers
Unruhe	NN	1	Unruhe
Lob	NNS	1	Lobe
zufried	JJ	1	zufrieden
gewisseste	JJ	1	gewisseste
jemanden	NN	1	jemanden
besinnen	VB	1	besinnen
kämpfen	VB	1	kämpfen
vertrauen	VB	1	vertrauen
gedulden	NN	1	gedulden
weiss	VB	1	weiß
gebe	NN	1	gebe
Sei	NN	1	Sei
Ganze	NN	1	Ganze
Schweig	JJ	1	Schweig
zehn	CD	1	zehn
Wisset	NN	1	Wisset
weder	CC	1	weder
Verziehn	NN	1	Verziehn
Kannst	NN	1	Kannst
betrifft	VB	1	betrifft
heraus	RB	1	heraus
Geh	NN	1	Geh
entzogen	NN	1	entzogen
Tugend	NN	1	Tugend
Erlauben	NN	1	Erlauben
Ansehen	NN	1	Ansehen
Könnten	NN	1	Könnten
unschuldig	JJ	1	unschuldig
Rechenschaft	NN	1	Rechenschaft
Rockknöpfe	NN	1	Rockknöpfe
andres	NN	1	andres
schaden	VB	1	schaden
löblich	JJ	1	löbliche
fest	RB	1	fest
Floh	NN	1	Floh
teilen	VB	1	teilen
Liebste	NN	1	Liebste
ins	IN	1	ins
schuld	NN	1	schuld
fühlen	VB	1	fühle
entziehen	VB	1	entziehen
vorfallender	NN	1	vorfallender
Vorurteil	NN	1	Vorurteil
glaube	VB	1	glaube
bewahren	VB	1	bewahren
sehren	VB	1	sehr
möge	RB	1	möge
Treue	NN	1	Treue
Nachwelt	NN	1	Nachwelt
vorzubringen	VB	1	vorzubringen
Reizungen	NN	1	Reizungen
lahm	JJ	1	lahm
Geiz	NN	1	Geiz
geholfen	NN	1	geholfen
nütze	NN	1	nütze
Grab	NN	1	Grab
besorgten	NN	1	besorgten
Unwürdigern	NN	1	Unwürdigern
verblendet	NN	1	verblendet
Arbeit	NN	1	Arbeit
eingenommen	NN	1	eingenommen
Wertester	NN	1	Wertester
verlören	NN	1	verlören
ändern	RP	1	geändert
Unkosten	NN	1	Unkosten
kurzen	NN	1	kurzen
besitze	NN	1	besitze
berede	NN	1	berede
verachtungswürdiger	NN	1	verachtungswürdiger
Liebst	JJ	1	Liebster
sau	JJ	1	sauer
lachen	VB	1	lacht
geirret	NN	1	geirret
auszusöhnen	NN	1	auszusöhnen
Zweifelt	NN	1	Zweifelt
Unsere	PRP$	1	Unsere
Niemand	NN	1	Niemand
wüsste	NN	1	wüßte
scheinet	NN	1	scheinet
hierinne	NN	1	hierinne
niederträchtiger	NN	1	niederträchtiger
entdeckten	NN	1	entdeckten
verunglücket	NN	1	verunglücket
gewuchert	NN	1	gewuchert
schw	JJ	1	schwer
Narren	NN	1	Narren
Welch	JJ	1	Welchen
beurteile	NN	1	beurteile
Nebenbuhlern	NN	1	Nebenbuhlern
Vereinigung	NN	1	Vereinigung
gehässiger	NNP	1	gehässiger
Bettlerin	NN	1	Bettlerin
glücklichen	VBN	1	glücklich
lasst	WRB	1	laßt
Schwäche	NN	1	Schwäche
Geschicklichkeit	NN	1	Geschicklichkeit
schäme	NN	1	schäme
besess	JJ	1	besessen
Häusern	NN	1	Häusern
brechen	VB	1	brechen
Schäfchen	VB	1	Schäfchen
Allein	NN	1	Allein
abwarten	VB	1	abwarten
sagten	NN	1	sagten
erleichtern	VB	1	erleichtern
edle	NN	1	edle
Zufalle	NN	1	Zufalle
prächtig	JJ	1	prächtig
gewinnen	VB	1	gewinnen
Zwei	CD	1	Zwei
wen	WP	1	wen
Geier	NN	1	Geier
Verlust	NN	1	Verlust
niemals	RB	1	niemals
parat	JJ	1	parat
vermutet	NN	1	vermutet
Bundes	NN	1	Bundes
hat	RB	1	hat
gewollt	NN	1	gewollt
wundersam	JJ	1	wundersam
bin	JJ	1	bin
begegnen	VB	1	begegnet
einzigen	VB	1	einzige
Abends	NN	1	Abends
klugen	VBN	1	klug
Vorwand	NN	1	Vorwand
beunruhigen	VB	1	beunruhigen
neuem	NN	1	neuem
Zärtliche	RB	1	Zärtliche
Lebt	NN	1	Lebt
beunruhiget	NN	1	beunruhiget
schlagen	VB	1	schlagen
abzulaufen	VB	1	abzulaufen
Kohle	NNS	1	Kohlen
Damons	NN	1	Damons
schonen	VBN	1	schon
erste	RB	1	erste
Vernunft	NN	1	Vernunft
trockne	NN	1	trockne
Darf	NN	1	Darf
Sperlinge	NN	1	Sperlinge
jaten	RP	1	ja
vernehmen	RP	1	vernommen
vorstelle	NN	1	vorstelle
Empfindung	NNS	1	Empfindungen
Regel	NN	1	Regel
verdammen	VB	1	verdammen
Geldern	NN	1	Geldern
versteht	JJ	1	versteht
liebt	NN	1	liebt
klüger	NN	1	klüger
garen	VB	1	gar
sagt	VB	1	sagt
Lisett	NN	1	Lisette
hinter	IN	1	hinter
Bosheit	NN	1	Bosheit
niemalsen	VB	1	niemals
aufbringen	VB	1	aufbringen
Beifall	NN	1	Beifall
wahren	VB	1	wahre
seinetwegen	JJ	1	seinetwegen
Könnte	NN	1	Könnte
vorgesucht	NN	1	vorgesucht
Nehmen	VB	1	Nehmen
ums	IN	1	ums
Punkt	NN	1	Punkt
gehören	VB	1	gehöret
bemühen	VB	1	bemühen
Tagen	NN	1	Tagen
stehlen	VB	1	gestohlen
Sammelplatz	NN	1	Sammelplatz
Befürchten	NN	1	Befürchten
vergeben	VB	1	vergeben
ungestüm	JJ	1	ungestüm
lossprechen	VBN	1	lossprechen
führen	VB	1	führt
Maus	NN	1	Maus
entzücket	NN	1	entzücket
acht	CD	1	acht
sag	NN	1	sag
habt	NN	1	habt
verachtungswert	NN	1	verachtungswert
binden	VB	1	binden
hergekommen	NN	1	hergekommen
anfängt	VBN	1	anfängt
Itzo	NN	1	Itzo
Wichtigen	VB	1	Wichtige
Bräutigam	NN	1	Bräutigam
nötig	JJ	1	nötige
geizig	JJ	1	geizig
Jugend	NN	1	Jugend
verschweigen	VB	1	verschweigen
ausdrücklich	RB	1	ausdrücklich
Setzen	NN	1	Setzen
entzückt	NN	1	entzückt
befreien	VB	1	befreien
gründen	VB	1	gegründet
Antrage	NN	1	Antrage
Seits	NN	1	Seits
erworbener	NN	1	erworbener
verderben	VB	1	verderben
schlage	NN	1	schlage
woran	WDT	1	woran
eitel	JJ	1	eitel
Geldes	NN	1	Geldes
Wesentlichen	NN	1	Wesentlichen
Feindschaft	NN	1	Feindschaft
fern	JJ	1	fern
Alsdenn	NN	1	Alsdenn
verursachen	VB	1	verursachen
aufzuopfern	NN	1	aufzuopfern
abfinden	PRP$	1	abfinden
Hartnäckigkeit	NN	1	Hartnäckigkeit
entschlassen	VB	1	entschließen
nähern	VBN	1	näher
dürfte	VB	1	dürfte
verargen	NN	1	verargen
vermögen	VB	1	vermöge
dran	RP	1	dran
ausnehmende	NN	1	ausnehmende
gäben	NN	1	gäben
unbillig	JJ	1	unbillig
Bald	NN	1	Bald
beleidigten	NN	1	beleidigten
Rtlr	NN	1	Rtlr
Geheimnis	NN	1	Geheimnis
Zweck	NN	1	Zweck
aufgehört	NN	1	aufgehört
sähe	NN	1	sähe
war	VB	1	war
tändeln	NN	1	tändeln
zählen	VB	1	zählt
übrig	JJ	1	übrig
kostbarste	NN	1	kostbarste
davor	RB	1	davor
wenigst	JJ	1	wenigsten
ltzo	NN	1	ltzo
wiederholte	NN	1	wiederholte
artige	JJ	1	artige
häufig	JJ	1	häufig
Herren	NN	1	Herren
fort	RP	1	fort
erdichtete	NN	1	erdichtete
verkündigen	VBN	1	verkündigt
Frauenzimmer	NN	1	Frauenzimmer
Voll	NN	1	Voll
sterben	VB	1	sterbe
munter	JJ	1	munter
verdammte	NN	1	verdammte
widerfahren	NN	1	widerfahren
prächtige	NN	1	prächtige
Sollte	NN	1	Sollte
ungeschickt	JJ	1	ungeschickt
Dienen	NN	1	Dienen
bewaffnet	JJ	1	bewaffnet
Grausamer	NN	1	Grausamer
Begierde	NN	1	Begierde
Entdecken	NN	1	Entdecken
treten	VB	1	treten
willen	IN	1	willen
Dessen	WDT	1	Dessen
Wucher	NN	1	Wucher
streite	NN	1	streite
zärtlichsten	NN	1	zärtlichsten
gelangen	PRP$	1	gelangen
loben	VB	1	loben
Tränen	NN	1	Tränen
keins	NN	1	keins
wert	RP	1	wert
teilten	NN	1	teilten
Banquerouten	NN	1	Banquerouten
schweig	JJ	1	schweig
zanken	NN	1	zanken
Anbeter	NN	1	Anbeter
redete	NN	1	redete
erholen	VB	1	erholen
Freundin	NN	1	Freundin
unwahrscheinlich	JJ	1	unwahrscheinlich
vorsagen	VBN	1	vorgesagt
verliebte	NN	1	verliebte
Antrag	NN	1	Antrag
Versuch	NN	1	Versuch
Erstaunen	NN	1	Erstaunen
weichet	NN	1	weichet
Zwischen	IN	1	Zwischen
vorzuwerfen	VB	1	vorzuwerfen
einigermassen	RB	1	einigermaßen
Verdrusse	NN	1	Verdrusse
Mährgen	IN	1	Mährgen
Fällen	NN	1	Fällen
täten	NN	1	täten
unerschrocknen	NN	1	unerschrocknen
Eigennutz	NN	1	Eigennutz
nähmen	NN	1	nähmen
Aufrichtig	IN	1	Aufrichtig
geheim	JJ	1	geheime
niederträchtige	NNP	1	niederträchtige
unschmackhaft	PRP$	1	unschmackhaft
ersetzen	VB	1	ersetzen
wohlgemachte	NN	1	wohlgemachte
holen	VB	1	holt
Schmerz	NN	1	Schmerz
Alsdann	NNP	1	Alsdann
irr	JJ	1	irre
