Title: Die Juden
Number of all lemmas: 3563
Nummber of different lemmas: 1762

Lemma	POS	Frequency	Tokens
Herr	NN, JJ	49	Herr
sagen	VBN, VB	37	gesagt, sagt, sagen, sage, sagte
wohl	RB, RP, IN	29	wohl
Dose	NN	26	Dose
Jude	NNS, NN	24	Juden, Jude
glauben	VB, VBN	24	glaube, glauben, glaubt, geglaubt, glaubte
gut	JJ	23	gut, guter, guten, gute, gutem
Herrn	NN, NNP, JJ	22	Herrn
meine	PRP$	22	meine
sehen	VB, RP, VBN, RB	20	sieht, gesehen, sehen, seht
wenig	IN, DT, WRB, JJ, RB, RP	20	wenig, wenige, wenigen
Vogt	NNP, NN	19	Vogt
Freund	NN, NNS	19	Freund, Freunde
wahr	RP, RB	18	wahr
nehmen	VB, RP, RB	17	nimmt, nehme, genommen, nehmen
ehrlich	JJ	16	ehrlichen, ehrlicher, ehrliches
gewiss	NN, JJ	15	gewiß, gewissen, gewisser
gar	RB, RP	15	gar
eben	RB	14	eben
weeissen	VB	14	weiß
wissen	VB, RB	13	wissen
Mann	NN	13	Mann
denken	VB, VBN	13	denken, denke, dachte
ist	VB, JJ	11	ist
lieb	JJ, VB	11	lieben, liebe, lieber
Hand	NN	11	Hand
Lisette	NN, NNP	11	Lisette
fragen	VB, VBN	11	fragen, fragt, gefragt
Ei	NN	11	Ei
Papa	NN	11	Papa
Allein	NN, RB	11	Allein
stehen	NN, VB, RB	11	steht, stehen
ha	NN	11	ha
Ach	NN	10	Ach
Kerl	NNS, NN	10	Kerle, Kerl
finden	VB, VBN, RB	10	fand, finden, gefunden
andre	NN	9	andre
Uhr	NN	9	Uhr
gehabt	NN, NNP	9	gehabt
erst	RB, JJ, IN, RP	9	erst, erste
Ihrem	NN, JJ	9	Ihrem
reden	VB, PRP$	9	reden, rede
Freundschaft	NN, JJ	9	Freundschaft
rechen	VB	9	rechten, recht, rechte
Herz	NN, NNS	8	Herz, Herzen
kömmen	MD	8	kömmt
bitten	VB, VBN	8	bitten, bitte, gebeten
Vergnügen	NN	8	Vergnügen
soen	RB, VBN, VB	8	so
Zeit	NN	8	Zeit
Wahrheit	NN	8	Wahrheit
meines	NN, IN, JJ	8	meines
sehe	PRP$	8	sehe
Bart	NN, NNP	8	Bart
gern	RP, IN, RB	8	gern
bald	RB, WRB	8	bald
Diener	NNP, NN	8	Diener
Seite	NN	7	Seite
Geier	NN	7	Geier
Ha	NN	7	Ha
vielleicht	RB	7	vielleicht
fort	RP, JJ, RB	7	fort
deswegen	RB, IN	7	deswegen
Verdacht	NN, NNS	7	Verdacht, Verdachte
gross	JJ	7	groß, großer, großes, große, großen
unser	PRP$	7	unser
sonst	RB, WRB	7	sonst
Gott	NN	7	Gott
befehlen	VBN, VB, RP	7	befohlen, befehlen
Nu	NN	7	Nu
ichs	NN	7	ichs
Glück	NN	7	Glück
Vielleicht	RB, IN, RP	7	Vielleicht
Christ	NNS, NN	7	Christen, Christ
Fräulein	NN, NNP	6	Fräulein
Bedienten	NN, NNP	6	Bedienten
Geschenk	NN	6	Geschenk
läng	JJ, RB	6	länger
Vermögen	NN	6	Vermögen
lange	RB, RP	6	lange
ei	RP	6	ei
Leute	NN, NNP	6	Leute
Mamsell	NN	6	Mamsell
Teufel	NN	6	Teufel
Umstand	NNS	6	Umstände
Stande	NN	6	Stande
dumm	JJ, RB	6	dummer, dumm
klug	JJ	6	klug, kluges
sitzen	VB	6	sitzen, sitze
weit	JJ	6	weit
sind	VB, JJ, RB	6	sind
Gut	NN	6	Gut
zufried	JJ	6	zufrieden
Liebe	NN	6	Liebe
seid	NN	6	seid
Frage	NN	5	Frage
Verzeihen	NN	5	Verzeihen
schenken	VBN, VB	5	geschenkt, schenken
klein	JJ	5	kleine, klein, kleinen
gehn	NN	5	gehn
beinahe	RB, RP	5	beinahe
leiden	VB, VBN	5	leiden, leid
verstehen	VBN, VB	5	verstanden, versteht, verstehe
Bitte	NN, NNS	5	Bitte, Bitten
Tag	NN	5	Tag
gestern	IN, RB	5	gestern
kann	VB, RB	5	kann
wert	RB, RP	5	wert
verdienen	VB	5	verdient, verdienen
lernen	VB, VBN	5	lernen, gelernt, lerne
Grobheit	NN	5	Grobheit
kennen	VB	5	kennen, kenne
Menschen	NN	5	Menschen
Ehre	JJ, NN	5	Ehre
begleiten	VB	5	begleiten, begleitet
Mühe	NN	5	Mühe
fallen	VB, VBN	5	fallen
Spass	NN	5	Spaß
Namen	NN	5	Namen
gestehn	NN	5	gestehn
bin	VB, JJ	5	bin
bös	JJ	5	böse
Vermutung	NN, NNS	5	Vermutung, Vermutungen
silberne	NN	5	silberne
könnte	VB, RB	5	könnte
Ernst	NNP, NN	5	Ernst
etwa	RB, RP	5	etwa
setzen	VB, VBN	5	setzt, gesetzt, setzen
Wohltat	NN	5	Wohltat
jung	JJ	5	junge, jung, junger, jungen
allein	RB, RP	5	allein
Eure	NN	4	Eure
kaum	RB	4	kaum
verschwiegen	NN	4	verschwiegen
übel	JJ	4	übel
weniger	RB	4	weniger
Gedanke	NNS	4	Gedanken
Bedienter	NN	4	Bedienter
Tochter	NN	4	Tochter
Dienste	NN	4	Dienste
andern	DT	4	andern
näh	JJ	4	näher
genug	RB, RP, NNP	4	genug
Garten	NN	4	Garten
weiss	VB	4	weiß
Krumm	NNP	4	Krumm
nu	UH	4	nu
Grossmut	NN	4	Großmut
Flucht	NN	4	Flucht
Vergeltung	NN	4	Vergeltung
Dieb	NNS, NN	4	Diebe, Dieb
Tobaksdose	NN	4	Tobaksdose
unsern	PRP$	4	unsern
Leuten	NN	4	Leuten
Martin	NNP	4	Martin
hören	VB	4	hören, hört
Jahr	NN	4	Jahr
dergleichen	PRP	4	dergleichen
Abreise	NN	4	Abreise
meinigen	NN	4	meinigen
verstehs	NN	4	verstehs
hör	NN, JJ	4	hör, höre
besser	RB, RP	4	besser
habt	NN	4	habt
nötig	JJ	4	nötig
fein	JJ	4	fein, feinen
geirrt	NN	4	geirrt
dienen	VB, VBN	4	dienen
Kleinigkeit	NN	4	Kleinigkeit
Recht	NN	4	Recht
Schuldigkeit	NN	4	Schuldigkeit
Henker	NN	4	Henker
Reden	NN	4	Reden
bekommen	VB, VBN	4	bekommen
höchst	JJ	4	höchst
heuen	VB, VBN	4	heute
übereilt	NN	4	übereilt
selb	DT	4	selber
antworen	VB	4	antworten
Händen	NN	4	Händen
Jungfer	NN	4	Jungfer
unschuldig	JJ	4	unschuldig
erkenntlich	JJ	4	erkenntlich, erkenntliches
leicht	JJ	4	leicht, leichter
Frauenzimmers	NN	4	Frauenzimmers
Himmel	NN	4	Himmel
wenigstens	RB	4	wenigstens
Augen	JJ, NN	4	Augen
Gefahr	NN	4	Gefahr
älter	NN	4	älter
vorhin	RB, RP, IN	4	vorhin
zeigen	VB, RP	4	zeigen, zeigt, gezeigt
jetzen	VBN, VB	4	jetzt
gefallen	VB, RP	4	gefallen
sehn	NN	4	sehn
allezeit	NN	4	allezeit
suchen	VB	4	suchen, sucht
entdecken	VB	4	entdecken
greifen	VB, VBN	4	greifen, griff, gegriffen
freilich	RB, RP	4	freilich
schöne	NN	3	schöne
reissen	VBN, VB	3	gerissen, riß
verfolgen	VB	3	verfolgen, verfolgt
Dankbarkeit	NN	3	Dankbarkeit
annehmen	VB	3	angenommen, annehmen
muss	VB	3	muß
heraus	RB, RP	3	heraus
kehren	VB	3	kehren
Augenblick	NN, NNP	3	Augenblick
Stunde	NN	3	Stunde
tragen	VBN, VB	3	getragen, trägt, trugen
falsch	JJ	3	falschen, falsch
deiner	PRP$	3	deiner
Dero	NN	3	Dero
Wort	NNS, NN	3	Wörter, Wort
unschätzbar	PRP$, JJ	3	unschätzbar, unschätzbare
laufen	VB	3	läuft, gelaufen, laufen
angenehm	JJ	3	angenehmen, angenehme, angenehmer
Räuber	NN	3	Räuber
Jahre	NN	3	Jahre
erhalten	VB, VBN	3	erhalten, erhält
stehlen	VB, VBN	3	stehlen, gestohlen
Zweifel	NN	3	Zweifel
Fasson	NN	3	Fasson
sprechen	VB	3	sprechen
Wollte	NN	3	Wollte
niemals	RB, WRB	3	niemals
lieben	VB	3	liebe
beschwerlich	JJ	3	beschwerlich
Volk	NN	3	Volk
gehören	VBN, RP, VB	3	gehört
mirs	NN	3	mirs
behaupten	VB	3	behaupten
Unrecht	NN, JJ	3	Unrecht
ertappt	NN	3	ertappt
unserm	PRP$	3	unserm
Fremden	NN	3	Fremden
davonen	VB	3	davon
erweisen	VBN, VB	3	erwiesen, erweisen
Munde	NN	3	Munde
wollensen	MD	3	wollens
schuldig	JJ	3	schuldig
Ah	NN	3	Ah
ähnlich	JJ, VB	3	ähnlicher, ähnlich
gehe	NN	3	gehe
sau	JJ	3	sauer
Schnupftabaksdose	NN, NNP	3	Schnupftabaksdose
Furcht	NN	3	Furcht
Weg	NN	3	Weg
Gesetzt	NN	3	Gesetzt
dazuen	VB	3	dazu
verlegen	VB	3	verlegen
merken	VB	3	merken, merke, gemerkt
umbringen	VB	3	umbringen
unsre	PRP$	3	unsre
Sache	NN	3	Sache
gering	JJ	3	geringes, geringen, geringer
erzeigen	VB, NN	3	erzeigt, erzeigen
hieher	NN	3	hieher
Euren	NN	3	Euren
Mantelsäcke	NN	3	Mantelsäcke
einander	PRP	3	einander
Verdrüsslichkeiten	NN	3	Verdrüßlichkeiten
gleichwohl	RB	3	gleichwohl
Exempel	NN	3	Exempel
empfindlich	JJ	3	empfindlich
Reise	NN	3	Reise
alsdann	NNP	3	alsdann
komm	NN	3	komm
damien	VB	3	damit
werfen	VB, RP	3	werfe, geworfen
Mords	NN	3	Mords
Dosen	NN	3	Dosen
erlauben	VB, VBN, RP	3	erlauben, erlaubt
bedeuten	VB, VBN	3	bedeutet, bedeuten
nimmermehr	NN	3	nimmermehr
endlich	RP, RB	3	endlich
Hunger	NN	3	Hunger
abpacken	NN	3	abpacken
Hurtig	JJ	3	Hurtig
urteilen	VB	3	urteilen
silbernen	NN	3	silbernen
Hören	NN	3	Hören
Könnte	NN	3	Könnte
Ursach	JJ, VB	3	Ursachen
Dank	IN	3	Dank
lass	JJ, VB	3	laß, lasse
Durst	NN	3	Durst
verlassen	VB	3	verlassen
fällen	VB, RP	3	gefällt
redt	NNP	3	redt
Pferde	NN	3	Pferde
hinter	IN	3	hinter
allgemein	JJ	3	allgemeine, allgemeiner, allgemein
Frauenzimmer	NN	3	Frauenzimmer
dringen	VB	3	drängen, dringen, drang
lügen	VB, VBN	3	lügen, gelogen
Leben	NN	3	Leben
dafüren	VB	3	dafür
nochen	VB	3	noch
gedenken	VB, VBN	3	gedenken, gedacht
dahin	RP	3	dahin
Paar	NN	3	Paar
Meilen	NN	3	Meilen
verbinden	VB	3	verband, verbinden
Stunden	NN	3	Stunden
wild	JJ	3	wilde, wild
Verwirrung	NN, NNS	3	Verwirrung, Verwirrungen
oft	RB	3	oft
Drum	NN	3	Drum
zwei	CD	3	zwei
wär	NN, JJ	3	wär, wären
Gewiss	UH, DT	3	Gewiß, Gewisse
schäme	NN	3	schäme
Säue	NN	2	Säue
Sprache	NN	2	Sprache
jemals	RB	2	jemals
beleidigen	VB	2	beleidigen, beleidigt
neu	JJ	2	neuen, neue
bezahlen	VB	2	bezahlen
Unglücke	NN	2	Unglücke
Mangel	NN	2	Mangel
dankbar	JJ	2	dankbar
Gefälligkeit	NN	2	Gefälligkeit
Acht	NN	2	Acht
hieren	VB, VBN	2	hier
Mantelsack	NN	2	Mantelsack
zuwider	NN	2	zuwider
zielen	VB	2	zielen
Neugierde	NN	2	Neugierde
Hülfe	NN	2	Hülfe
verstellt	NN	2	verstellt
verbindlich	JJ	2	verbindlich
Antrag	NN	2	Antrag
Ihrigen	JJ, NN	2	Ihrigen
daraufen	VB	2	darauf
spazieren	VB	2	spazieren
wussen	VB	2	wußte
bedanken	VB	2	bedanken
vermisse	NN	2	vermisse
Macht	NN	2	Macht
umsonst	RB, RP	2	umsonst
sollens	NN, JJ	2	sollens
kurzen	NN	2	kurzen
anfangen	VB	2	anfangen
schämen	VB	2	schämen
vermuten	VB	2	vermuten
brav	JJ	2	brav, braver
Neugierigkeit	NN	2	Neugierigkeit
allzugütig	JJ	2	allzugütig
Schuld	NN	2	Schuld
entfliehen	VB	2	entfliehen
Aufsicht	NN, NNP	2	Aufsicht
angefallen	VBN	2	angefallen
Sies	RB	2	Sies
Genugtuung	NN	2	Genugtuung
wenden	VB	2	wendet
ordentlich	JJ	2	ordentliche, ordentlicher
wüsste	NN	2	wüßte
dächte	NN	2	dächte
ohngefähr	NN	2	ohngefähr
Eigenschaft	NNS	2	Eigenschaften
verlange	NN	2	verlange
gewinnen	VB, VBN	2	gewonnen
Anerbieten	NN	2	Anerbieten
Schulze	NN	2	Schulze
Sagen	NN	2	Sagen
Art	NN	2	Art
zärtlich	JJ	2	zärtliche, zärtlichen
Arm	NNS, NN	2	Arme, Arm
Punkt	NN	2	Punkt
hundertmal	RB	2	hundertmal
Mannspersonen	NN	2	Mannspersonen
verschweigen	VB	2	verschweigen
reeissen	VB	2	reißen
schätzbar	JJ	2	schätzbar
Erstaunen	NN	2	Erstaunen
Wohlstands	NN	2	Wohlstands
Engeland	NN	2	Engeland
Stehlen	JJ, NN	2	Stehlen
entdeckt	NN	2	entdeckt
ansehen	VBN	2	angesehen
Tat	NN	2	Tat
übrige	JJ, NN	2	übrige
Sachte	PRP$	2	Sachte
glücklich	JJ	2	glücklich
lächerlich	JJ	2	lächerlich
schlassen	VB	2	schließen
gewohnt	JJ	2	gewohnt
grob	JJ	2	grob
kurz	VB, JJ	2	kurzem, kurzer
fasen	VB	2	fast
meinetwegen	RB	2	meinetwegen
Larve	NN	2	Larve
Galgen	NN	2	Galgen
Unglück	JJ, NN	2	Unglück
erlernen	VB	2	erlernen, erlernt
Wollten	NN	2	Wollten
Erkenntlichkeit	NN	2	Erkenntlichkeit
Komplimente	NN	2	Komplimente
Stricke	NN	2	Stricke
Ihrige	NN	2	Ihrige
ewig	JJ	2	ewig
schlecht	JJ	2	schlecht
sahen	NN	2	sahen
fertig	JJ	2	fertig
machts	NN	2	machts
Geduld	NN	2	Geduld
Lande	NN	2	Lande
führen	VB	2	führen
Wen	NN	2	Wen
betrachten	VB	2	betrachten
kosen	VB	2	kostet
geh	NN	2	geh
Alles	NN	2	Alles
Erretter	NN	2	Erretter
verwirrt	JJ	2	verwirrt
geschwind	RP, RB	2	geschwind
tut	VB, JJ	2	tut
Kann	NNP	2	Kann
Glücke	NN	2	Glücke
besorge	NN	2	besorge
verdammt	NN, JJ	2	verdammte, verdammt
Messe	NN	2	Messe
glaube	VB	2	glaube
Wisst	NN	2	Wißt
zugleich	RB	2	zugleich
Spitzbube	NN	2	Spitzbube
Hätte	NN	2	Hätte
hungert	NN	2	hungert
schicken	VBN	2	geschickt
suche	NN	2	suche
habe	VB, RB	2	habe
unbelohnt	NN	2	unbelohnt
essen	VB	2	essen
ehe	CC	2	ehe
Sollte	NN	2	Sollte
Verrichtungen	NN	2	Verrichtungen
behüte	NN	2	behüte
Wissen	NN	2	Wissen
zanken	NN	2	zanken
Spiel	NN	2	Spiel
genötiget	NN	2	genötiget
Meine	PRP$	2	Meine
notwendig	JJ	2	notwendig
beschuldigen	VB, RP	2	beschuldigt
alt	JJ, VB	2	alt
tu	NN	2	tu
darnachen	VB	2	darnach
wohin	RB	2	wohin
hinein	RP	2	hinein
Menschenliebe	NN	2	Menschenliebe
Unvorsichtigkeit	NN	2	Unvorsichtigkeit
laut	JJ	2	lauter
trinken	PRP$, VB	2	trinken
leid	JJ	2	leid
grausam	JJ	2	grausam, grausamer
hast	NN	2	hast
treffen	VB, VBN	2	getroffen
gottloser	NN	2	gottloser
aufs	NN	2	aufs
rächen	VB	2	rächen
Gewissen	NN	2	Gewissen
Adel	NN	2	Adel
verlieren	VBN	2	verloren
halte	NN	2	halte
heran	NN	2	heran
rasend	JJ	2	rasend
Bärte	NN	2	Bärte
deutlich	JJ	2	deutlich, deutlicher
Hamburg	NNP	2	Hamburg
Rat	NN	2	Rat
nötigen	VB	2	nötigen, genötigt
begeben	VB	2	begeben
ernsthaft	JJ	2	ernsthaft
hart	JJ	2	hart
Komm	NN	2	Komm
geringste	NN	2	geringste
irren	VB	2	irren
wagen	VB	2	gewagt, wagen
nennen	VB	2	nannte, nennen
unverschämt	JJ	2	unverschämt
Vaterlande	NN	2	Vaterlande
Wege	NN, JJ	2	Wege
meinig	JJ, DT	2	meinige
Freiheit	NN	2	Freiheit
Hat	NN	2	Hat
küssen	VB	2	küssen
gewusst	NN	2	gewußt
Unwahrheit	JJ, NNP	2	Unwahrheit
rechtschaffne	NN	2	rechtschaffne
arm	JJ	2	armen, arm
Kind	NN	2	Kind
dadurch	RB	2	dadurch
Schaden	NN	2	Schaden
zwingen	VBN, VB	2	gezwungen, zwingen
Tage	NN	2	Tage
Urteile	NN	2	Urteile
Verdammt	NN	2	Verdammt
Natur	NN	2	Natur
abern	VBN, CC	2	aber
sehren	VB, RB	2	sehr
Heirat	NNS, NN	2	Heiraten, Heirat
bewegen	VB	2	bewegen
Nation	NNS, NN	2	Nationen, Nation
ansehn	NN	2	ansehn
stellen	VB	2	stellen, stellt
niedergeschlagen	NN	2	niedergeschlagen
Schade	NN	2	Schade
Soen	VBN	2	So
weis	NN	2	weis
wanns	NN	2	wanns
Gesicht	NN	2	Gesicht
Schicksal	NNS, NN	2	Schicksale, Schicksal
Geheimnis	NNS, NN	2	Geheimnisse, Geheimnis
Verlust	NN	2	Verlust
Herren	NN	2	Herren
Prise	NN	2	Prise
letzt	JJ	2	letzten, letzte
umwenden	NN	2	umwenden
meiner	RB	2	meiner
Not	NN	2	Not
Holland	NNP	2	Holland
ging	JJ, VB	2	gingen, ging
gemein	JJ	2	gemein
reich	JJ	2	reich
gestehen	VB, RP	2	gestehen, gestanden
Ort	NN	2	Ort
Bedenken	NN	2	Bedenken
Seele	NN	2	Seele
Lügen	NN	2	Lügen
Frankreich	NNP	2	Frankreich
Schweigen	VBN	2	Schweigt
erklären	VBN, VB	2	erklärt, erklären
zornig	JJ	2	zornig
Geschenke	NN	2	Geschenke
anzunehmen	VB	2	anzunehmen
Euer	NN	2	Euer
liebenswürdig	JJ	2	liebenswürdig
rechtschaffnen	NN, JJ	2	rechtschaffnen
verlangen	VB	2	verlangen
eins	CD	2	eins
Reisende	NN	2	Reisende
erfreuen	VB	2	erfreut, erfreuen
Griff	NN, NNS	2	Griff, Griffe
Hause	NN	2	Hause
Rede	NN	2	Rede
beigestehen	VB, VBN	2	beigestanden
Zorn	NN	2	Zorn
weisen	VB	2	weisen
Überlegen	NN	2	Überlegen
Wohltäters	NN	2	Wohltäters
Wolle	NNS	2	Wollen
Gast	NN	2	Gast
wichtig	RB, JJ	2	wichtig, wichtigen
spotten	VB	2	spotten
wird	RB	2	wird
Kenner	NN	2	Kenner
zumuten	VB	2	zumuten
vergebens	WRB, JJ	2	vergebens
Franzose	NN, NNS	2	Franzose, Franzosen
Spitzbuben	NN	2	Spitzbuben
Physiognomie	NN	2	Physiognomie
längst	RB	2	längst
ziehen	VB	2	zieht, ziehen
vermummt	NN	2	vermummt
halbpart	NNP	2	halbpart
Liebesantrag	NN	2	Liebesantrag
Tasche	NN	2	Tasche
weg	RP	2	weg
wem	WP	2	wem
Frühstück	NN	2	Frühstück
wünschen	VB	2	wünschen
fahren	VBN, VB	2	fährt, fahren
ertappte	NN	2	ertappte
Segen	NN	2	Segen
übrig	JJ	2	übrigen
Welt	NN	2	Welt
Vertrauen	NN	2	Vertrauen
entsetzlich	JJ	2	entsetzlich
seit	IN	2	seit
zweifeln	VB	2	zweifeln
Entleibten	NN	2	Entleibten
Nachricht	NN	2	Nachricht
steinern	JJ	2	steinern
Mensch	NN	2	Mensch
höchste	NN	2	höchste
vortrefflich	JJ	2	vortrefflich
Respekt	NN	1	Respekt
würde	RB	1	würde
fragst	NN	1	fragst
erwiesene	NN	1	erwiesene
steigen	VB	1	stieg
vergeissen	VB	1	vergißt
Könntest	NN	1	Könntest
Wochen	NN	1	Wochen
pflegen	VB	1	gepflegt
Richter	NN	1	Richter
dürstet	NN	1	dürstet
naseweiser	NN	1	naseweiser
Brodgrümel	NN	1	Brodgrümel
Schubsäcke	NN	1	Schubsäcke
Umgang	NN	1	Umgang
täte	NN	1	täte
Bedienungen	NN	1	Bedienungen
deutsch	JJ	1	deutsch
dennen	RP	1	denn
besässen	NN	1	besäßen
angefangen	NN	1	angefangen
verrate	NN	1	verrate
Schritte	NN	1	Schritte
Merken	NN	1	Merken
Miene	NN	1	Miene
ausersehen	NN	1	ausersehen
toll	JJ	1	toll
Zeug	NN	1	Zeug
satteln	VB	1	satteln
schätze	NN	1	schätze
überzeugen	VB	1	überzeugt
drei	CD	1	drei
ungefähr	RB	1	ungefähr
Eigennützige	NN	1	Eigennützige
ungekünsteltste	NN	1	ungekünsteltste
allzeit	NN	1	allzeit
Stand	NN	1	Stand
gewissenhaft	JJ	1	gewissenhaft
Trinkliedern	NN	1	Trinkliedern
Sehe	PRP$	1	Sehe
drauf	RB	1	drauf
anzusehen	VB	1	anzusehen
vermögen	VB	1	vermag
Dinge	NN	1	Dinge
wars	NN	1	wars
Person	NN	1	Person
sicher	RP	1	sicher
Gewinst	NN	1	Gewinst
lohnen	VBN	1	lohnt
Rache	NN	1	Rache
verliessen	NN	1	verließen
Bedenkzeit	NN	1	Bedenkzeit
zieht	VB	1	zieht
Beinahe	NN	1	Beinahe
hundert	CD	1	hundert
niemand	DT	1	niemand
nachteilig	JJ	1	nachteilig
Unhöflichkeit	NN	1	Unhöflichkeit
höre	VB	1	höre
hol	NN	1	hol
hiesige	JJ	1	hiesige
verkappten	NN	1	verkappten
nachreden	NN	1	nachreden
Weinen	NN	1	Weinen
Feinden	NN	1	Feinden
hüten	VB	1	hüten
herzu	JJ	1	herzu
recht	JJ	1	recht
Untergebnen	NN	1	Untergebnen
Kriegsdiensten	NN	1	Kriegsdiensten
versprechen	VB	1	versprechen
umgeh	JJ	1	umgehen
Heldentaten	NN	1	Heldentaten
bösen	VBN	1	böse
Jungen	NN	1	Jungen
stössen	VB	1	stößt
Schuldigen	NN	1	Schuldigen
Gestalt	NN	1	Gestalt
Antwort	NN	1	Antwort
Anverwandten	NN	1	Anverwandten
dorthin	RB	1	dorthin
drinne	NN	1	drinne
durchzukommen	NN	1	durchzukommen
Strassen	NN	1	Straßen
Rittergute	NN	1	Rittergute
übereinstimmen	VB	1	übereinstimmen
geweissen	JJ	1	gewiß
dasmal	IN	1	dasmal
Darzu	RB	1	Darzu
klingen	VB	1	klingt
Rechts	NN	1	Rechts
Rechte	NN	1	Rechte
Unterhaltung	NN	1	Unterhaltung
entzückt	NN	1	entzückt
Städten	JJ	1	Städten
erstlich	JJ	1	erstlich
Geschwind	NN	1	Geschwind
verknüpften	NN	1	verknüpften
werde	RB	1	werde
frei	JJ	1	frei
wenigen	VB	1	wenigen
wenigem	NN	1	wenigem
unendlich	JJ	1	unendlich
muntre	NN	1	muntre
Lisetten	NN	1	Lisetten
sahe	NN	1	sahe
Seiner	PRP$	1	Seiner
Siebensachen	VB	1	Siebensachen
liefen	NN	1	liefen
Gleichwohl	RP	1	Gleichwohl
darnach	RB	1	darnach
Pistol	NN	1	Pistol
gefährlich	JJ	1	gefährlichen
raten	VB	1	raten
tot	JJ	1	tot
herkommen	VB	1	herkommen
Träumen	NN	1	Träumen
Närrin	NN	1	Närrin
heissen	VB	1	heißen
Woher	NN	1	Woher
verblenden	NN	1	verblenden
strebe	NN	1	strebe
binnen	IN	1	binnen
wohlbestallt	JJ	1	wohlbestallter
vielem	NN	1	vielem
sonen	VBN	1	sonst
Viertelstunde	NN	1	Viertelstunde
liefst	WRB	1	liefst
verraten	VB	1	verraten
bedanket	NN	1	bedanket
abgeschmackt	JJ	1	abgeschmackt
vieles	NN	1	vieles
verheiratet	JJ	1	verheiratet
herrschet	NN	1	herrschet
Eigennutz	NN	1	Eigennutz
durchaus	RB	1	durchaus
nachfolgen	VB	1	nachfolgen
denkts	NN	1	denkts
Bissen	NN	1	Bissen
herrschen	VB	1	herrschen
künftig	JJ	1	künftig
balden	VB	1	bald
taumelt	NN	1	taumelt
Ungelegenheit	NN	1	Ungelegenheit
Verklagen	NN	1	Verklagen
wünsch	NN	1	wünsch
einladen	VB	1	einladen
Seid	NN	1	Seid
weine	NN	1	weine
geschlagen	NN	1	geschlagen
visitieren	NN	1	visitieren
gutherzige	NN	1	gutherzige
Untersuchung	NN	1	Untersuchung
Sinne	NN	1	Sinne
mitten	RB	1	mitten
sagt	VB	1	sagte
Bin	NN	1	Bin
wirst	RB	1	wirst
sieh	NN	1	sieh
christlich	JJ	1	christliche
Mademoisell	NN	1	Mademoisell
Müsst	NN	1	Müßt
verteidigen	VB	1	verteidigen
ausgerissen	NNP	1	ausgerissen
Gewaltsamkeit	NN	1	Gewaltsamkeit
Strassenräuber	NN	1	Straßenräuber
vielmehr	JJ	1	vielmehr
schimpflich	JJ	1	schimpflich
verschaffen	VB	1	verschaffen
inne	NN	1	inne
schreiben	VB	1	schreiben
Alfanzereien	NN	1	Alfanzereien
best	JJ	1	besten
fangen	VB	1	fangen
schimpft	NN	1	schimpft
allzugewissenhaften	NN	1	allzugewissenhaften
Philosophie	NN	1	Philosophie
Vater	NN	1	Vater
hasste	NN	1	haßte
Ausflucht	NN	1	Ausflucht
erfodert	NN	1	erfodert
Treu	NN	1	Treu
lösete	NN	1	lösete
Volke	NN	1	Volke
sagte	VB	1	sagte
zweitenmal	RB	1	zweitenmal
vexieren	NN	1	vexieren
daranen	RB	1	daran
Schreien	NN	1	Schreien
Wundern	NN	1	Wundern
wohlen	VBN	1	wohl
Dingern	VB	1	Dinger
wider	IN	1	wider
alles	RB	1	alles
Gnüge	NN	1	Gnüge
Marquisin	NN	1	Marquisin
Italien	NN	1	Italien
müsst	JJ	1	müßten
mehrer	JJ	1	mehrere
belieben	NN	1	belieben
könne	RB	1	könne
übereilte	NN	1	übereilte
fest	IN	1	fest
verdienstlich	JJ	1	verdienstliches
verflucht	JJ	1	verflucht
boshafterer	NN	1	boshafterer
Schutzengel	NN	1	Schutzengel
erstreckt	JJ	1	erstreckt
gewöhnen	VB	1	gewöhnen
Scherz	NNS	1	Scherze
beschweren	VB	1	beschweren
erzählen	VB	1	erzählen
Niesen	NN	1	Niesen
Schande	NN	1	Schande
nie	RB	1	nie
legen	RP	1	gelegt
Portion	NN	1	Portion
Grobian	NN	1	Grobian
Verlauf	NN	1	Verlauf
zornigen	VBN	1	zornig
verliert	VB	1	verliert
tiefsinnigen	NN	1	tiefsinnigen
angekommen	NN	1	angekommen
ihres	PRP$	1	ihres
unbequemsten	NN	1	unbequemsten
gefällig	JJ	1	gefällig
Nimmermehr	NN	1	Nimmermehr
hab	NN	1	hab
Unachtsamkeit	NN	1	Unachtsamkeit
besehn	NN	1	besehn
offnen	NN	1	offnen
Tugend	NN	1	Tugend
besehe	NN	1	besehe
hat	RB	1	hat
fragt	VB	1	fragt
Anfange	NN	1	Anfange
durstet	NN	1	durstet
Wichtigersen	VB	1	Wichtigers
unleidlich	JJ	1	unleidlich
anwendete	NN	1	anwendete
Orte	NN	1	Orte
Stolz	NN	1	Stolz
verschaffte	NN	1	verschaffte
gönnen	VB	1	gönnen
Verweise	NN	1	Verweise
darausen	VB	1	daraus
darzu	RB	1	darzu
bereit	RP	1	bereit
Wechsel	NN	1	Wechsel
gesattelt	NN	1	gesattelt
wirft	VB	1	wirft
ums	IN	1	ums
Abendmahlzeit	NN	1	Abendmahlzeit
sinnreich	JJ	1	sinnreich
Quark	NN	1	Quark
stiften	VB	1	stiften
binden	VB	1	binden
Argwohn	NN	1	Argwohn
Affen	NN	1	Affen
Bräutigam	NN	1	Bräutigam
Religionspunkt	NN	1	Religionspunkt
bestärkt	NN	1	bestärkt
Liebesverständnisse	NN	1	Liebesverständnisse
Lichte	NN	1	Lichte
geringst	JJ	1	geringste
Bess	JJ	1	Besser
gutherziger	NN	1	gutherziger
anbieten	VB	1	anbieten
Völker	NN	1	Völker
unternehmend	JJ	1	unternehmend
dürfte	VB	1	dürfte
alsdenn	RB	1	alsdenn
Fuss	NN	1	Fuß
Pöbels	NN	1	Pöbels
untern	JJ	1	untern
Ende	NN	1	Ende
gib	NN	1	gib
Verbindlichkeit	NN	1	Verbindlichkeit
nunen	VBN	1	nun
Unschuld	NN	1	Unschuld
schweigen	VB	1	schweigen
Nuren	RB	1	Nur
Guen	VB	1	Gute
aufnehmen	VB	1	aufnehmen
Erinnern	NN	1	Erinnern
dritt	JJ	1	dritten
übereilen	NN	1	übereilen
Loch	NN	1	Loch
bedienen	VB	1	bedienen
Abschiedsformeln	NN	1	Abschiedsformeln
gelangen	VBN	1	gelangt
Befehlen	NN	1	Befehlen
aufgingen	NN	1	aufgingen
Vogte	NN	1	Vogte
Stücken	NN	1	Stücken
Freundin	NN	1	Freundin
Ausschweifungen	NN	1	Ausschweifungen
saurern	VB	1	saurer
erfolgt	RB	1	erfolgt
Unbekannten	NN	1	Unbekannten
Hund	NN	1	Hund
Träumenden	NN	1	Träumenden
Gütern	NN	1	Gütern
geschehn	NN	1	geschehn
dicht	JJ	1	dichter
verdächtig	JJ	1	verdächtig
Erzählen	NN	1	Erzählen
Glauben	NN	1	Glauben
gehorchen	VB	1	gehorchen
macht	VB	1	macht
bezeugte	NN	1	bezeugte
greulich	JJ	1	greulich
mache	NN	1	mache
hurtiger	RP	1	hurtiger
weils	NN	1	weils
Tagen	NN	1	Tagen
Querstrich	NN	1	Querstrich
Umwenden	NN	1	Umwenden
zerronnen	NN	1	zerronnen
schwerlich	JJ	1	schwerlich
weitrer	NN	1	weitrer
Ehrlichkeit	NN	1	Ehrlichkeit
Bibel	NN	1	Bibel
aufsetzen	NN	1	aufsetzen
wesweg	RB	1	weswegen
selben	VBN	1	selbst
gelinder	NN	1	gelinder
beurlauben	NN	1	beurlauben
Bemühe	NN	1	Bemühe
gescheuter	NN	1	gescheuter
Verschwiegenheit	NN	1	Verschwiegenheit
Schwatzhaftigkeit	NN	1	Schwatzhaftigkeit
einzigen	VB	1	einzigen
Klage	NN	1	Klage
Absicht	NN	1	Absicht
Lachen	NN	1	Lachen
nimmt	VB	1	nimmt
Pest	NN	1	Pest
Wahrhaftig	JJ	1	Wahrhaftig
allzusicher	NN	1	allzusicher
Ihres	NN	1	Ihres
ausstechen	RB	1	ausstechen
wusst	JJ	1	wußte
Verlangen	NN	1	Verlangen
steckte	NN	1	steckte
Mundsemmel	NN	1	Mundsemmel
vorgekommen	NN	1	vorgekommen
Zwei	CD	1	Zwei
lesen	VB	1	lesen
Sehen	NN	1	Sehen
übergebe	NN	1	übergebe
bleibe	NN	1	bleibe
schaden	VB	1	schaden
ungekannt	NN	1	ungekannt
antrifft	NN	1	antrifft
liebern	VB	1	lieber
vous	NN	1	vous
Amts	NN	1	Amts
unsere	PRP$	1	unsere
Haufen	NN	1	Haufen
ungeehrt	NN	1	ungeehrt
zweifle	NN	1	zweifle
redten	NN	1	redten
unmöglich	JJ	1	unmöglich
Setzen	NN	1	Setzen
Narre	NN	1	Narre
Essenszeit	NN	1	Essenszeit
ängstlich	JJ	1	ängstliches
Termin	NN	1	Termin
schrecken	VB	1	schrecken
Reisebibliothek	NN	1	Reisebibliothek
befunden	NN	1	befunden
ausplaudern	NN	1	ausplaudern
behende	NN	1	behende
verborgen	VB	1	verborgen
Vormittag	NN	1	Vormittag
beschliessen	RP	1	beschlossen
Verzeiht	NN	1	Verzeiht
st	PRP$	1	st
Wohltäter	NN	1	Wohltäter
ärgert	NN	1	ärgert
geredt	NNP	1	geredt
wirksam	JJ	1	wirksame
Wetter	NN	1	Wetter
küsst	NN	1	küßt
doppeltes	NN	1	doppeltes
meiste	NN	1	meiste
Lacht	NN	1	Lacht
Beiwort	NN	1	Beiwort
wiedergeben	VB	1	wiedergeben
Handgemenge	NN	1	Handgemenge
Flegel	NN	1	Flegel
erweiset	NN	1	erweiset
ersuche	NN	1	ersuche
halb	JJ	1	halber
Schlimmes	NN	1	Schlimmes
antreiben	VB	1	antreiben
willkürlich	JJ	1	willkürliche
erwerben	VBN	1	erworben
Kette	NN	1	Kette
verkleidet	NN	1	verkleidet
spassen	PRP$	1	spaßen
Verbinde	NN	1	Verbinde
Lieber	NN	1	Lieber
bekömmt	NN	1	bekömmt
zuschreiben	VBN	1	zugeschrieben
freilichen	VBN	1	freilich
Sachen	NN	1	Sachen
Keines	NN	1	Keines
Bösem	NN	1	Bösem
zehnmal	RB	1	zehnmal
Kinderspiel	NN	1	Kinderspiel
beschreibt	NN	1	beschreibt
wirds	NN	1	wirds
Anstalt	NN	1	Anstalt
Eue	JJ	1	Euer
Warens	NN	1	Warens
behaltet	NN	1	behaltet
einnehmender	NN	1	einnehmender
Topp	NN	1	Topp
hätte	RB	1	hätte
Eur	NN	1	Euren
Entleibte	NN	1	Entleibte
Atem	NN	1	Atem
aufheben	VB	1	aufheben
Lohn	NN	1	Lohn
ansehnlich	JJ	1	ansehnlichen
unterlassen	VBN	1	unterlassen
Kurz	NN	1	Kurz
Ungewissenhafte	NN	1	Ungewissenhafte
geschmeidiger	NN	1	geschmeidiger
anvertrauen	VB	1	anvertrauen
beschämen	VB	1	beschämen
unterdessen	NN	1	unterdessen
geht	VB	1	geht
Strassenräubern	NN	1	Straßenräubern
Erklären	NN	1	Erklären
Flaschen	NN	1	Flaschen
unvollkommen	NN	1	unvollkommen
helfen	VB	1	helfen
nötigte	NN	1	nötigte
Baurensprache	NN	1	Baurensprache
Geringes	NN	1	Geringes
gekannt	NN	1	gekannt
Unser	PRP$	1	Unser
falle	NN	1	falle
erbärmlich	JJ	1	erbärmlichen
untertänig	JJ	1	untertänige
verbleib	JJ	1	verbleibe
Redlichkeit	NN	1	Redlichkeit
Uhrtaschen	VB	1	Uhrtasche
Wem	NN	1	Wem
verrichten	VB	1	verrichten
Stückch	JJ	1	Stückchen
ungegründeten	NN	1	ungegründeten
König	NN	1	König
vermeinte	NN	1	vermeinte
Wohin	NN	1	Wohin
Diensten	NN	1	Diensten
nüchtern	JJ	1	nüchtern
beurteilen	VB	1	beurteilen
bekümmern	NN	1	bekümmern
Brandwein	NN	1	Brandwein
raset	NN	1	raset
weitesten	NN	1	weitesten
verachten	PRP$	1	verachten
unverschämtes	NN	1	unverschämtes
beschwöre	NN	1	beschwöre
verhindern	JJ	1	verhindert
sichere	NN	1	sichere
Lustspalten	VB	1	Lustspielen
Wohltaten	NN	1	Wohltaten
gesehn	NN	1	gesehn
behutsam	JJ	1	behutsam
erkundigen	VB	1	erkundigen
Hieren	VBN	1	Hier
fremden	PRP$	1	fremden
schreien	VB	1	schreien
Bewegung	NNS	1	Bewegungen
versichere	NN	1	versichere
Abneigung	NN	1	Abneigung
geschämt	VBN	1	geschämt
Mädel	NN	1	Mädel
gottlose	NN	1	gottlose
Werk	NN	1	Werk
verzeihen	VB	1	verzeihen
witzige	NN	1	witzige
darin	RB	1	darin
kahle	NN	1	kahle
jemanden	NN	1	jemanden
begreif	NN	1	begreif
gedulden	VBN	1	geduldet
Empfindlichers	NN	1	Empfindlichers
sichs	NN	1	sichs
gleichviel	NN	1	gleichviel
hintertreiben	VB	1	hintertreiben
Stich	NN	1	Stich
genugsam	RB	1	genugsam
Eigensinn	NN	1	Eigensinn
Erlauben	NN	1	Erlauben
verhelfen	VB	1	verhelfen
entwandt	NNP	1	entwandt
bestürmen	NN	1	bestürmen
teilen	VB	1	teilen
hernach	NN	1	hernach
hochadelich	JJ	1	hochadelichen
herum	IN	1	herum
Väter	NN	1	Väter
eröffnen	VB	1	eröffnen
Naseweis	NN	1	Naseweis
ginge	NN	1	ginge
Besten	NN	1	Besten
hochzuehrenden	NNP	1	hochzuehrenden
Ers	NN	1	Ers
Christenheit	NN	1	Christenheit
Grösse	NN	1	Größe
besitzt	NN	1	besitzt
allzuzärtlicher	NN	1	allzuzärtlicher
missfallen	NN	1	mißfallen
Höflichkeit	NN	1	Höflichkeit
geniessen	VB	1	genossen
berichtet	NN	1	berichtet
niederträchtigsten	NN	1	niederträchtigsten
allzugrosse	NN	1	allzugroße
Glücks	NN	1	Glücks
Befehl	NN	1	Befehl
Verfahren	NN	1	Verfahren
Ankunft	NN	1	Ankunft
hohlen	NN	1	hohlen
Völkerschaften	NN	1	Völkerschaften
frühmorgens	IN	1	frühmorgens
schnurrig	RB	1	schnurrig
erlangtesen	VB	1	erlangtes
derenwegen	NN	1	derenwegen
bereden	NN	1	bereden
Allda	NN	1	Allda
ungerecht	JJ	1	ungerecht
Abends	NN	1	Abends
zuviel	RB	1	zuviel
verstehn	NN	1	verstehn
schonen	VB	1	schon
vergelten	VB	1	vergelten
Geschwindigkeit	NN	1	Geschwindigkeit
würdet	NN	1	würdet
höh	JJ	1	höher
Dummheit	NN	1	Dummheit
Kindes	NN	1	Kindes
schmelzen	VB	1	schmelzen
auslegen	VB	1	auslegen
destoweniger	NNP	1	destoweniger
vergeben	VBN	1	vergeben
Eurem	NN	1	Eurem
entschliesst	NN	1	entschließt
Gehet	NN	1	Gehet
gebrauchen	VBN	1	gebraucht
Neigung	NN	1	Neigung
Betrachtung	NNS	1	Betrachtungen
schlechteste	NN	1	schlechteste
venia	NN	1	venia
öfters	RB	1	öfters
rühmen	NN	1	rühmen
erwachen	VB	1	erwachen
erwischt	NN	1	erwischt
bitte	VB	1	bitte
Rocktasch	VB	1	Rocktasche
log	NN	1	log
stark	JJ	1	stark
zugehört	NN	1	zugehört
Schönheit	NN	1	Schönheit
Gefälligkeiten	NN	1	Gefälligkeiten
verschnupft	NN	1	verschnupft
Orgel	NN	1	Orgel
Gedränge	NN	1	Gedränge
gibt	VB	1	gibt
eingehen	VB	1	eingehen
unvermuteten	NN	1	unvermuteten
völligen	NN	1	völligen
Gehülfe	NN	1	Gehülfe
Verfolgung	NN	1	Verfolgung
neunmalten	VB	1	neunmalen
schimpfen	VB	1	schimpfen
vors	JJ	1	vors
melancholisch	JJ	1	melancholische
unnötige	NN	1	unnötige
Bücher	NN	1	Bücher
Grossvater	NN	1	Großvater
Bekannte	NN	1	Bekannte
Gespräch	NN	1	Gespräch
Lebens	NN	1	Lebens
gesetzt	VBN	1	gesetzt
dunkel	JJ	1	dunkel
Zeitlebens	NN	1	Zeitlebens
anderns	NN	1	anderns
Wagen	NN	1	Wagen
grossmütige	NN	1	großmütige
Alsdann	NNP	1	Alsdann
heftig	JJ	1	heftig
zugegangen	NN	1	zugegangen
Eltern	NN	1	Eltern
Winter	NN	1	Winter
unsrer	PRP$	1	unsrer
erfahren	VBN	1	erfahren
ergebe	NN	1	ergebe
Übels	NN	1	Übels
Edelmütigkeit	NN	1	Edelmütigkeit
müsste	VB	1	müßte
Habe	NN	1	Habe
überflüssig	JJ	1	überflüssig
wichtigere	NN	1	wichtigere
richtig	JJ	1	richtig
Sohn	NN	1	Sohn
breit	JJ	1	breit
Vermummte	NN	1	Vermummte
Stehn	NN	1	Stehn
Ware	NNS	1	Waren
heiss	JJ	1	heiß
einfältig	JJ	1	einfältig
anbot	NN	1	anbot
rate	NN	1	rate
hervor	RP	1	hervor
unterstehen	NN	1	unterstehen
auflösen	VB	1	auflösen
Liebhaber	NN	1	Liebhaber
ausfragen	NN	1	ausfragen
Verzeihung	NN	1	Verzeihung
zweimal	RB	1	zweimal
herausfiele	NN	1	herausfiele
bewundre	NN	1	bewundre
Türe	NN	1	Türe
Schulmeist	JJ	1	Schulmeister
heben	VB	1	hebe
Gift	NN	1	Gift
fragte	NN	1	fragte
verzweifelt	JJ	1	verzweifelt
irrte	NN	1	irrte
Bekanntschaft	NN	1	Bekanntschaft
erstechen	VB	1	erstechen
lustig	JJ	1	lustig
entdecke	NN	1	entdecke
plündern	VB	1	plündern
Verdienst	NN	1	Verdienst
stelle	NN	1	stelle
Gönnen	NN	1	Gönnen
unergründlich	JJ	1	unergründlich
französisch	JJ	1	französische
Pfui	NN	1	Pfui
zurückhalten	VB	1	zurückhalten
treibt	NN	1	treibt
überflüssige	NN	1	überflüssige
Hinterhause	NN	1	Hinterhause
Mässigen	NN	1	Mäßigen
lögen	NN	1	lögen
verlieret	NN	1	verlieret
grösst	JJ	1	größte
bekannter	JJ	1	bekannter
St	PRP$	1	St
Verziehen	NN	1	Verziehen
hurtig	JJ	1	hurtig
Gewisser	JJ	1	Gewisser
biete	NN	1	biete
beitragen	VB	1	beitragen
allerboshaftesten	NN	1	allerboshaftesten
erlustigen	VB	1	erlustigen
staten	VB	1	statten
bedeutend	JJ	1	bedeutende
Vergiss	NN	1	Vergiß
widersprechen	VB	1	widersprechen
befürchten	VB	1	befürchten
drohen	VB	1	drohen
Meisterstück	NN	1	Meisterstück
vorbei	IN	1	vorbei
trieb	NN	1	trieb
Ernste	NN	1	Ernste
List	NN	1	List
Heldengedichten	NN	1	Heldengedichten
fünfzig	CD	1	fünfzig
angehen	VB	1	angeht
Erde	NN	1	Erde
abe	JJ	1	aber
nachgewünscht	NN	1	nachgewünscht
Gerichten	NN	1	Gerichten
Armen	NN	1	Armen
verrieten	NN	1	verrieten
bestimmen	RP	1	bestimmt
kämen	NN	1	kämen
allerliebstes	JJ	1	allerliebstes
bloss	JJ	1	bloße
Alter	NN	1	Alter
alten	VB	1	alt
Gesetzchen	VB	1	Gesetzchen
närrisch	JJ	1	närrisch
möge	VB	1	möge
musste	RB	1	mußte
Handelschaft	NN	1	Handelschaft
verdiente	NN	1	verdiente
aufpacken	NN	1	aufpacken
entfernt	JJ	1	entfernt
nachgekommen	NN	1	nachgekommen
nötiget	NN	1	nötiget
fünf	CD	1	fünf
würden	RB	1	würden
Bessers	NN	1	Bessers
errate	NN	1	errate
Gutes	NN	1	Gutes
verschieden	JJ	1	verschiedenen
Schlimmers	NN	1	Schlimmers
weitläuftig	JJ	1	weitläuftig
Trauerspalten	VB	1	Trauerspielen
Adieu	NN	1	Adieu
sichrer	NNP	1	sichrer
Dingen	NN	1	Dingen
abnehmen	VB	1	abnehmen
Tückischen	VB	1	Tückische
abgedroschnen	NN	1	abgedroschnen
unerträglich	JJ	1	unerträglich
übertriebene	NN	1	übertriebene
Vielleichen	VBN	1	Vielleicht
Duells	RB	1	Duells
lässen	VB	1	läßt
Unterscheid	NN	1	Unterscheid
unruhig	JJ	1	unruhig
blieb	NN	1	blieb
Haar	NN	1	Haar
erniedrigen	VB	1	erniedrigen
jüdisch	JJ	1	jüdischen
anwenden	VB	1	anwenden
frech	JJ	1	frech
wofür	WRB	1	wofür
Dämmerung	NN	1	Dämmerung
hochmütige	NN	1	hochmütige
verzweifelten	NN	1	verzweifelten
ansichtigen	VBN	1	ansichtig
Laffe	NN	1	Laffe
jen	DT	1	jene
angetroffen	NN	1	angetroffen
gereiset	NN	1	gereiset
bedenken	VB	1	bedenken
Breslau	NNP	1	Breslau
leiblich	JJ	1	leiblichen
überreden	VB	1	überreden
freue	NN	1	freue
Notwendiges	NN	1	Notwendiges
aime	NN	1	aime
Ursache	NN	1	Ursache
stehn	NN	1	stehn
beständig	JJ	1	beständig
Duell	JJ	1	Duell
Darumen	RB	1	Darum
denkst	NN	1	denkst
Zeigen	VB	1	Zeigt
Vorwande	NN	1	Vorwande
kostbar	VB	1	kostbarer
leichen	VBN	1	leicht
ermüdet	NN	1	ermüdet
Schätzen	NN	1	Schätzen
küss	NN	1	küß
brauch	NN	1	brauch
drittemal	RB	1	drittemal
Hörst	NN	1	Hörst
lachen	VB	1	lacht
befühlen	NN	1	befühlen
Helf	NN	1	Helf
Schnupftuch	NNP	1	Schnupftuch
Hell	NN	1	Heller
Fort	NN	1	Fort
verratet	NN	1	verratet
eignen	VB	1	eignen
eigner	JJ	1	eigner
arg	RB	1	arg
manchmal	RB	1	manchmal
seh	PRP$	1	seh
Nehmen	VB	1	Nehmen
auchen	VBN	1	auch
unterschreiben	VB	1	unterschreiben
ritt	NN	1	ritt
diebisch	JJ	1	diebisches
schmeisst	NN	1	schmeißt
niemanden	NN	1	niemanden
entwandte	NN	1	entwandte
erkenne	NN	1	erkenne
Kinn	NN	1	Kinn
Gesichtsbildung	NN	1	Gesichtsbildung
Katze	NN	1	Katze
belogen	NN	1	belogen
Schulzen	NN	1	Schulzen
Neid	NN	1	Neid
Rippen	NN	1	Rippen
drängen	VB	1	drängte
Unruhe	NN	1	Unruhe
neinen	RB	1	nein
schwören	VB	1	schwören
Wodurch	NN	1	Wodurch
empfehle	NN	1	empfehle
Wären	NN	1	Wären
weislich	JJ	1	weislich
Auge	NN	1	Auge
zusammen	RB	1	zusammen
stürzen	RP	1	gestürzt
heeissen	VB	1	heißen
verwandelt	NN	1	verwandelt
bestens	NN	1	bestens
packt	NN	1	packt
Irrtum	NN	1	Irrtum
Lisettch	VB	1	Lisettchen
erfährt	NN	1	erfährt
erraten	NN	1	erraten
Michel	NN	1	Michel
Ding	NN	1	Ding
erfreu	NN	1	erfreu
verlohnen	VB	1	verlohne
ärger	NN	1	ärger
Lügner	NN	1	Lügner
Betrieger	NN	1	Betrieger
liebreich	NN	1	liebreich
Beantwortung	NN	1	Beantwortung
Aufrichtigkeit	NN	1	Aufrichtigkeit
liebenswürdigste	NN	1	liebenswürdigste
Entdeckung	NN	1	Entdeckung
entdecktes	NN	1	entdecktes
scheinet	NN	1	scheinet
Wanns	NN	1	Wanns
verfahr	JJ	1	verfahren
Verfahrens	NN	1	Verfahrens
verdiene	NN	1	verdiene
Gelegenheit	NN	1	Gelegenheit
salva	FW	1	salva
Witz	JJ	1	Witz
reizend	JJ	1	reizend
Monaten	NN	1	Monaten
Einfall	JJ	1	Einfall
Argwohns	NN	1	Argwohns
Christophen	NN	1	Christophen
Sodann	RB	1	Sodann
Provinz	NN	1	Provinz
Argwohne	NN	1	Argwohne
gnädiges	NN	1	gnädiges
erwarten	VB	1	erwarten
Höflich	JJ	1	Höflich
beschwören	VB	1	beschwören
weinen	VB	1	weinen
Zufall	NN	1	Zufall
verhinderlich	JJ	1	verhinderlich
besaufen	NN	1	besaufen
hinten	RB	1	hinten
verfährt	NN	1	verfährt
Kutscher	NN	1	Kutscher
Ohren	NN	1	Ohren
offenbar	JJ	1	offenbar
entgehn	NN	1	entgehn
entwendet	NN	1	entwendet
weint	NN	1	weint
Meineid	NN	1	Meineid
funfzig	JJ	1	funfzig
blieben	RB	1	blieben
fügen	VB	1	fügen
Baron	NN	1	Baron
klüger	NN	1	klüger
verursachen	VB	1	verursachte
sachte	PRP$	1	sachte
gehorsam	JJ	1	gehorsam
verfahren	VB	1	verfahren
Schwanze	NN	1	Schwanze
keinen	RB	1	keinen
ausschütten	VB	1	ausschütten
Hätten	NN	1	Hätten
wohlbestallter	NN	1	wohlbestallter
geglaubt	VBN	1	geglaubt
darinen	VB	1	darin
halbern	VB	1	halber
Grunde	NN	1	Grunde
Anwesenheit	NN	1	Anwesenheit
kürzen	VB	1	kürzen
ungeschickter	NN	1	ungeschickter
Lass	NN	1	Laß
Verweis	NN	1	Verweis
sichern	VB	1	sicher
bewog	NN	1	bewog
Tausenderlei	NN	1	Tausenderlei
nah	JJ	1	nahes
umwechseln	NN	1	umwechseln
beide	RB	1	beide
gottloses	NN	1	gottloses
gottlosen	NN	1	gottlosen
wüssten	NN	1	wüßten
Schurke	NN	1	Schurke
Versicherung	NN	1	Versicherung
Nacht	NN	1	Nacht
genomm	VBN	1	genommen
Träumt	NN	1	Träumt
Punkte	NN	1	Punkte
Hände	NN	1	Hände
Liebsten	NN	1	Liebsten
ungeneigen	VBN	1	ungeneigt
Ausnahme	NN	1	Ausnahme
Landstrasse	JJ	1	Landstraße
edl	JJ	1	edles
wenigstensen	VBN	1	wenigstens
wiederkommen	NN	1	wiederkommen
höflicher	NN	1	höflicher
aufgeräumt	NN	1	aufgeräumt
lenken	VB	1	lenken
Erklärten	NN	1	Erklärten
Ruhe	NN	1	Ruhe
Nötige	NN	1	Nötige
abgehen	NN	1	abgehen
bedenke	NN	1	bedenke
beliebt	VB	1	beliebten
Blitz	NN	1	Blitz
Fälle	NN	1	Fälle
grossmütig	JJ	1	großmütig
Kunst	NN	1	Kunst
Zimmermann	NN	1	Zimmermann
unsich	JJ	1	unsicher
gütig	JJ	1	gütig
Gemüt	NN	1	Gemüt
Pflicht	NN	1	Pflicht
Gemüte	NN	1	Gemüte
betaure	NN	1	betaure
Verwahrung	NN	1	Verwahrung
prahlen	VB	1	prahlen
unzulänglich	JJ	1	unzulänglich
herausgerissen	NN	1	herausgerissen
nebst	IN	1	nebst
lee	JJ	1	leer
Tiere	NN	1	Tiere
Seeln	VB	1	Seelen
anbeten	VB	1	anbeten
verdoppeln	VB	1	verdoppeln
ärgre	NN	1	ärgre
undankbar	JJ	1	undankbar
erzdumm	NN	1	erzdumm
voll	JJ	1	voll
verdammten	NN	1	verdammten
zuging	NN	1	zuging
entgehen	RP	1	entgangen
Hui	NN	1	Hui
Plündern	NN	1	Plündern
Gestern	NN	1	Gestern
alsoen	VBN	1	also
genassen	VB	1	genießen
übern	JJ	1	übern
begreifen	VB	1	begreife
zublinzt	NN	1	zublinzt
wiedern	VBN	1	wieder
Sonst	NN	1	Sonst
vergnügen	NN	1	vergnügen
hindert	NN	1	hindert
fett	JJ	1	fetten
Pfarr	NN	1	Pfarr
empfehlen	VB	1	empfehlen
Verzweifelt	NN	1	Verzweifelt
Gibt	NNP	1	Gibt
danken	VB	1	danken
Schweinfleisch	JJ	1	Schweinfleisch
Wovon	NN	1	Wovon
Erklärung	NN	1	Erklärung
Roman	NN	1	Roman
nachdenkend	JJ	1	nachdenkend
erstaunen	VB	1	erstaunen
darumen	VB	1	darum
zeitig	JJ	1	zeitig
worin	RB	1	worin
zweierlei	RB	1	zweierlei
hättet	NN	1	hättet
gereuen	NN	1	gereuen
bins	NN	1	bins
gelassne	JJ	1	gelaßne
dochen	VB	1	doch
wundern	VB	1	wundern
groben	VBN	1	grob
Belohnung	NN	1	Belohnung
ausrichten	VB	1	ausrichten
Beute	NN	1	Beute
morgen	RB	1	morgen
sichersten	NN	1	sichersten
gleichgültig	JJ	1	gleichgültig
Mannsperson	NN	1	Mannsperson
gedenke	NN	1	gedenke
Deutscher	NN	1	Deutscher
vermummte	NN	1	vermummte
Dazuen	RB	1	Dazu
warten	VBN	1	warten
schrecke	NN	1	schrecke
Vers	NNS	1	Verse
ausnehmen	JJ	1	ausgenommen
werdet	NN	1	werdet
Gegendienst	NN	1	Gegendienst
bekennen	VB	1	bekannt
vorwerfen	VB	1	vorwerfen
liebenswürdigen	NN	1	liebenswürdigen
zürnen	VB	1	zürnen
schüchtern	JJ	1	schüchtern
zuzuschreiben	VB	1	zuzuschreiben
geraten	VBN	1	geraten
Bekannten	NN	1	Bekannten
zugehen	VB	1	zugehen
Treulosigkeit	NN	1	Treulosigkeit
Grade	NN	1	Grade
belohnt	NN	1	belohnt
Narr	NN	1	Narr
einnehmen	VB	1	einnimmt
echt	JJ	1	echten
eilends	NN	1	eilends
Gleichem	NN	1	Gleichem
laufe	NN	1	laufe
ehrlichsten	NN	1	ehrlichsten
Reife	NN	1	Reife
überdrüssig	JJ	1	überdrüssig
ausgesonnen	NN	1	ausgesonnen
Betrug	NN	1	Betrug
Vortrefflicher	NN	1	Vortrefflicher
aufrichtig	JJ	1	aufrichtig
Betrachten	NN	1	Betrachten
einbilden	NN	1	einbilden
aufrichtige	NN	1	aufrichtige
zugezogen	NN	1	zugezogen
Belieben	NN	1	Belieben
hättest	WRB	1	hättest
worinne	NN	1	worinne
unhöflich	JJ	1	unhöflich
sollt	NN	1	sollt
Glas	NNS	1	Gläser
ists	NN	1	ists
zurück	RP	1	zurück
silbern	JJ	1	silbern
durchdringet	NN	1	durchdringet
Genug	NN	1	Genug
jemand	DT	1	jemand
finst	JJ	1	finster
plaudern	VB	1	plaudern
Kosten	NN	1	Kosten
aushalten	NN	1	aushalten
verderbt	NN	1	verderbt
allzuklugen	NN	1	allzuklugen
geleg	JJ	1	gelegen
Kostbarers	NN	1	Kostbarers
nied	JJ	1	nieder
Vorhin	NN	1	Vorhin
Religion	JJ	1	Religion
flucht	NN	1	flucht
Ofen	NN	1	Ofen
vorstellen	VB	1	vorstellen
wiegen	VB	1	wiegt
Pöbel	NN	1	Pöbel
begehen	VB	1	begehen
neugierig	RB	1	neugierig
Unverschämter	NN	1	Unverschämter
Betrügerei	NN	1	Betrügerei
unsinniges	PRP$	1	unsinniges
Schelm	NN	1	Schelm
honetten	NN	1	honetten
obgleich	CC	1	obgleich
gütigen	NNP	1	gütigen
Danksagung	NN	1	Danksagung
ganzes	JJ	1	ganzes
vier	CD	1	vier
Aufs	NN	1	Aufs
bessern	PRP$	1	bessern
gesprächigen	NN	1	gesprächigen
sehs	NN	1	sehs
achtungswürdig	JJ	1	achtungswürdig
bezaubert	NN	1	bezaubert
allzusehr	NN	1	allzusehr
Räubern	NN	1	Räubern
aufhören	VB	1	aufhören
Ohrwürmch	JJ	1	Ohrwürmchen
ken	JJ	1	ken
glaub	NN	1	glaub
Dienen	NN	1	Dienen
brächte	NN	1	brächte
sparen	VB	1	sparen
überlegen	VB	1	überlegen
inbrünstigen	NN	1	inbrünstigen
verkaufen	VB	1	verkaufen
möchte	VB	1	möchte
Knecht	NNP	1	Knecht
Schimpft	NN	1	Schimpft
Lot	NN	1	Lot
besänftigen	VB	1	besänftigen
teuerst	JJ	1	teuerster
scherzen	VB	1	scherzen
dümmre	NN	1	dümmre
ausgibt	NN	1	ausgibt
weichste	NN	1	weichste
Geschenken	NN	1	Geschenken
saub	JJ	1	sauber
Hehl	NN	1	Hehler
moralisieren	NN	1	moralisieren
Kalender	NN	1	Kalender
nütze	NN	1	nütze
gestorb	JJ	1	gestorben
erinnerte	NN	1	erinnerte
kränken	VB	1	kränken
hintragen	NN	1	hintragen
Erhaltung	NN	1	Erhaltung
zitterte	NN	1	zitterte
zuliessen	NN	1	zuließen
betreigen	VBN	1	betriegt
belauschen	JJ	1	belauschen
beschreiben	VB	1	beschreiben
allzuviel	RB	1	allzuviel
Mörder	NN	1	Mörder
siebenmal	RB	1	siebenmal
anfiele	NN	1	anfiele
subtil	JJ	1	subtil
schw	JJ	1	schwer
nahen	VB	1	nahen
Stern	NN	1	Stern
Welch	JJ	1	Welches
Döschen	VB	1	Döschen
preiswürdigen	NN	1	preiswürdigen
Tabak	NN	1	Tabak
ausgepresst	NN	1	ausgepreßt
Bärten	NN	1	Bärten
Magd	NN	1	Magd
geholfen	NN	1	geholfen
Karte	NN	1	Karte
Umständen	NN	1	Umständen
Ankläger	NN	1	Ankläger
ochsenmässig	JJ	1	ochsenmäßig
Predigt	NN	1	Predigt
Küsschen	NN	1	Küßchen
reisete	NN	1	reisete
dienstwilliger	NNP	1	dienstwilliger
höflich	JJ	1	höflich
schlage	NN	1	schlage
schätzen	VB	1	schätzen
letztemal	RB	1	letztemal
erpicht	NN	1	erpicht
Werde	NN	1	Werde
ausgestellet	NN	1	ausgestellet
dreiden	VB	1	dritten
ausgenomm	JJ	1	ausgenommen
Geld	NN	1	Geld
beinahen	VBN	1	beinahe
Besorgnis	NN	1	Besorgnis
geringsten	NN	1	geringsten
langen	VBN	1	lang
Finstern	NN	1	Finstern
ankömmt	NN	1	ankömmt
weder	CC	1	weder
Erstlich	JJ	1	Erstlich
Vergessen	NN	1	Vergessen
genugsames	NN	1	genugsames
Gesindel	NN	1	Gesindel
wegstipitzt	NN	1	wegstipitzt
Sacke	NN	1	Sacke
überhoben	NN	1	überhoben
Überlegungen	NN	1	Überlegungen
Schirrmeister	NN	1	Schirrmeister
schmeckt	NN	1	schmeckt
hängen	VBN	1	gehangen
hastig	JJ	1	hastig
Sprechen	VB	1	Sprechen
Prisch	JJ	1	Prischen
Verdruss	NN	1	Verdruß
nuren	RB	1	nur
Eifer	NN	1	Eifer
Potz	NN	1	Potz
zergliedern	NN	1	zergliedern
verwegen	NN	1	verwegen
ins	IN	1	ins
brauche	NN	1	brauche
Rasenden	NN	1	Rasenden
Geschmack	NN	1	Geschmack
gehorsamster	NNP	1	gehorsamster
Gebüschen	VB	1	Gebüsche
genau	RP	1	genau
Landwein	NN	1	Landwein
vorzuwerfen	VB	1	vorzuwerfen
Besaufen	NN	1	Besaufen
spielt	NN	1	spielt
vertreiben	VB	1	vertreiben
gefällige	NN	1	gefällige
