Title: Nathan der Weise
Number of all lemmas: 11120
Nummber of different lemmas: 4133

Lemma	POS	Frequency	Tokens
wohl	RB, RP, IN, JJ	121	wohl
Nathan	NN, NNP	92	Nathan
Gott	NN, NNP	89	Gott
Vater	NN, NNP	88	Vater
Al-Hafi	NN, NNP	80	Al-Hafi, AL-HAFI
gut	RB, JJ, VB	78	gut, guter, gute, guten
Bruder	NN, JJ	67	Bruder
sagen	VB, VBN, RB, RP, PRP$	63	sagen, sagt, sage, gesagt, sagte
Jude	NN, NNS	59	Jude, Juden
Saladin	NN, JJ	59	Saladin, SALADIN
gar	RP, RB, IN	55	gar
lieb	VB, JJ	52	lieber, liebes, lieb, lieben, liebe
Patriarch	JJ, NN, VB	48	Patriarchen, Patriarch
gern	RP, RB, IN, VB, WRB	48	gern
weeissen	VB	46	weiß
wär	NN, VB	46	wär, wäre
Mann	NN, NNP	44	Mann
Christ	NN, NNS	44	Christ, Christen
erst	VB, JJ, RP, RB, IN	43	erste, ersten, erst, erster
sehn	NN, NNP	39	sehn
Sultan	NN, JJ	38	Sultan
Recha	NN, NNP	36	Recha
sonst	IN, RB, RP	36	sonst
hören	VB	34	hören, hört, hörte, hörst, höre
bald	RB, IN, WRB, RP	34	bald
wahr	RP, RB, JJ	33	wahr, wahre
hab	NN	33	hab
Ah	NN	33	Ah
Herr	NN, NNP, JJ	32	Herr
nie	IN, RB, RP	31	nie
allein	RB, RP, IN, WRB	31	allein
kömmen	MD	30	kömmt, kömmst
Sittah	NN, NNP	30	Sittah
rechen	VB, VBN, JJ	30	rechte, recht
Daja	RB	29	Daja
Geld	NN, NNP	28	Geld
eben	RB, IN, RP, VB	27	eben
Mädchen	NN, NNP	27	Mädchen
denken	VB, PRP$	26	denken, dachte, denkt, denke
geh	NN	26	geh
Menschen	NN	26	Menschen
Wohl	RB, IN, WRB	26	Wohl
seid	NN	26	seid
sprechen	VB, VBN	25	sprechen, sprach, gesprochen, spricht
Tempelherr	NN, JJ	25	Tempelherr, Tempelherren
Ritter	NN, NNP	25	Ritter
selb	DT	25	selber
freilich	RB, RP, IN, WRB	25	freilich
sehen	VB, VBN	24	sahen, sehen, seht, sieht, sah, gesehen
wenig	IN, RB, NNP, RP	24	wenig
kennen	VB	24	kennen, kenne, kennt
Allein	NN	24	Allein
glauben	VB, VBN	24	glaubte, glaubt, glauben, glaube, glaubst, geglaubt
ichs	NN, NNP, FW	24	ichs
Herz	NN, NNS, JJ	23	Herz, Herzen
Liebe	NN	23	Liebe
Freund	NN, JJ, NNP, NNS	23	Freund, Freunde
Schwester	NN	22	Schwester
Zeit	NN, JJ	22	Zeit
wissen	VB, RB	22	wissen
itzt	DT, RP	22	itzt
Dank	RP, IN	22	Dank
seiner	PRP$	22	seiner
Geh	NN, NNP	22	Geh
Eure	NN, JJ, RB	21	Eure
soen	RB, VB, VBN	21	so
habt	NN	21	habt
Derwisch	NN	21	Derwisch
Ring	NN, NNS	21	Ring, Ringe
Euer	NN, JJ	21	Euer
dochen	VB, RB, VBN, RP	21	doch
ists	NN	21	ists
retten	VB, VBN, RP	21	rettete, retten, gerettet
Sei	NN	20	Sei
Tochter	NN	20	Tochter
hätt	NN	20	hätt
Engel	NN	20	Engel
Recht	NN	19	Recht
Komm	NN	19	Komm
Ei	NN	19	Ei
Kind	NN, NNP	19	Kind
Mensch	NN, JJ	19	Mensch
Lass	NN, JJ	18	Laß
Wunder	NN	18	Wunder
Leben	NN, NNP	18	Leben
Welt	NN	18	Welt
gewiss	NN, JJ, NNP	17	gewiß, gewissen
finden	VB, RB, VBN, RP	17	finden, fand, gefunden
lange	RB, IN	17	lange
bloss	RB, IN, RP, JJ	17	bloß, bloße
nennen	VB, PRP$	17	nennen, nennt, nannte, nennst, nennte
nuren	RB, RP, VB, VBN	17	nur
wahrlich	JJ	16	wahrlich
willst	WRB, RP, RB, NNP	16	willst
deiner	PRP$	16	deiner
klein	JJ, RB	16	kleines, klein, kleinen, kleiner
Ha	NN	16	Ha
Volk	NN, NNP	16	Volk
nehmen	VB, VBN	16	nehmen, genommen, nehme, nahm
Sache	NN	16	Sache
weit	JJ, RB	16	weit, weitem
Gut	NN, JJ	16	Gut, Gute, Guter
stehen	VB, RB	16	stand, steht, stehe, stehen
jung	JJ, VB	16	junger, jung, junge, jungen
Hand	NN, JJ	15	Hand
Herrn	JJ, NN	15	Herrn
Schach	NN, JJ	15	Schach
Dajaten	RB, VB	15	Daja
fragen	VB, RP, RB	15	fragen, fragt, gefragt
Feuer	NN, JJ	14	Feuer
wisst	NN	14	wißt
heuen	RB, VB, VBN	14	heut, heute
hast	NN	14	hast
heeissen	VB	14	heißen, heißt, heiße, heißet
Sieh	NN	13	Sieh
Wort	NN, NNS	13	Wort, Worte
brauchen	VB, VBN, RB	13	braucht, brauchen
weniger	RB, VB, RP, IN	13	weniger
kurz	JJ	13	kurz, kurzem, kurze
leben	VB, VBN	13	lebt, leben, lebte
nimm	NN	13	nimm
besser	RP, RB, IN	13	besser
meines	NN	13	meines
Stauffen	NN	13	Stauffen
fromm	JJ, VB, NN	13	fromme, fromm, frommer, frommen
oft	IN, RB, WRB	13	oft
auchen	VB, RB	13	auch
Euern	NN, JJ	13	Euern
Hafi	NN	13	Hafi
kaum	RB, RP, IN, WRB	13	kaum
seines	PRP$	13	seines
wem	WP	13	wem
deinen	NN, NNP	12	deinen
lass	JJ, VB	12	laß, lasse
best	JJ, NN	12	besten, beste, best
genug	RP, RB	12	genug
weisen	VB, PRP$	12	wies, weisen
ewig	JJ	12	ewig, ewige, ewigen, ewiger
komm	NN	12	komm
Tag	NN	12	Tag, Tage
andern	DT, JJ	12	andern
Seele	NN	12	Seele
verlangen	VBN, VB	12	verlangt, verlangen
Hört	NN	12	Hört
eins	CD	12	eins
Gewiss	UH, JJ	12	Gewiß, Gewisse
Christin	NN	11	Christin
niemand	DT, RB	11	niemand
Sohn	NN, NNS	11	Sohn, Söhne
bitten	VB, PRP$	11	bittet, bitten, bitte
läng	JJ	11	länger
Sagen	VB, VBN	11	Sagt, Gesagt
fort	RP, IN, RB	11	fort
gehören	RP, VBN, VB	11	gehört
schwerlich	JJ	11	schwerlich
fehlen	VB, VBN	11	fehlt, fehlen, fehlet, fehlte, gefehlt
Palmen	NN	11	Palmen
bitt	NN, JJ	11	bitt, bitter, bitte
ins	IN	11	ins
gross	JJ, VB	11	große, groß, großen
Assad	NN, VB, NNP	11	Assad
Rat	NN	11	Rat
lässen	VB	11	läßt
jen	VB, DT, JJ, WDT	11	je, jene, jenem, jenen, jener
ruhig	JJ	11	ruhig, ruhige
fühlen	VB	11	fühlen, fühlte, fühle, fühlest, fühlt
holen	VB, VBN	11	holen, holte, geholt, holt
reich	JJ	11	reich, reicher
sollt	NN	11	sollt
Wahrheit	NN	11	Wahrheit
andre	NN, NNP	10	andre
Augenblick	NN, NNP	10	Augenblick
Weiss	NN, JJ	10	Weiß
deinem	NN	10	deinem
drei	CD	10	drei
wohlen	VB, RB, JJ	10	wohl
weiss	VB, RB, JJ	10	weiß
lasst	RB, IN, RP, WRB	10	laßt
kalt	JJ	10	kalter, kalt, kalte
borgen	VB, RP, VBN	10	borgen, borgt
Muselmann	NNP, NN	10	Muselmann
Tat	NN	10	Tat
führen	VB	10	führen, führt
Weg	NN	10	Weg
einzig	JJ	10	einziger, einzig, einzigen, einzige
verlieren	VB, VBN, PRP$	10	verlieren, verloren
seh	VB, PRP$	10	sehen, seh
Namen	NN	10	Namen
wenigstens	WRB, RB, RP, IN	10	wenigstens
danken	VB	10	danken, danket, dankt
Gefahr	NN	10	Gefahr
Rechas	NN, JJ	10	Rechas
Haus	NN, NNP	10	Haus, Hause
ward	NNP	9	ward
Blut	NN	9	Blut
deines	NN	9	deines
Lasst	NN	9	Laßt
Bleibt	NN	9	Bleibt
Vernunft	NN	9	Vernunft
Seid	NN	9	Seid
vielleicht	RB, IN, RP	9	vielleicht
Patriarchen	VB, JJ, RB	9	Patriarchen
Tempelherrn	NN	9	Tempelherrn
werd	NNP, NN	9	werd
sag	NN	9	sag
Geduld	NN	9	Geduld
fallen	VB, VBN	9	fiel, fallen
Spiel	NN	9	Spiel
darum	RB	9	darum
Fall	NN, JJ	9	Fall
endlich	RB, IN, RP	9	endlich
Soen	VBN, RB, VB	9	So
weis	JJ, NN	9	weise, weis
Augen	NN, JJ	9	Augen
voll	JJ	9	volle, vollem, voll, voller, vollen
zurück	RP, IN	9	zurück
Glück	NN	9	Glück
gebt	NN	9	gebt
Jud	NN	9	Jud
näh	JJ	9	näher
liebt	NN	9	liebt
zwei	CD	9	zwei
neu	JJ, VB	8	neue, neuen, neues, neu
eh	RB, WRB, IN	8	eh
sterben	PRP$, VB, VBN	8	sterben, stirbt, starb, gestorben
recht	JJ, VB, RB	8	rechter, recht
übel	JJ	8	übel
frei	JJ	8	frei, freien, freier, freiem
Curd	RB, NNP	8	Curd
Mantel	NN, JJ	8	Mantel
jaten	RB, RP, VB	8	ja
unserm	PRP$	8	unserm
spielen	VB	8	spielen
schlagen	VB	8	schlagen, schlägt, schlagt
wert	RP	8	wert
andrer	NN	8	andrer
suchen	VBN, VB	8	gesucht, sucht, suchen
hör	NN, VB	8	hör, höre
Eurer	NN, JJ	8	Eurer
Auchen	VB, RB, VBN	8	Auch
Tempelherren	NN	8	Tempelherren
tausend	CD	8	tausend
weisst	NN	8	weißt
stehn	NN	8	stehn
Händen	NN, JJ	8	Händen
Natur	NN	8	Natur
fällen	RP, VB	8	gefällt, fällt
Euerm	NN, NNP	8	Euerm
Feind	NN, NNS	8	Feind, Feinde
leicht	JJ, NNP, RP, IN	8	leicht
Himmel	JJ, NN	8	Himmel
hättet	NN, NNP	8	hättet
Hause	NN	8	Hause
Stelle	NN	8	Stelle
setzen	VB, RP, VBN	8	setzt, setzen, setzte, gesetzt
sehe	PRP$	8	sehe
Kopf	NN	8	Kopf
bezahlen	VB, RP, VBN, PRP$	7	bezahlen, bezahlt
tot	JJ	7	tot
Gewalt	NN	7	Gewalt
Königin	NN	7	Königin
Freilich	JJ	7	Freilich
schämen	VB	7	schämen, schämt
Grund	NN	7	Grund
wüsste	NN	7	wüßte
Tugend	NN, JJ	7	Tugend
lieben	VB, NN, RB	7	lieben, liebt, liebe
Ende	NN	7	Ende
Nuren	RB, VB	7	Nur
dünkt	NN	7	dünkt
Kinder	NN	7	Kinder
Gottes	NN	7	Gottes
unser	PRP$	7	unser
Habt	NN	7	Habt
Wär	NN	7	Wär
Gutes	NN, NNP	7	Gutes
Mutter	NN	7	Mutter
reden	VB	7	reden, rede
arm	JJ	7	armen, arm, armer, armes
Bild	NN	7	Bild
steh	NN	7	steh
Stimme	NN	7	Stimme
indes	CC, RB	7	indes
Wunsch	JJ, NN	7	Wunsch
nochen	RP, VB, RB	7	noch
bring	FW	7	bring
verlor	JJ, NN	7	verloren, verlor
rufen	VB	7	rief, rufen, ruft
Christenkind	NN	7	Christenkind
Drum	NN	7	Drum
handeln	VB	7	handeln, handle, handelt
vergessen	VBN, RP, VB	6	vergessen
Richter	NN	6	Richter
sicher	RB, IN, RP	6	sicher
spät	JJ	6	spät
Taten	NN	6	Taten
Jüdin	NN	6	Jüdin
Gedanke	NNS, NN	6	Gedanken, Gedanke
Gern	NN	6	Gern
Seit	IN	6	Seit
fangen	VBN, VB, NN	6	gefangen, fängt, fingt
schenken	VB	6	schenken, geschenkt
brav	JJ, VB	6	brav, braven, braver
Schuld	NN	6	Schuld
Kloster	NN	6	Kloster
erzählen	VB	6	erzählen, erzählt, erzähle, erzählet
Gehört	NN	6	Gehört
ihrem	PRP$	6	ihrem
Ists	NN	6	Ists
Dochen	RB, VB, VBN	6	Doch
untern	JJ, NN	6	untern
nunen	VB, RB	6	nun
fassen	VB, VBN	6	faßt, gefaßt, fassen
Tränen	NN	6	Tränen
verstehen	VB, RB	6	verstehn, versteht, verstehen
Weisen	NN, VB	6	Weisen, Wies
Wem	NN	6	Wem
Dingen	NN	6	Dingen
lesen	VB, PRP$	6	lesen, gelesen
schaden	VB	6	schadet, schaden
Filneck	NN	6	Filneck
stolz	JJ	6	stolz
Bettler	NN	6	Bettler
Nathans	NN	6	Nathans
halt	IN, RP	6	halt
schuldig	JJ	6	schuldig
schlecht	JJ	6	schlecht, schlechter
Nimm	NN	6	Nimm
schnell	JJ	6	schnell, schneller
wessen	WP	6	wessen
Sultans	JJ, NN	6	Sultans
gibts	NN, JJ	6	gibts
unsrer	PRP$	6	unsrer
richtig	JJ	6	richtig
Aug	NN, JJ	6	Aug, Auge
aufs	NN, IN, JJ	6	aufs
mirs	NN	6	mirs
Stein	NNS, NN	6	Steine, Stein
Hast	NN	6	Hast
edler	NN	6	edler
Hab	NN	6	Hab
mind	JJ	6	minder
Auge	NN	6	Auge
verbrennen	RP, VB	6	verbrannt, verbrennen
Jerusalem	NNP, NN	6	Jerusalem
erwarten	VB	6	erwarten, erwartet
schaffen	VB	6	schaffen, schafft
Geheimnis	NN	6	Geheimnis
Ihrs	NN	6	Ihrs
Weit	NN, NNP	6	Weit
Not	NN	6	Not
Weib	NN	6	Weib
Fast	NN	6	Fast
Feur	NN	6	Feur
Tut	NN, JJ	6	Tut
Rede	NN	6	Rede
etwa	RP, RB, IN	6	etwa
stets	RB, JJ, IN	6	stets
selten	RB, RP	6	selten
ziehen	VB, VBN	6	zieht, ziehst, gezogen
Gelegenheit	NN	6	Gelegenheit
wünschen	VB, VBN	6	wünschte, gewünscht, wünsche
Bald	NN	6	Bald
Blick	NN, NNP	6	Blick
Brautkleid	NN	6	Brautkleid
Mach	NN	6	Mach
treten	VB, RP	6	trat, treten, getreten, tritt
dennen	RB, VB	5	denn
Kindheit	NN	5	Kindheit
Wasser	NN	5	Wasser
arme	NN	5	arme
wart	NNP, NN	5	wart
Wege	NN, NNP	5	Wege
tragen	VB	5	tragen, trägt, tragt
unterscheiden	VB	5	unterscheiden
heissen	PRP$, VB	5	heißen
Eindruck	NN	5	Eindruck
Kurz	NN	5	Kurz
Ganges	NNP	5	Ganges
sieh	NN	5	sieh
Bruders	NN	5	Bruders
Gewesen	NN	5	Gewesen
kennst	NN	5	kennst
Kasse	NN	5	Kasse
könnt	VB, RB, JJ	5	könnt
Zweifel	NN	5	Zweifel
Schwert	NN	5	Schwert
plötzlich	JJ	5	plötzlich
stecken	VB	5	steckt, stecken
Beste	NN	5	Beste
bestellen	VBN, VB, RP	5	bestellt, bestellen
liebern	VB, NN	5	lieber
würdig	JJ	5	würdig
hoffen	VB	5	hoffen, hoffte, hofft
werfen	VB	5	wirft, geworfen, werfen, warf
Euers	NN	5	Euers
Beutel	NN	5	Beutel
zweit	JJ	5	zweiten, zweiter, zweite
König	NNP, NN	5	König
merken	VB	5	merken, merkt, merke
geschwind	RB, FW	5	geschwind
dergleichen	PRP	5	dergleichen
drum	RP, RB	5	drum
krank	JJ	5	krank
Christenheit	NN	5	Christenheit
zugleich	RB, IN	5	zugleich
nah	JJ	5	nah, naher
schicken	RP, VB	5	geschickt, schicken
Bloss	NN	5	Bloß
erfahren	RP, VB, VBN	5	erfahren
alt	JJ	5	alter, alt, alte
Glauben	NN	5	Glauben
Wolf	NNP, NN	5	Wolf
Kleinigkeit	NN	5	Kleinigkeit
Jahren	NN	5	Jahren
Wozu	NN	5	Wozu
Gewissen	NN	5	Gewissen
Geckerei	NN	5	Geckerei
gnug	NN	5	gnug
damien	VB	5	damit
gelehrt	JJ	5	gelehrt
Augenblicke	NN	5	Augenblicke
blieb	NN	5	blieb
Füssen	NNP	5	Füßen
hassen	VB	5	hießet, hieß, hassen
nehmt	NN	5	nehmt
Argwohn	NN	5	Argwohn
Denkt	NN	5	Denkt
vernehmen	RP, VBN, VB	5	vernommen, vernehmen
stellen	VB	5	stellen, stellt
Zeiten	NN	5	Zeiten
Kennt	NN	5	Kennt
fürcht	NN	5	fürchte, fürcht
sogleich	RB, IN, RP	5	sogleich
Zug	NN	5	Zug
schön	JJ	5	schön
Sonst	NN	5	Sonst
erkennen	VB	5	erkennen
möchen	MD	5	möcht
Zins	NNS, NN	5	Zinsen, Zins
Genug	NN	5	Genug
Ernst	NNP	5	Ernst
Vielleicht	RB, IN	5	Vielleicht
gefallen	VB, VBN, RP	5	gefallen
bessern	VB, PRP$	5	besser, bessern
Entschluss	NNS, NN	5	Entschlüsse, Entschluß
Geist	NN	5	Geist
längst	IN, RB	5	längst
Welch	NN	5	Welch
Arm	NN, NNS	5	Arm, Arme
Ohr	NN	5	Ohr
manch	JJ, DT	5	manche, manchem, manches, manch
weder	CC, RB	5	weder
würd	NNP	5	würd
loben	VB, RP	5	loben, gelobt
Ach	NN	5	Ach
drauf	RP, RB	4	drauf
dienen	VB	4	dienen
ungefähr	IN, WRB, RP	4	ungefähr
reichen	VB, PRP$	4	reiche, reichen
welch	WDT, WP	4	welch
ziemt	NN	4	ziemt
Posse	NN	4	Posse
Seite	NN	4	Seite
Rechte	NN	4	Rechte
Geschwind	JJ, NN	4	Geschwind
gehabt	NN	4	gehabt
vorgehen	VB	4	vorgeht
Gang	NN, NNP	4	Gang
Einfalt	NN	4	Einfalt
Conrad	NNP	4	Conrad
Spott	NN	4	Spott
wirst	WRB, RP	4	wirst
vielmehr	RB	4	vielmehr
Prinzessin	NN	4	Prinzessin
gewinnen	VB, VBN, RP	4	gewinnen, gewonnen
mehren	VB, RP	4	mehr
Libanon	NNP	4	Libanon
Springer	NN	4	Springer
Hauses	NN	4	Hauses
Spiele	NN	4	Spiele
frisch	JJ	4	frisch, frische
Versprechen	NN	4	Versprechen
He	NN	4	He
Gekommen	NN	4	Gekommen
Fenster	NN, JJ	4	Fenster
nu	UH	4	nu
Bettlern	NN	4	Bettlern
entdeckt	RP, RB, NN	4	entdeckt
Wahn	NN	4	Wahn
warst	RP, WRB, IN, RB	4	warst
Absicht	NN	4	Absicht
Seel	NN, JJ	4	Seel, Seele
Sehen	VB, VBN	4	Seht
unsers	PRP$	4	unsers
Glaube	NN	4	Glaube
Unruh	NN	4	Unruh
fasen	VB	4	fast, fasten
erweisen	RP, RB, VB	4	erwiesen, erweisen
drücken	VB, RP	4	drücken, gedrückt
Verbrannt	NN	4	Verbrannt
gilts	NN	4	gilts
Eur	NN, JJ	4	Eure, Eurer
doppelt	RB, JJ	4	doppelt
ähnlich	JJ	4	ähnlich
gib	NN	4	gib
gehn	NN	4	gehn
vertrauen	VB	4	vertrauen
Diensten	NN	4	Diensten
unsre	PRP$	4	unsre
Hieren	VBN, RP, RB	4	Hier
Ägypten	NN	4	Ägypten
Fällen	NN, VB, RB	4	Fällen, Fällt
Wert	NN, JJ	4	Wert
Dennen	RP, VB, RB	4	Denn
Pfand	NN	4	Pfand
kämpfen	VB	4	kämpft, kämpfen
siegen	VB, VBN	4	siegen, siegt
Munde	NN	4	Munde
begegnen	VB	4	begegnet, begegnen
Hats	NN	4	Hats
wahren	VB, PRP$	4	wahren
verschmäht	NN	4	verschmäht
Eures	NN	4	Eures
Nehmt	NN	4	Nehmt
schöner	NN	4	schöner
ohn	NN	4	ohn
Erst	RB	4	Erst
Söhnen	NN, VB	4	Söhnen
treffen	VB, VBN	4	treffen, getroffen, trifft
treibt	NN, NNP	4	treibt
Tod	NN	4	Tod
schweig	JJ	4	schweig
Ins	NN	4	Ins
vorbei	IN	4	vorbei
Guten	NN	4	Guten
Mönch	NN	4	Mönch
bekommen	VB	4	bekommen
wagen	VB	4	wagen
Märchen	NN	4	Märchen
Vaters	NN	4	Vaters
Mansor	NN	4	Mansor
dank	IN	4	dank
Nie	NN	4	Nie
stürzte	NN, NNP	4	stürzte
find	NN	4	find
irgend	JJ	4	irgend
Sorge	NN	4	Sorge
sei	VB, JJ	4	sei
klug	JJ	4	klug
Richards	NN, JJ	4	Richards
Tage	NN	4	Tage
Sünde	NN	4	Sünde
Ding	NN	4	Ding
Verstehen	VB	4	Versteht
Manne	NN	4	Manne
bös	JJ	4	böser, böse
Wahrlich	JJ	4	Wahrlich
hinter	IN	4	hinter
allgemein	JJ, VB	4	allgemeine, allgemein, allgemeinen
helfen	VB	4	helfen, hilft
gesehn	NN	4	gesehn
lang	JJ	4	langer, lang
Erlaubt	NN	4	Erlaubt
Steh	NN, JJ	4	Steh
wiedern	VB, VBN	4	wieder
sprichst	NN	4	sprichst
warten	VB	4	warten, wartet
bilden	VBN, VB	4	gebildet, bilden, bildete
echt	JJ, NN	4	echten, echt, echte
umsonst	RB, RP	4	umsonst
denk	NN, JJ	4	denk, denke
Kaum	NN	4	Kaum
ganzen	RB, VB	4	ganz
mags	NN	4	mags
wärs	NN	4	wärs
Rechnung	NN	4	Rechnung
sollst	RB, WRB	4	sollst
Stadt	NN, NNP	4	Stadt
tu	NN	4	tu
Unsinn	NN	4	Unsinn
weg	RB, RP	4	weg
Kraft	NN	4	Kraft
Lebt	NN	4	Lebt
Ohn	NN	4	Ohn
Vorsicht	NN	4	Vorsicht
kenn	JJ, NN	4	kenne, kenn
Klosterbruder	NN	4	Klosterbruder
Kindern	NN, JJ	4	Kindern
Ehr	NN	3	Ehr
hats	NN	3	hats
Wünsch	JJ, NN	3	Wünsche, Wünsch
Kleid	NN	3	Kleid
Sach	PRP$, JJ	3	Sach, Sache
Tieres	NN	3	Tieres
Vorteil	NN	3	Vorteil
vermögen	VB	3	vermag, vermögen
Judenmädch	JJ	3	Judenmädchen
grösst	VB, JJ	3	größte, größten
erzähl	NN	3	erzähl
gelass	JJ	3	gelassen
Schwerlich	RB, JJ	3	Schwerlich
fleissig	JJ	3	fleißig
Himmels	NN, JJ	3	Himmels
Hülfe	NN	3	Hülfe
hierher	RB, RP	3	hierher
trefflich	JJ	3	trefflich, trefflichen
Wills	RB	3	Wills
Weise	NN	3	Weise
Gestalt	NN	3	Gestalt
erzogen	NN	3	erzogen
wenigen	RB, VBN, VB	3	wenig
Versteh	NN	3	Versteh
Fürst	JJ, NN	3	Fürsten, Fürst
konnt	JJ, NN	3	konnten, konnt
verfolgen	VB	3	verfolgen
beschwor	NN	3	beschwor
sonen	RB, VB	3	sonst
Geschlechts	NN	3	Geschlechts
Vergnügen	NN	3	Vergnügen
eilt	NN	3	eilt
eile	NN	3	eile
lächeln	VB	3	lächelt, lächeln
Lächeln	NN	3	Lächeln
Geburt	NN	3	Geburt
Dienste	NN	3	Dienste
Verschmäht	NN	3	Verschmäht
Jahre	NN	3	Jahre
verbinden	VB, VBN	3	verbunden
Wohlan	NN	3	Wohlan
Boten	NN	3	Boten
Treu	NN	3	Treu
Volke	NN	3	Volke
sanft	JJ	3	sanfte, sanfter
wider	IN	3	wider
müsst	VB, RB	3	müßt, müßte
stehlen	VB, VBN	3	stehlen, gestohlen
hoff	NN	3	hoff
Reichtum	NN	3	Reichtum
meinern	VB	3	meiner
dächte	NN	3	dächte
Wink	NN	3	Wink
Leidenschaft	NN	3	Leidenschaft
Brüderchen	NN	3	Brüderchen
Stolz	NN	3	Stolz
gönnen	VB	3	gönnen
bereit	RP, IN	3	bereit
Stell	NN	3	Stell
Heisst	NN, JJ	3	Heißt
Grab	NN	3	Grab
Bubenstück	NN	3	Bubenstück
Orten	NN	3	Orten
Deutschland	NNP	3	Deutschland
drüber	NN	3	drüber
trug	NN	3	trug
Erinnern	NN, VBN	3	Erinnern, Erinnert
wisse	NN	3	wisse
dacht	RB	3	dacht
leeren	PRP$, VB	3	leeren
warm	JJ	3	warm
Pferd	NN	3	Pferd
Phantasie	NN, JJ	3	Phantasie
gehorchen	VB	3	gehorchen
überrasch	NN	3	überrasch
Hm	NN	3	Hm
versuchen	VB	3	versucht, versuchen
Fort	NN	3	Fort
nachgeschickt	NN	3	nachgeschickt
bleibe	NN	3	bleibe
Entzücken	NN	3	Entzücken
Heraus	IN	3	Heraus
Lieb	NN	3	Lieb
schlassen	VB	3	schließt
Glut	NN	3	Glut
Neugier	NN	3	Neugier
schlimm	JJ	3	schlimm, schlimmes
annehmen	VBN	3	angenommen
Verderben	NN	3	Verderben
bessrer	NN	3	beßrer
hol	NN	3	hol
Geck	NN	3	Geck
keines	NN	3	keines
stimmen	VBN, VB	3	stimmt, stimmen
freilichen	VB, VBN	3	freilich
Münze	NN	3	Münze
Überschuss	NN	3	Überschuß
hübsch	JJ	3	hübsch, hübschen, hübsche
legen	VB, VBN	3	legen, gelegt
freuen	VB, VBN	3	freuen, freut, gefreut
Verlust	NN	3	Verlust
Bescheidenheit	NN	3	Bescheidenheit
sonderbar	JJ	3	sonderbar
Name	NN	3	Name
gekannt	NN	3	gekannt
Kerl	NN	3	Kerl
schweigen	VB	3	schweigt
Oft	NN	3	Oft
ohnedem	RB	3	ohnedem
Lande	NN	3	Lande
Bitte	NN	3	Bitte
Kömmt	NN	3	Kömmt
Erhalten	NN, VBN	3	Erhalten
Krone	NN	3	Krone
Wohin	NN	3	Wohin
verlegen	VB	3	verlegen
geb	NN	3	geb
Krank	NN	3	Krank
Alles	NN	3	Alles
Babylon	NN	3	Babylon
lösen	VB	3	lösen, löset
Güte	NN	3	Güte
falsch	JJ	3	falsch, falschen
Mund	NN	3	Mund
Freundin	NN	3	Freundin
schonen	VB, RB	3	schon
Luft	NN	3	Luft
wozu	WRB	3	wozu
besondre	NN	3	besondre
fein	VB, JJ	3	feine, fein
Itzt	NN	3	Itzt
Meinung	NN	3	Meinung
sterbend	JJ	3	sterbend
los	RB, RP	3	los
euer	PRP$	3	euer
welchem	WP	3	welchem
einander	PRP	3	einander
sagst	NN	3	sagst
Warte	NN	3	Warte
gebot	JJ	3	geboten
Traun	NN	3	Traun
brauch	NN	3	brauch
grössern	NN, JJ	3	größern
laut	JJ	3	lauter, laute
überlegt	JJ	3	überlegt
Wisst	NN	3	Wißt
nenn	NN	3	nenn
Hirn	NN	3	Hirn
Fleck	NN	3	Fleck
Gnade	NN	3	Gnade
Europa	NNP	3	Europa
Besinn	NN	3	Besinn
kaufen	RP, VB	3	gekauft, kauftet
Armen	NN	3	Armen
ferner	RB	3	ferner
Schwesterchen	NN	3	Schwesterchen
Leib	NN	3	Leib
lernen	VB, VBN	3	lernen, gelernt, lernt
wofür	RB	3	wofür
Blanda	NN	3	Blanda
Schatz	NN, NNS	3	Schatz, Schätze
Eh	NN	3	Eh
versteh	NN	3	versteh
Sinai	NN	3	Sinai
Raub	NN	3	Raub
abern	VB	3	aber
überall	RB	3	überall
Wegs	NN	3	Wegs
Berge	NN	3	Berge
Berg	NN	3	Berg
verschweigen	VB, PRP$	3	verschweigt, verschweigen
Wohlen	RB	3	Wohl
ersen	VB	3	ersten, erste
Schurken	NN	3	Schurken
Ursach	NN	3	Ursach
Assads	NN	3	Assads
leihen	VB	3	leihen
zusammen	RB, RP, IN	3	zusammen
zwingen	VB	3	gezwungen, zwingen, zwingt
Ibrahim	IN	3	Ibrahim
Freundschaft	NN	3	Freundschaft
valten	VB, RB	3	viel
Betrieger	NN	3	Betrieger
ansehn	NN	3	ansehn
Vielmehr	RP, RB	3	Vielmehr
Rate	NN	3	Rate
Streich	NN	3	Streich
Dienst	NN	3	Dienst
Staat	NN	3	Staat
Horch	NN	3	Horch
Rettung	NN	3	Rettung
Persisch	NNP	3	Persisch
weinen	VB, RP, VBN	3	weinen, geweint
Blumen	NN	3	Blumen
Kamele	NN	3	Kamele
Gefallen	NN	3	Gefallen
Gesicht	NN	3	Gesicht
auferzogen	NN	3	auferzogen
Gründe	NN	3	Gründe
dringen	VBN, VB	3	drang, drängen, gedrungen
herrlich	JJ	3	herrlicher, herrlich
Vermutlich	JJ	3	Vermutlich
Fittiche	NN	3	Fittiche
taugen	VB, VBN	3	taugt
letzt	JJ	3	letzter, letzten
tuts	NN	3	tuts
Indes	NN	3	Indes
Saladins	NN	3	Saladins
gestehen	VB	3	gestanden, gestehen
jagen	VB, VBN	3	jagt
entgegen	RP, TO	3	entgegen
Geboren	NN	3	Geboren
Hut	NN, JJ	3	Hut
begreifen	VB	3	begreife, begriffen, begreifen
tat	VB	3	tat
zwischen	IN	3	zwischen
Verzeih	NN	3	Verzeih
frag	NN	3	frag
Philipp	NNP	3	Philipp
darumen	VB	3	darum
Ehgemahl	NN	3	Ehgemahl
Seiten	NN	3	Seiten
Womit	NN	3	Womit
Beispiel	NN	3	Beispiel
matt	JJ	3	matt
wandeln	VB	3	wandeln
geheim	JJ	3	geheimes, geheime, geheim
Verdacht	NN, JJ	3	Verdacht
Frau	NN	3	Frau
lauft	NN	3	lauft
Staub	NN, NNS	3	Staub, Staube
Kleidung	NN	3	Kleidung
Melek	NN	3	Melek
zufried	JJ	3	zufrieden
Judenmädchen	VB	3	Judenmädchen
solls	RB	3	solls
Geschwister	NN	3	Geschwister
jemand	DT	3	jemand
Reichen	VB	3	Reichen
bins	NN	3	bins
Wollt	NN	3	Wollt
nied	JJ	3	nieder
rechnen	VB	3	rechnen
Könnt	NN	3	Könnt
erhalten	VB, VBN	3	erhielt, erhält, erhalten
zeigen	VBN, VB	3	zeigen, zeigt
Kundschaft	NN	3	Kundschaft
Gebet	NNS, NN	3	Gebete, Gebet
still	JJ	3	still
fremd	JJ	3	fremd, fremde
Gebt	NN	3	Gebt
Gesetz	NN	3	Gesetz
sparen	PRP$, VB	3	sparen
Verloren	NN	3	Verloren
Haupt	NN, JJ	3	Haupt
mitgebracht	NN	3	mitgebracht
betreten	VB	3	betreten
ah	UH	3	ah
schwärmt	NN	3	schwärmt
Gespräch	NN	3	Gespräch
wild	VB, JJ	3	wilden
ändern	VB	3	ändern, ändert
Orden	NN	3	Orden
verlernen	VB	3	verlernen
schw	JJ	3	schwer
untersuchen	VBN, VB	3	untersucht, untersuchen
Mags	NN	3	Mags
womit	WRB	3	womit
sinds	NN	3	sinds
fahren	VB	3	fuhr, fahren
Genannt	NN	3	Genannt
seit	IN	3	seit
stürzt	NN	3	stürzt
Laienbruder	NN	3	Laienbruder
Lebens	NN	3	Lebens
Nachricht	NN	3	Nachricht
genau	RP, RB	3	genau
ungeachtet	IN	3	ungeachtet
scheiden	VB, VBN	2	geschieden
hatt	NN	2	hatt
fragst	NN	2	fragst
steigen	VB, VBN	2	steigen, steigt
schöne	NN	2	schöne
euerm	NN	2	euerm
Christus	NNP	2	Christus
vertraut	JJ, NN	2	vertraut, vertrautes
betteln	VB	2	betteln
Sollt	NN	2	Sollt
Schritte	NN	2	Schritte
Vorurteilen	NN	2	Vorurteilen
irrst	NN	2	irrst
hilfts	NN	2	hilfts
blossen	VB, NN	2	bloß, bloßen
vorgesetzt	NN	2	vorgesetzt
Gestehen	VB	2	Gesteht
offn	JJ	2	offne, offnes
Acht	NNP, NN	2	Acht
schmerzt	NN	2	schmerzt
auszubeugen	NN	2	auszubeugen
Dinge	NN	2	Dinge
wars	NN	2	wars
Person	NN	2	Person
sieben	CD	2	sieben
Geschäft	NN	2	Geschäft
Gewinst	NN	2	Gewinst
lohnen	VB	2	lohnt, lohnen
ers	NN, JJ	2	ers
wovon	WRB	2	wovon
hundert	CD	2	hundert
darnachen	RB, VB	2	darnach
hört	JJ, VB	2	hörte, hört
gönnt	NN	2	gönnt
lau	JJ	2	lau
versprechen	VB	2	versprechen, verspricht
anklagen	VB, VBN	2	angeklagt
Christentum	NN	2	Christentum
verstellt	NN	2	verstellt
erkunden	NN	2	erkunden
erwägen	VBN, VB	2	erwogen, erwägen
Antwort	NN	2	Antwort
Verzeihet	NN	2	Verzeihet
erboten	NN	2	erboten
Ward	NNP, NN	2	Ward
Ware	NNS	2	Waren
unendlich	JJ	2	unendlich
Gedacht	NN	2	Gedacht
verschont	NN	2	verschont
Durchs	NN	2	Durchs
Gleichwohl	RB	2	Gleichwohl
Geldes	NN	2	Geldes
Herzens	NN	2	Herzens
Mannes	NN, JJ	2	Mannes
Närrin	NN	2	Närrin
Deswegen	NN, RB	2	Deswegen
albern	JJ	2	albern
nahe	IN	2	nahe
verweilt	NN	2	verweilt
Bereit	NN	2	Bereit
Hunde	NN	2	Hunde
angenehm	JJ	2	angenehm
inzwischen	RB	2	inzwischen
bst	NN	2	bst
Gemach	NN	2	Gemach
menschlich	JJ	2	menschlich, menschliche
Räuber	NN	2	Räuber
Hecke	NN	2	Hecke
Woran	NN	2	Woran
Wand	NN	2	Wand
gestand	JJ, NN	2	gestanden, gestand
schleunig	RP, IN	2	schleunig
Sättigen	VB, VBN	2	Gesättigt
Miene	NNS	2	Mienen
Schlecht	NN	2	Schlecht
laufe	NN	2	laufe
höchstens	RB, WRB	2	höchstens
Büchelch	JJ, VB	2	Büchelchen
spitz	JJ	2	spitz, spitze
erröten	VB	2	erröten
Gönnts	NNP, NN	2	Gönnts
Bekommen	NN	2	Bekommen
Stehen	VB	2	Steht
bar	JJ	2	baren
blicken	VB	2	blicken, blickte
ausführen	VBN, RP	2	ausgeführt
Wolfs	NN	2	Wolfs
wiederkommt	NN	2	wiederkommt
bess	JJ	2	besser
Hinzufügen	VB	2	Hinzugefügt
irr	NN, JJ	2	irr, irre
weiten	PRP$, VB	2	weiten
eren	RB, VB	2	erst
höchstes	NN	2	höchstes
Wenigstens	NN	2	Wenigstens
zuverlässig	JJ	2	zuverlässig
ungesäumt	NN	2	ungesäumt
Laune	NN, NNS	2	Laune, Launen
mehrer	JJ, NN	2	mehrere
Frevel	NN	2	Frevel
selig	JJ	2	selig
Gestiegen	NN	2	Gestiegen
fest	RP, JJ	2	fest, festen
Salomons	NN	2	Salomons
erkennt	NN	2	erkennt
Hälfte	NN	2	Hälfte
Gross	NN	2	Groß
Kostbarkeiten	NN	2	Kostbarkeiten
Halt	NNS, NN	2	Halte, Halt
Bewunderung	NN	2	Bewunderung
anderm	NN	2	anderm
schäme	NN	2	schäme
Nimmermehr	NN	2	Nimmermehr
Verkennt	NN	2	Verkennt
frage	NN	2	frage
Gar	NN	2	Gar
Mädchens	NN	2	Mädchens
Art	NN	2	Art
füllen	VB	2	füllen
Ton	NN	2	Ton
Beifall	NN	2	Beifall
Punkt	NN	2	Punkt
weiblich	JJ	2	weibliche, weiblich
verschwinden	VB, RP	2	verschwand, verschwunden
binden	VB	2	band
übrige	NN	2	übrige
Ichs	NN	2	Ichs
Geschichte	NN	2	Geschichte
heitre	NN	2	heitre
Topf	NN	2	Topf
verdienen	VB	2	verdienen
Schulden	NN, JJ	2	Schulden
Wärs	NN	2	Wärs
leiden	VB	2	litt
Guen	VB, NN	2	Gute
Franke	NN, NNP	2	Franke
reiten	VB	2	reiten
Schwärmerinnen	NN	2	Schwärmerinnen
dritt	JJ	2	dritter, dritten
Schwachheit	NN	2	Schwachheit
ergründet	NN	2	ergründet
ergründen	NN	2	ergründen
Sogleich	NN	2	Sogleich
Eben	NN	2	Eben
Vergessen	NN	2	Vergessen
geschehn	NN	2	geschehn
trennen	VB	2	trennen
herzlich	JJ, NN	2	herzlich, herzlicher
Botschaft	JJ, NN	2	Botschaft
rot	JJ, VB	2	rote, roter
Dings	NN	2	Dings
mache	NN	2	mache
Grossmut	NN	2	Großmut
hattet	NN	2	hattet
Wahl	NN	2	Wahl
Religion	NN	2	Religion
Kalt	NN	2	Kalt
Milde	NN	2	Milde
gefangner	NN	2	gefangner
Stimm	NN	2	Stimm
michs	NN	2	michs
Worten	NN	2	Worten
Kniee	NN	2	Kniee
bange	NN	2	bange
verbergen	VB	2	verbergen
Verlangen	VB, NN	2	Verlangt, Verlangen
springen	VB	2	springt, sprang
Preis	NN	2	Preis
Wirst	WRB	2	Wirst
gestillt	NN	2	gestillt
bleibt	VB	2	bleibt
Retter	NN	2	Retter
glücklich	JJ, RB	2	glücklich
schleppen	VB	2	schleppen
Rauch	NN	2	Rauch
Brav	NN	2	Brav
unsern	PRP$	2	unsern
Angesicht	NN	2	Angesicht
Unterschied	NN	2	Unterschied
gewohnt	JJ	2	gewohnt
Tabor	NN	2	Tabor
Freunds	NN	2	Freunds
mag	VB	2	mag
tötet	NN	2	tötet
verachten	VB	2	verachten
töten	VB	2	getötet, töten
Glaubt	NN	2	Glaubt
ungern	NN	2	ungern
Menge	NN	2	Menge
Stauffin	NN	2	Stauffin
weissen	PRP$	2	weißen
Buch	NN	2	Buch, Buche
Begreifen	VB	2	Begriffe
Unkraut	NN	2	Unkraut
erwerben	VB	2	erwerben
bezahl	NN	2	bezahl
Gerechtigkeit	JJ, NN	2	Gerechtigkeit
Mild	NN	2	Mild
Kette	NN, NNS	2	Kette, Ketten
verzeiht	NN	2	verzeiht
ungewohnt	NN	2	ungewohnt
wackrer	NN	2	wackrer
Davids	NN, JJ	2	Davids
reif	JJ	2	reif
Datteln	NN	2	Datteln
drohen	VB	2	droht
Wesen	NN	2	Wesen
Schicksal	NN	2	Schicksal
quitt	JJ	2	quitt
Böses	NN	2	Böses
wirken	VB	2	wirken, wirkt
Eue	JJ	2	Euer
entbrech	JJ	2	entbrechen
unternehmen	VB	2	unternommen, unternehmen
Problema	NN	2	Problema
Rings	NN	2	Rings
Möglichkeit	NN	2	Möglichkeit
Elend	NN	2	Elend
and	JJ	2	ander
Obs	NN	2	Obs
vollends	NN	2	vollends
sau	JJ	2	sauer
Hiess	NN	2	Hieß
Hals	NN	2	Hals
Unschuld	NN	2	Unschuld
liebsten	NN	2	liebsten
Schlinge	NN	2	Schlinge
entspräche	NN	2	entspräche
Ringes	NN	2	Ringes
Furcht	NN	2	Furcht
Netze	NN	2	Netze
Schwerd	NN, NNP	2	Schwerd
aufzudringen	NN, NNP	2	aufzudringen
weitern	RB, VBN	2	weiter
betrachten	VB	2	betrachten
ehrwürdger	NN	2	ehrwürdger
Männer	NN	2	Männer
fliessen	VBN, VB	2	geflossen, fließen
Gebrauch	NN	2	Gebrauch
Männern	NN	2	Männern
verzeih	NN	2	verzeih
Christendamen	NN	2	Christendamen
brauchst	NN	2	brauchst
solltet	NN	2	solltet
bekam	JJ	2	bekam
väterlich	JJ	2	väterlichen, väterliches
einst	RB, IN	2	einst
Boden	NN	2	Boden
tut	VB	2	tut
Askalon	NN, JJ	2	Askalon
Kirch	NN	2	Kirch
Darun	NN	2	Darun
Büchern	NN	2	Büchern
Ansehn	NN, NNP	2	Ansehn
Stich	NN, NNS	2	Stich, Stiche
Höchsten	NN	2	Höchsten
Geträumt	NN	2	Geträumt
glaube	VB	2	glaube
Väter	NN	2	Väter
nächst	JJ	2	nächsten
Besten	NN	2	Besten
voraus	RP, IN	2	voraus
ehedemen	VB	2	ehedem
zwanzig	CD	2	zwanzig
Eisen	NN	2	Eisen
zittern	VBN, VB	2	gezittert, zittern
Schatzes	NN	2	Schatzes
lehren	VB	2	lehrt, lehren
Geleiten	VB, NN	2	Geleitet, Geleiten
Stolzes	NN	2	Stolzes
Nochen	RB, VBN	2	Noch
erstenmal	IN, RP	2	erstenmal
neuem	NN	2	neuem
Vergesst	NN	2	Vergeßt
goldnen	NN	2	goldnen
Verächtlich	JJ	2	Verächtlich
wärst	NN	2	wärst
bereuen	VB	2	bereuen
nötig	JJ	2	nötig
sichs	NN	2	sichs
Eilt	NN	2	Eilt
Hass	NN	2	Haß
kosen	VB	2	kosten, kostet
öfters	RB	2	öfters
rühmen	NN	2	rühmen
essen	VB	2	essend, gegessen
bergen	VB	2	bergen
Stirn	NN	2	Stirn
strich	NNP, JJ	2	strich, striche
gesagt	VB, VBN	2	gesagt
fühlte	RB, VB	2	fühlte
schönen	PRP$	2	schönen
Zeichen	NN	2	Zeichen
Schurkerei	NN	2	Schurkerei
Künstler	NN	2	Künstler
horch	NN	2	horch
erinnern	VB	2	erinnern
kleiden	VB	2	kleiden
erinnert	NN	2	erinnert
zanken	NN	2	zanken
Bücher	NN	2	Bücher
gleichwohl	IN, RB	2	gleichwohl
Schmerz	NNS, NN	2	Schmerzen, Schmerz
Mühe	NN	2	Mühe
wiedersehn	NN	2	wiedersehn
Erzogen	NN	2	Erzogen
sodann	NNP	2	sodann
Briefchen	VB	2	Briefchen
Eltern	NN, JJ	2	Eltern
Gelds	NN	2	Gelds
Mauer	NN	2	Mauer
Traum	NNS	2	Träume
wohin	RP, RB	2	wohin
elend	JJ	2	elend
begnadigen	VBN	2	begnadigt
liebste	NN	2	liebste
Gefangner	NN, NNP	2	Gefangner
Schreck	NN	2	Schreck
Eräugnet	NN	2	Eräugnet
teu	JJ	2	teuer
Bedeckung	NN	2	Bedeckung
hinauf	IN	2	hinauf
Türe	NN	2	Türe
daraufen	VB, RB	2	darauf
heben	VBN, VB	2	gehoben, hebt
Zusammen	RB	2	Zusammen
Gespielt	NN	2	Gespielt
geliebt	NN	2	geliebt
wacht	NN	2	wacht
quälen	VBN, VB	2	gequält, quälen
Wirds	NN	2	Wirds
alsdann	NNP, NN	2	alsdann
lautern	NN	2	lautern
verfügen	VB	2	verfügt, verfügen
rächen	VB	2	rächen
ertragen	VB	2	ertragen
allemal	RB	2	allemal
widersprechen	VB	2	widersprechen
Fleisch	NN	2	Fleisch
Betrogen	NN	2	Betrogen
Grille	NN	2	Grille
Gräber	NN	2	Gräber
deutlich	JJ	2	deutlich
Erde	NN	2	Erde
Emir	NN	2	Emir
abe	JJ, RB	2	aber
Armes	NN	2	Armes
bestimmen	VB, PRP$	2	bestimmen
wärmster	NN	2	wärmster
Nenn	NN	2	Nenn
schaudert	NN	2	schaudert
Unglaublich	JJ	2	Unglaublich, Unglaubliche
Verschlingen	NN	2	Verschlingen
zerstreut	NN	2	zerstreut
würdet	NN	2	würdet
nötigen	VBN	2	nötig
erlauben	VB, VBN	2	erlauben, erlaubt
Feste	NN	2	Feste
hart	JJ	2	harten, hart
nimmermehr	NN	2	nimmermehr
borge	NN	2	borge
dirs	NN	2	dirs
unterschlagen	NN	2	unterschlagen
willkomm	JJ	2	willkommen
weisse	NN	2	weiße
stutzt	NN	2	stutzt
bedenken	VB	2	bedenken
Religionen	NN	2	Religionen
Leier	NN	2	Leier
Pflicht	NN	2	Pflicht
freue	NN	2	freue
Neubegier	NN	2	Neubegier
aufgewachsen	NN	2	aufgewachsen
erschaffen	VB	2	erschaffen
Darumen	RB, VB	2	Darum
denkst	NN	2	denkst
erlügen	VB	2	erlogen
Unrecht	NN	2	Unrecht
gabt	NN	2	gabt
Freiheit	NN	2	Freiheit
Stande	NN	2	Stande
Freude	NN	2	Freude
Reich	JJ, NNS	2	Reichen, Reiche
Knall	NN	2	Knall
Kennst	NN	2	Kennst
schüchtern	JJ	2	schüchtern
Vermuten	NN	2	Vermuten
treiben	VB	2	treiben
eignet	NN	2	eignet
zusammenpassen	NN, FW	2	zusammenpassen
Stuhle	NN	2	Stuhle
Fleiss	NN	2	Fleiß
Mohren	NN	2	Mohren
Tode	NN	2	Tode
kamt	NN	2	kamt
Ergebenheit	NN	2	Ergebenheit
Versichert	NN	2	Versichert
liess	VB	2	ließ
Umsonst	NN	2	Umsonst
dus	NN, NNP	2	dus
bliebe	NN	2	bliebe
Ehrwürdger	NN	2	Ehrwürdger
sonder	JJ, NN	2	sonder
aufgedrungen	NN	2	aufgedrungen
Galle	NN	2	Galle
abzuwenden	VB	2	abzuwenden
nützen	VB	2	nützen
sichtbar	JJ	2	sichtbar
verlassen	VB	2	verlassen
Hunger	NN	2	Hunger
Wette	NN	2	Wette
Wahne	NN	2	Wahne
mangeln	VB	2	mangeln
bemerken	VB, VBN	2	bemerken, bemerkt
Getäuscht	NN	2	Getäuscht
Geht	JJ, VB	2	Geht
Anschlag	NN	2	Anschlag
ungewiss	JJ	2	ungewiß
rechts	RP, RB	2	rechts
Kummer	NNP	2	Kummer
brechen	VBN	2	gebrochen
Oh	NN	2	Oh
Bote	NN	2	Bote
sitzen	VB, PRP$	2	sitzen
Gelernt	NN	2	Gelernt
schützen	VB	2	schützen
Siegel	NN	2	Siegel
Koch	NN	2	Koch
Tritt	NN	2	Tritt
Faktum	NN	2	Faktum
schwört	NN	2	schwört
Feld	NN	2	Feld
traf	NN	2	traf
Verlegenheit	NN	2	Verlegenheit
endlichen	RB, VBN	2	endlich
Einsicht	NN	2	Einsicht
Neu	JJ	2	Neu, Neues
Erwarten	NN, NNP	2	Erwarten
Gegenteil	NN	2	Gegenteil
Hände	NN	2	Hände
Gerettet	NN	2	Gerettet
wenigstensen	VB	2	wenigstens
Lilla	NN	2	Lilla
Gib	NNP	2	Gib
wiederkommen	NN	2	wiederkommen
meiner	RB	2	meiner
Ruhm	NN	2	Ruhm
fühlt	RB, VB	2	fühlt
gemein	JJ	2	gemeinen, gemeiner
beliebt	JJ	2	beliebt
Aberglauben	NN	2	Aberglauben
stünde	NN	2	stünde
süssen	NN	2	süßen
Gelt	NN	2	Gelt
Vorsatz	RP, NN	2	Vorsatz
leb	NN	2	leb
lee	JJ	2	leer
Bezahl	NN	2	Bezahl
Ströme	NN	2	Ströme
Finger	NN	2	Finger
verwickeln	NN, NNP	2	verwickeln
Hui	NN	2	Hui
wenigst	JJ	2	wenigsten
Reitknecht	NN	2	Reitknecht
Land	NN	2	Land
verbrannte	NN	2	verbrannte
links	RP, RB	2	links
Zahl	NN	2	Zahl
kennt	RB, VB	2	kennt
Gebracht	NN	2	Gebracht
langen	VB, RB	2	lange
geschmeichelt	NN	2	geschmeichelt
Verstand	NN	2	Verstand
spottest	NN, NNP	2	spottest
Opfer	NN	2	Opfer
irren	VB	2	irren
Euertwegen	NN	2	Euertwegen
Held	NN	2	Held
horchen	VB	2	horchen
Fehlern	NN	2	Fehlern
gesteckt	NN	2	gesteckt
Titel	NN	2	Titel
tus	NN	2	tus
Blicken	NN	2	Blicken
Spenden	NN	2	Spenden
Deutscher	NN	2	Deutscher
beginnen	VB	2	beginnt, beginn
umgekehrt	RP	2	umgekehrt
wandelt	NN	2	wandelt
reg	JJ	2	rege
Teil	NN	2	Teil
Wovon	NN	2	Wovon
verächtlich	JJ	2	verächtlich
unbegreiflich	JJ	2	unbegreiflichen, unbegreiflich
Defterdar	NN	2	Defterdar
Vorrecht	NN	2	Vorrecht
Volkes	NN	2	Volkes
verwünscht	JJ, NN	2	verwünschten, verwünscht
gebären	VB	2	geboren
Paar	NN	2	Paar
umgekommen	NN	2	umgekommen
Ewigkeit	NN	2	Ewigkeit
hiess	VB, NN	2	hieß
Fassung	NN	2	Fassung
Blatt	NN	2	Blatt
Verzeiht	NN	2	Verzeiht
hättest	IN, WRB	2	hättest
vorhin	IN, RB	2	vorhin
Gekannt	NN	2	Gekannt
Hinein	NN	2	Hinein
Geschöpf	NN	2	Geschöpf
Karawane	NN	2	Karawane
geleg	JJ	2	gelegen
wirklicher	NN	2	wirklicher
Werkzeug	NN	2	Werkzeug
empfangen	VB	2	empfange, empfingt
Augenbraunen	NN	2	Augenbraunen
Lieber	NN	2	Lieber
rein	RB	2	rein
Aufs	JJ, NN	2	Aufs
Dufte	NN, NNP	2	Dufte
seht	VB, RB	2	seht
Gesetzt	NN	2	Gesetzt
Gefühl	NN	2	Gefühl
Stoff	NN, JJ	2	Stoff
vergebens	RP, WRB	2	vergebens
Weisheit	NN	2	Weisheit
Zugleich	RP, RB	2	Zugleich
Hätt	NN	2	Hätt
Erraten	NN	2	Erraten
stumpfen	NN	2	stumpfen
Wichtigkeit	NN	2	Wichtigkeit
Schickt	NN	2	Schickt
Überlegung	NN	2	Überlegung
Funken	NN	2	Funken
allmählig	JJ	2	allmählig
Denk	NN	2	Denk
Sturm	NN	2	Sturm
melancholisch	JJ	2	melancholisches, melancholisch
eur	NN, JJ	2	eur
brauche	NN	2	brauche
schenkte	NNP, NN	2	schenkte
schelten	VB	2	schelten, schalten
Wohltat	NN	2	Wohltat
Bösewicht	NN	2	Bösewicht
kleinst	NNP, VB	2	kleinst, kleinste
getauft	NNP, NN	2	getauft
Osten	NN	2	Osten
wen	WP	2	wen
Töchterch	JJ	2	Töchterchen
Pflegen	NN, VB	2	Pflegen, Gepflegt
Eigentum	NN	2	Eigentum
schwören	VB	2	schwören
Schatzmeister	NN	2	Schatzmeister
Gabe	NN	2	Gabe
dennoch	IN, RB	2	dennoch
dreist	JJ	2	dreist
Geniessen	NN	2	Genießen
Rätsel	NN	2	Rätsel
rasch	JJ	2	rasch, rasches
Reichtums	NN	2	Reichtums
Erziehen	NN, RP	2	Erziehen, Erzögt
Willen	NN	2	Willen
neidisch	JJ	2	neidisch
hiervon	RB	2	hiervon
bescheid	JJ	2	bescheiden
Gelder	NN	2	Gelder
Gestürzte	NN	2	Gestürzte
Todes	NN	2	Todes
übrig	JJ	2	übrig
Brüder	IN, NN	2	Brüder
Zudem	RB	2	Zudem
Eifer	NN	2	Eifer
Erzählt	NN	2	Erzählt
auserlesen	NN	2	auserlesen
drin	IN, RP	2	drin
Heer	NN, NNS	2	Heer, Heere
spielt	NN	2	spielt
Jüngling	NN	2	Jüngling
Wüste	NN	2	Wüste
spiele	NN	2	spiele
alleinen	VBN, RB	2	allein
öfter	NN	1	öfter
wäret	NN	1	wäret
Betreiben	VB	1	Betreiben
zöge	NN	1	zöge
Abschach	NN	1	Abschach
Brandmal	RB	1	Brandmal
Aberglaub	NN	1	Aberglaub
euern	NN	1	euern
Charakter	NN	1	Charakter
hinterbracht	NN	1	hinterbracht
abgelegnen	NN	1	abgelegnen
Platz	NN	1	Platz
Erfüllet	NNP	1	Erfüllet
Zelle	NN	1	Zelle
Farbe	NNS	1	Farben
Ruine	NNS	1	Ruinen
jemals	RB	1	jemals
Pflegevater	NN	1	Pflegevater
Zusprach	NN	1	Zusprach
getobt	NN	1	getobt
wich	NN	1	wich
pflegen	VB	1	gepflegt
Beräuchern	NN	1	Beräuchern
Roche	NN	1	Roche
Wuchs	NN	1	Wuchs
Sack	NN	1	Sack
Bestimmt	NN	1	Bestimmt
wahrhaftig	JJ	1	wahrhaftig
launig	JJ	1	launigen
garstger	NN	1	garstger
Sermon	NN	1	Sermon
Frisch	JJ	1	Frisch
Wach	JJ	1	Wachen
Solls	IN	1	Solls
deutsch	JJ	1	deutscher
Wunderbaren	NN	1	Wunderbaren
Verlängert	NN	1	Verlängert
Eigensinn	NN	1	Eigensinn
bürg	NNP	1	bürg
Hängts	NN	1	Hängts
Willkommen	NN	1	Willkommen
Forscher	NN	1	Forscher
Moses	NNP	1	Moses
entgegensetzen	NN	1	entgegensetzen
Barschaft	NN	1	Barschaft
contraten	VBN	1	contra
Besondersen	VBN	1	Besonders
üben	VB	1	üben
zugeschworen	NN	1	zugeschworen
trotzt	NN	1	trotzt
Alten	NN	1	Alten
Schlimm	NN	1	Schlimm
toll	JJ	1	toll
brauchts	NN	1	brauchts
Spur	NN	1	Spur
Pflegetochter	NN	1	Pflegetochter
Asien	NN	1	Asien
Stürzt	NN	1	Stürzt
fördern	VB	1	fördern
schänden	VB	1	schänden
Braut	NN	1	Braut
erschreckest	NN	1	erschreckest
bedünkt	NN	1	bedünkt
Mittelgut	NN	1	Mittelgut
nannt	VB	1	nannt
ungesittet	JJ	1	ungesittet
verspreche	NN	1	verspreche
willkommner	NN	1	willkommner
Hierher	NN	1	Hierher
Entläuft	NN	1	Entläuft
worauf	WRB	1	worauf
Allgerechter	IN	1	Allgerechter
wundersüchtges	NN	1	wundersüchtges
klemmt	NN	1	klemmt
grenzt	NN	1	grenzt
erfreut	VB	1	erfreut
trugs	NN	1	trugs
Länder	NN	1	Länder
allzeit	NN	1	allzeit
Mantels	NN	1	Mantels
solcherlei	NN	1	solcherlei
Hättst	NN	1	Hättst
sprengte	NN	1	sprengte
innigst	JJ	1	innigster
Torheit	NN	1	Torheit
müd	JJ	1	müde
Nackter	NN	1	Nackter
Teufels	NN	1	Teufels
desselben	NN	1	desselben
vergleichen	VB	1	vergleichen
Gefälligkeit	NN	1	Gefälligkeit
Wirt	NN	1	Wirt
gossen	VB	1	goß
aufgebunden	NN	1	aufgebunden
Stacheln	NN	1	Stacheln
vertieft	NN	1	vertieft
empfang	NN	1	empfang
Unterschleif	NN	1	Unterschleif
sandte	NN	1	sandte
geraten	VBN	1	geraten
schiehen	VB	1	geschieht
Jung	JJ	1	Junger
Licht	NN	1	Licht
Fuchses	NN	1	Fuchses
gehorche	NN	1	gehorche
bevölkern	VB	1	bevölkern
hieren	VB	1	hier
Kindch	JJ	1	Kindchen
allzustreng	NN	1	allzustreng
Zwaren	RP	1	Zwar
Blume	NN	1	Blume
stellt	VB	1	stellt
bewusst	JJ	1	bewußt
herein	RP	1	herein
verkenn	NN	1	verkenn
brannte	NN	1	brannte
warf	JJ	1	warf
warb	NN	1	warb
Christenmensch	NN	1	Christenmensch
Willkür	NN	1	Willkür
Rache	NN	1	Rache
Erklärt	NN	1	Erklärt
Gräbern	NN	1	Gräbern
entgelten	NN	1	entgelten
drosseln	VB	1	drosseln
Vorteile	NN	1	Vorteile
schäm	NN	1	schäm
Schwächsten	NN	1	Schwächsten
unterhalten	VB	1	unterhalten
gesund	JJ	1	gesund
sond	JJ	1	sonder
befehl	NN	1	befehl
hochgepriesner	JJ	1	hochgepriesner
Engelschwärmerin	NN	1	Engelschwärmerin
betrogen	NN	1	betrogen
Erwiesen	NN	1	Erwiesen
erdacht	NN	1	erdacht
Delk	NN	1	Delk
Jordan	NNP	1	Jordan
gebieten	VB	1	gebieten
Buhler	NN	1	Buhler
ergreifen	VBN	1	ergriffen
heilsamer	NN	1	heilsamer
lad	NN	1	lad
Fieber	NN	1	Fieber
Bessres	NN	1	Beßres
unterstützen	VB	1	unterstützen
Konnt	NN	1	Konnt
Berichten	VBN	1	Berichtet
Seht	VB	1	Seht
Winkel	NN	1	Winkel
Stunde	NN	1	Stunde
Ungewissheit	NN	1	Ungewißheit
Verschwunden	RB	1	Verschwunden
bösen	NN	1	bösen
gesteht	VB	1	gesteht
frostig	JJ	1	frostig
Enden	NN	1	Enden
Geraumer	NN	1	Geraumer
blind	JJ	1	blind
Wohltun	NN	1	Wohltun
eigen	JJ	1	eigenen
Frage	NN	1	Frage
Getauft	NN	1	Getauft
Ausdruck	NN	1	Ausdruck
Hiernieden	NN	1	Hiernieden
Wille	NN	1	Wille
ungetreuen	NN	1	ungetreuen
sprächst	NN	1	sprächst
schone	NN	1	schone
Ahnenprobe	NN	1	Ahnenprobe
Wolke	NN	1	Wolke
Behandeln	NN	1	Behandeln
Gesichter	NN	1	Gesichter
schüttelt	NN	1	schüttelt
Bande	NN	1	Bande
Gefangnen	NN	1	Gefangnen
verhüllen	VB	1	verhüllen
Äsern	NN	1	Äsern
bestechen	VB	1	bestechen
filzig	JJ	1	filzig
Strassen	NN	1	Straßen
Ziel	JJ	1	Ziel
Gehabt	NN	1	Gehabt
umschatten	NN	1	umschatten
geweissen	VB	1	gewiß
Darübern	RB	1	Darüber
Setz	NN	1	Setz
Töte	NN	1	Töte
süsses	NN	1	süßes
ausser	RP	1	außer
klingen	VB	1	klingt
Rechts	NN	1	Rechts
Verhungern	NN	1	Verhungern
garstgen	NN	1	garstgen
abzugehen	VB	1	abzugehen
vermuten	VB	1	vermuten
unverzeihlich	JJ	1	unverzeihlich
verschlissen	NN	1	verschlissen
Christlichste	NN	1	Christlichste
Bewusstsein	NN	1	Bewußtsein
rauhen	NN	1	rauhen
christlichem	NN	1	christlichem
Transport	NN	1	Transport
Saumti	JJ	1	Saumtier
glaublicher	NN	1	glaublicher
wahrscheinlich	JJ	1	wahrscheinlich
Uralte	NN	1	Uralte
nisten	NN	1	nisten
Schiehen	VB	1	Geschieht
hergeschickt	NN	1	hergeschickt
Stirne	NN	1	Stirne
tolerante	NN	1	tolerante
Lassts	NN	1	Laßts
Kält	NN	1	Kält
Besitzt	NN	1	Besitzt
glaublichen	JJ	1	glaubliche
ungleich	JJ	1	ungleich
Kostbares	NN	1	Kostbares
Erkenntlichkeit	NN	1	Erkenntlichkeit
Entdeckung	NN	1	Entdeckung
werdt	NNP	1	werdt
Wart	NNP	1	Wart
Wars	NN	1	Wars
Dürft	NN	1	Dürft
zweimal	RB	1	zweimal
überflüssig	JJ	1	überflüssig
Schien	NN	1	Schien
Bemerkte	NN	1	Bemerkte
geteilt	NN	1	geteilt
Beschwören	NNP	1	Beschwören
errötest	NN	1	errötest
wenigem	NN	1	wenigem
unterscheidet	NN	1	unterscheidet
Nächst	JJ	1	Nächster
getrau	NN	1	getrau
Bunde	NN	1	Bunde
gebettelt	NN	1	gebettelt
vertrau	NN	1	vertrau
Stoffen	NN	1	Stoffen
freu	NN	1	freu
Betret	NNP	1	Betret
Gezürnt	NN	1	Gezürnt
Dankbarkeit	NN	1	Dankbarkeit
Farb	NN	1	Farb
vorbereiten	VB	1	vorbereiten
lüstern	JJ	1	lüstern
Hofen	VB	1	Hofe
richten	VB	1	richten
begleite	NN	1	begleite
Seiner	PRP$	1	Seiner
Seines	PRP$	1	Seines
Ihmen	VBN	1	Ihm
grade	NN	1	grade
Richtig	JJ	1	Richtig
sandt	NNP	1	sandt
zankt	NN	1	zankt
fern	JJ	1	fern
Aushöhlen	NN	1	Aushöhlen
Gesandte	NN	1	Gesandte
gefährlich	JJ	1	gefährlich
Versteht	VB	1	Versteht
bürget	NN	1	bürget
raten	VB	1	raten
mindsten	NN	1	mindsten
ratet	NN	1	ratet
Errätst	NN	1	Errätst
verflossenen	NN	1	verflossenen
bürgen	VBN	1	bürgt
Woher	NN	1	Woher
Hör	NN	1	Hör
wussen	VB	1	wußte
weinst	NN	1	weinst
naht	NN	1	naht
bescheidne	NN	1	bescheidne
wähnen	VB	1	wähnen
flüchten	VB	1	geflüchtet
Such	NN	1	Such
gestrenger	JJ	1	gestrenger
vielem	NN	1	vielem
Sonderlings	NN	1	Sonderlings
Lüge	NN	1	Lüge
Geschützt	NN	1	Geschützt
klebt	NN	1	klebt
verraten	VB	1	verraten
windet	NN	1	windet
Feier	NN	1	Feier
herüber	IN	1	herüber
tret	NN	1	tret
Apostasie	NN	1	Apostasie
Gebaut	NN	1	Gebaut
durchaus	RB	1	durchaus
Strafe	NN	1	Strafe
Abraham	NNP	1	Abraham
Entdeckt	NN	1	Entdeckt
arabisch	JJ	1	arabisch
vorüber	NN	1	vorüber
Reisst	RB	1	Reißt
Geblüte	NN	1	Geblüte
entschuldigen	VB	1	entschuldigen
laden	VB	1	laden
horcht	NN	1	horcht
bleib	NN	1	bleib
Eins	NN	1	Eins
gestehn	NN	1	gestehn
Sofort	NN	1	Sofort
besuchen	VB	1	besuchen
ladet	NN	1	ladet
Vollkommen	NN	1	Vollkommen
ergiessend	JJ	1	ergießend
Brauch	NN	1	Brauch
einzge	NN	1	einzge
gegriffnen	NN	1	gegriffnen
Verklagen	VB	1	Verklagten
geizig	JJ	1	geizig
verzettelt	JJ	1	verzettelt
verwebt	NN	1	verwebt
Schnell	NNP	1	Schnell
eingeplaudert	NNP	1	eingeplaudert
dahinter	RB	1	dahinter
Heuchlerin	NN	1	Heuchlerin
Liess	NN	1	Ließ
Sinns	NN	1	Sinns
Zipfel	NN	1	Zipfel
Behutsam	JJ	1	Behutsam
Menschlichkeit	NN	1	Menschlichkeit
singen	VBN	1	gesungen
verstopft	NN	1	verstopft
Weile	NN	1	Weile
Gurt	NN	1	Gurt
Begleitet	NN	1	Begleitet
Andächtig	IN	1	Andächtig
Weils	NN	1	Weils
tiefgeprägte	NN	1	tiefgeprägte
Gimpel	NN	1	Gimpel
Zurück	NN	1	Zurück
fehl	NN	1	fehl
födert	NN	1	födert
mengen	VB	1	mengt
Asch	NN	1	Asch
Deucht	NN	1	Deucht
Ohrgehenke	NN	1	Ohrgehenke
Knie	NN	1	Knie
kurzen	NN	1	kurzen
Satz	NN	1	Satz
zurückgekommen	NN	1	zurückgekommen
Possen	NN	1	Possen
Fuchse	NN	1	Fuchse
hinab	NN	1	hinab
umkehrt	NN	1	umkehrt
lauscht	NN	1	lauscht
Knochen	NN	1	Knochen
ermessen	NN	1	ermessen
Wartung	NN	1	Wartung
Ehen	VB	1	Eh
saur	JJ	1	saurer
klügeln	NN	1	klügeln
eingebornen	NN	1	eingebornen
Transports	NN	1	Transports
sinken	VB	1	sinken
Filze	NN	1	Filze
Christentume	NN	1	Christentume
Beleidigte	NN	1	Beleidigte
Gewandtheit	NN	1	Gewandtheit
schwach	JJ	1	schwach
rund	RB	1	rund
Konnts	NN	1	Konnts
Dacht	NN	1	Dacht
blindlings	RB	1	blindlings
schreibet	NN	1	schreibet
raubt	NN	1	raubt
zahlen	VB	1	zahlt
untersteh	NN	1	untersteh
graute	NN	1	graute
Zuweilen	NN	1	Zuweilen
unschätzbarem	PRP$	1	unschätzbarem
machst	WRB	1	machst
Heiland	NN	1	Heiland
auszubitten	NN	1	auszubitten
wiederkomme	NN	1	wiederkomme
schick	JJ	1	schick
fürchtet	NN	1	fürchtet
jüngern	NN	1	jüngern
verlauten	VB	1	verlauten
Vorn	NN	1	Vorn
Ruf	NN	1	Ruf
bekannt	JJ	1	bekannt
Nimmt	NN	1	Nimmt
beschleuniget	NN	1	beschleuniget
gelänge	NN	1	gelänge
bied	JJ	1	bieder
schenkst	NN	1	schenkst
empfangnen	NN	1	empfangnen
Mittags	NN	1	Mittags
dankt	VB	1	dankte
brausend	JJ	1	brausend
genauer	RB	1	genauer
Geschenk	NN	1	Geschenk
Auferstandnen	NN	1	Auferstandnen
Gesammelt	NN	1	Gesammelt
Weissem	NN	1	Weißem
Brust	NN	1	Brust
zweitenmal	RB	1	zweitenmal
einverstand	JJ	1	einverstanden
verlange	NN	1	verlange
zweifelhaften	NN	1	zweifelhaften
versprich	NN	1	versprich
Brechen	VB	1	Brach
Wendung	NN	1	Wendung
stiehlt	NN	1	stiehlt
Geheiss	NN	1	Geheiß
Spiels	NN	1	Spiels
erfüllen	VB	1	erfüllten
Arabisch	NN	1	Arabisch
drückts	NN	1	drückts
edle	NN	1	edle
Majestät	NN	1	Majestät
Dankes	NN	1	Dankes
schwächsten	NN	1	schwächsten
Unglücklichen	JJ	1	Unglückliche
Platze	NN	1	Platze
erleben	VB	1	erleben
Regen	NN	1	Regen
schicktet	NN	1	schicktet
Wunders	NN	1	Wunders
Aberwitz	NN	1	Aberwitz
abgebrannt	NN	1	abgebrannt
Plötzlich	JJ	1	Plötzlich
zeigt	VB	1	zeigt
betrifft	VB	1	betrifft
Puls	NN	1	Puls
Unglaublichers	NN	1	Unglaublichers
Gefunden	NN	1	Gefunden
Fetze	NN	1	Fetze
Versucher	NN	1	Versucher
Lustig	RB	1	Lustig
sparts	NN	1	sparts
nachgewirkt	NN	1	nachgewirkt
Trank	NN	1	Trank
ungefälligst	JJ	1	ungefälligsten
nennens	NN	1	nennens
sendet	PRP$	1	sendet
Kleinigkeiten	NN	1	Kleinigkeiten
fürs	NN	1	fürs
Versichrung	NN	1	Versichrung
Argwohnen	NN	1	Argwohnen
entfliehen	VB	1	entfliehen
Erzürnt	NN	1	Erzürnt
Vorurteil	NNS	1	Vorurteile
Nebenzimmer	NN	1	Nebenzimmer
Schutzengel	NN	1	Schutzengel
Schachbrett	NN	1	Schachbrett
Sterben	NN	1	Sterben
Verträglichkeit	NN	1	Verträglichkeit
rühren	VBN	1	gerührt
säh	PRP$	1	säh
Ohm	NN	1	Ohm
gewöhnen	VB	1	gewöhnen
geliebtesten	NN	1	geliebtesten
eilet	NN	1	eilet
verharren	NN	1	verharren
Nam	JJ	1	Nam
Begreifst	NN	1	Begreifst
pfäffisch	JJ	1	pfäffisch
unbedeckt	NN	1	unbedeckt
innigster	NN	1	innigster
traun	NN	1	traun
freuet	NN	1	freuet
vergeb	NNP	1	vergeb
brenne	NN	1	brenne
nachgedacht	NN	1	nachgedacht
Wünsche	NN	1	Wünsche
aussen	RB	1	außen
Dolch	NN	1	Dolch
Verschwand	NN	1	Verschwand
untergräbst	NN	1	untergräbst
Vorwurfs	NN	1	Vorwurfs
brennt	NN	1	brennt
wurmisch	JJ	1	wurmisch
Wünscht	NN	1	Wünscht
Gerechnet	NN	1	Gerechnet
Erliegen	VB	1	Erliegt
Opal	NN	1	Opal
gerechnet	JJ	1	gerechnet
siebenfache	NN	1	siebenfache
ähneln	VB	1	ähneln
neubegieriger	NNP	1	neubegieriger
verlorner	NN	1	verlorner
äussern	VB	1	äußern
scheu	JJ	1	scheu
ohnehin	RB	1	ohnehin
Strumpf	NN	1	Strumpf
ähnelt	NN	1	ähnelt
weichen	PRP$	1	weichen
annochen	RB	1	annoch
anzugehnen	VB	1	anzugehn
Narren	NN	1	Narren
verlernt	NN	1	verlernt
Gleichsam	JJ	1	Gleichsam
wankenden	NN	1	wankenden
Mangel	NN	1	Mangel
angekommen	NN	1	angekommen
prallen	NN	1	prallen
trugt	JJ	1	trugt
entlockt	NN	1	entlockt
belegen	VB	1	belegen
ausgeliefert	NN	1	ausgeliefert
just	JJ	1	just
Streit	NN	1	Streit
setze	NN	1	setze
graden	NN	1	graden
Handwerk	NN	1	Handwerk
Gärtner	NN	1	Gärtner
brennen	VB	1	brennen
wüsst	NN	1	wüßt
entschliess	NN	1	entschließ
Flamme	NN	1	Flamme
Garaus	NN	1	Garaus
Schachgesell	NN	1	Schachgesell
weisr	JJ	1	weisrer
gerechtet	NN	1	gerechtet
besehn	NN	1	besehn
sagtet	NN	1	sagtet
Blicks	NN	1	Blicks
gierig	JJ	1	gierig
Verwandte	NN	1	Verwandte
hochbeladenen	NN	1	hochbeladenen
Sidon	NN	1	Sidon
umgesehn	NN	1	umgesehn
Blutbegier	NN	1	Blutbegier
Versprochne	NN	1	Versprochne
unten	RB	1	unten
Geier	NN	1	Geier
Kohle	NNS	1	Kohlen
Zuversicht	NN	1	Zuversicht
erstenmale	NN	1	erstenmale
Gärung	NN	1	Gärung
gnügen	VB	1	gnügt
darausen	RB	1	daraus
schirmen	NN	1	schirmen
undankbaren	NN	1	undankbaren
beneidet	NN	1	beneidet
Bedenklich	JJ	1	Bedenklich
Geschmeide	NN	1	Geschmeide
Putz	NN	1	Putz
Freuden	NN	1	Freuden
verschossen	NN	1	verschossen
kannen	VB	1	kannt
borg	NNP	1	borg
verwünschte	NN	1	verwünschte
wirft	VB	1	wirft
Geführt	NN	1	Geführt
erhört	NN	1	erhört
Bäumen	NN	1	Bäumen
Kahira	NN	1	Kahira
ums	IN	1	ums
dehnen	VB	1	dehnen
sinnreich	NN	1	sinnreich
grauen	PRP$	1	grauen
wachend	JJ	1	wachend
Leu	NN	1	Leu
mehrern	VB	1	mehrere
zeihen	VB	1	zieh
Ziele	NN	1	Ziele
Verschwenden	NN	1	Verschwenden
hundertmal	RB	1	hundertmal
aufbehalten	NN	1	aufbehalten
bricht	NN	1	bricht
hineingestossen	NN	1	hineingestoßen
Jericho	RP	1	Jericho
zogs	NN	1	zogs
nahte	NN	1	nahte
vertraulich	JJ	1	vertraulicher
entwöhnen	NN	1	entwöhnen
Euphrat	NN	1	Euphrat
Einerlei	NN	1	Einerlei
Grad	NN	1	Grad
Nerve	NN	1	Nerve
besoldet	NN	1	besoldet
auszuspüren	NN	1	auszuspüren
Eigennützigste	NN	1	Eigennützigste
Erborgen	NN	1	Erborgen
aufgesucht	NN	1	aufgesucht
drückt	VB	1	drückte
Christendirne	NN	1	Christendirne
abgemessen	NN	1	abgemessen
obs	NN	1	obs
erkenn	NN	1	erkenn
Treibt	NN	1	Treibt
woran	WP	1	woran
Allwo	NN	1	Allwo
sinnt	NN	1	sinnt
Oheim	NN	1	Oheim
Schwärmer	NN	1	Schwärmer
mocht	NN	1	mocht
dürfte	VB	1	dürfte
vermählt	NN	1	vermählt
rätselhaften	NN	1	rätselhaften
tragend	JJ	1	tragend
Geschadet	NN	1	Geschadet
leerer	NN	1	leerer
verbittet	NN	1	verbittet
Hältst	NN	1	Hältst
wag	NN	1	wag
verhält	NN	1	verhält
trüge	NN	1	trüge
geschieht	RB	1	geschieht
unters	NN	1	unters
unterliegen	VB	1	unterliegt
Verbindlichkeit	NN	1	Verbindlichkeit
verbitten	NN	1	verbitten
Kosten	NN	1	Kosten
vorgelogen	NN	1	vorgelogen
Wärt	NN	1	Wärt
zählen	VB	1	zählen
liesse	NN	1	ließe
unentbehrlich	JJ	1	unentbehrlich
Nagel	NN	1	Nagel
erfahr	NN	1	erfahr
Zerstreuung	NN	1	Zerstreuung
Besitzer	NN	1	Besitzer
Freudigkeit	NN	1	Freudigkeit
Gesucht	NN	1	Gesucht
Bauer	NN	1	Bauer
ausgeworfen	NN	1	ausgeworfen
woher	RP	1	woher
Weges	NN	1	Weges
Kräfte	NN	1	Kräfte
Voll	JJ	1	Voll
vertrautes	NN	1	vertrautes
Hiernächst	NN	1	Hiernächst
Verdirb	NN	1	Verdirb
Sklav	NN	1	Sklav
Stück	NN	1	Stück
schlauen	NN	1	schlauen
prüfen	VB	1	prüfen
Feldzug	NN	1	Feldzug
sträuben	VB	1	sträubt
erscheinen	VB	1	erscheinen
unwert	NN	1	unwert
nochmalsen	RP	1	nochmals
Dergleichen	RB	1	Dergleichen
selgen	NN	1	selgen
angst	RP	1	angst
einmalten	VB	1	einmal
Willst	WRB	1	Willst
bekehren	VB	1	bekehren
feierlich	JJ	1	feierlich
Neuste	NN	1	Neuste
niedrig	JJ	1	niedriger
Betaur	JJ	1	Betaur
morgens	IN	1	morgens
Falle	NN	1	Falle
stutzen	VB	1	stutzen
entlassen	VB	1	entlassen
Geärgert	NN	1	Geärgert
Weiberkopf	NN	1	Weiberkopf
enträtsln	RB	1	enträtsle
vollziehn	NN	1	vollziehn
bestehn	NN	1	bestehn
Künste	NN	1	Künste
geschwebt	VB	1	geschwebt
Waisen	NN	1	Waisen
Aufrichtig	RP	1	Aufrichtig
beschrieben	NN	1	beschrieben
scharf	JJ	1	scharfen
ersetzen	VB	1	ersetzen
drumen	RP	1	drum
Davonen	RB	1	Davon
angeraten	NN	1	angeraten
Gütern	NN	1	Gütern
dicht	JJ	1	dicht
gesät	NN	1	gesät
Baum	NN	1	Baum
gröss	JJ	1	größer
leidet	NN	1	leidet
knickerte	NN	1	knickerte
seitwärts	NN	1	seitwärts
emsig	JJ	1	emsig
Verlieren	NN	1	Verlieren
sollts	NN	1	sollts
setzt	VB	1	setzt
Brett	NN	1	Brett
Gewonnen	NN	1	Gewonnen
hierzu	NN	1	hierzu
lächelnd	NN	1	lächelnd
Getrieben	NN	1	Getrieben
Kluge	NN	1	Kluge
Bär	NN	1	Bär
Hinauf	NNP	1	Hinauf
Vornehmlich	JJ	1	Vornehmlich
Burg	NN	1	Burg
entdecke	NN	1	entdecke
Angehörigen	NN	1	Angehörigen
schweige	NN	1	schweige
Adern	NN	1	Adern
deswegen	RB	1	deswegen
Gepriesner	NN	1	Gepriesner
weils	NN	1	weils
Gassen	NN	1	Gassen
Gegeben	NN	1	Gegeben
spielte	NN	1	spielte
stiften	VBN	1	gestiftet
Erlogen	NN	1	Erlogen
Wen	NN	1	Wen
belohn	NN	1	belohn
fahr	NN	1	fahr
Stufen	NN	1	Stufen
wenns	NN	1	wenns
entreisst	NN	1	entreißt
Schwerte	NN	1	Schwerte
faulen	NN	1	faulen
Ehrlichkeit	NN	1	Ehrlichkeit
Ergiessung	NN	1	Ergießung
offner	NN	1	offner
liesset	NN	1	ließet
Nächt	NN	1	Nächt
Gebe	NN	1	Gebe
fasset	NN	1	fasset
Grabe	NN	1	Grabe
Antlitz	NN	1	Antlitz
wähnt	VB	1	wähnt
mächtiger	NNP	1	mächtiger
mächtiges	NN	1	mächtiges
Gebiete	NN	1	Gebiete
Buchgelehrsamkeit	NN	1	Buchgelehrsamkeit
tröstender	NN	1	tröstender
Kindes-Kindeskindern	NN	1	Kindes-Kindeskindern
Bonafides	NN	1	Bonafides
Vermögen	NN	1	Vermögen
Brauchts	NN	1	Brauchts
Pfiffigkeit	NN	1	Pfiffigkeit
schrecklich	JJ	1	schrecklich
besetzen	VB	1	besetzt
Teilen	VBN	1	Teile
unmild	NN	1	unmild
wiederholen	VB	1	wiederholen
Morgen	NN	1	Morgen
Tempelritter	NN	1	Tempelritter
Pfaffen	NN	1	Pfaffen
Form	NN	1	Form
Zufall	NN	1	Zufall
einzigen	VB	1	einzige
Tauf	NN	1	Tauf
Sittahs	NN	1	Sittahs
vermieden	NN	1	vermieden
gefang	JJ	1	gefangen
erdulden	NN	1	erdulden
Stempel	NN	1	Stempel
harret	NN	1	harret
grössen	VB	1	größte
meld	NN	1	meld
Krallen	NN	1	Krallen
geheimnisvoll	JJ	1	geheimnisvoll
Erwerben	NN	1	Erwerben
Bot	NN	1	Bot
süss	JJ	1	süß
losgehen	VB	1	losgeht
unweit	IN	1	unweit
Briefch	JJ	1	Briefchen
Schlechte	NN	1	Schlechte
funden	VBN	1	funden
Denkender	NN	1	Denkender
begnadet	NN	1	begnadet
kanns	NN	1	kanns
Verlanget	NN	1	Verlanget
Gram	NN	1	Gram
verändern	VB	1	verändert
gepflanzt	NN	1	gepflanzt
hinüber	RP	1	hinüber
Verfallnen	JJ	1	Verfallnen
gewinnt	NN	1	gewinnt
aufhör	NN	1	aufhör
Bildet	NN	1	Bildet
ausgegattert	NN	1	ausgegattert
zusammenhängen	VB	1	zusammenhängt
reget	NN	1	reget
mischen	VB	1	mischen
neubegierig	JJ	1	neubegierig
Lehrern	JJ	1	Lehrern
andr	JJ	1	andrer
worüber	RB	1	worüber
Herum	NN	1	Herum
würdiget	NN	1	würdiget
ergiebiger	NNP	1	ergiebiger
würdiger	NNP	1	würdiger
Vorfahr	NN	1	Vorfahr
Begleiten	NN	1	Begleiten
Fürwahr	NN	1	Fürwahr
Gewährt	NN	1	Gewährt
Hülf	NN	1	Hülf
gestern	RB	1	gestern
wallen	NN	1	wallen
unmöglich	JJ	1	unmöglich
Vetter	NN	1	Vetter
gelingt	VB	1	gelingt
Fremden	NN	1	Fremden
Abulkassem	NN	1	Abulkassem
Gleichviel	NN	1	Gleichviel
Schafpelz	NN	1	Schafpelz
ängstlich	JJ	1	ängstlich
Kaufmann	NN	1	Kaufmann
Wassereimer	NN	1	Wassereimer
lockt	NN	1	lockt
gerungn	NN	1	gerungnen
schrecken	VB	1	schrecken
Entlasst	NN	1	Entlaßt
sauersüssem	NN	1	sauersüßem
Einsamkeit	NN	1	Einsamkeit
atmet	JJ	1	atmet
befremdet	NN	1	befremdet
lediglichen	RP	1	lediglich
machtet	NN	1	machtet
kocht	NN	1	kocht
Gerührt	NN	1	Gerührt
Junge	NN	1	Junge
Göttlichen	VB	1	Göttlichen
geziemte	NN	1	geziemte
vorzugreifen	VB	1	vorzugreifen
Rückhalt	NN	1	Rückhalt
zerbricht	NN	1	zerbricht
gründen	VB	1	gründen
namentlich	JJ	1	namentlich
Geblüt	NN	1	Geblüt
säume	NN	1	säume
Geschickter	NN	1	Geschickter
fortgehn	NN	1	fortgehn
Vermöge	NN	1	Vermöge
verborgen	VB	1	verborgen
dumm	JJ	1	dumme
Drängen	VB	1	Drängt
such	NN	1	such
vorenthalten	NN	1	vorenthalten
Spart	NNP	1	Spart
neueren	JJ	1	neuer
Stosst	NN	1	Stoßt
schlägst	NN	1	schlägst
Bst	RB	1	Bst
innern	VB	1	innern
Empfang	NN	1	Empfang
Verzeihe	NN	1	Verzeihe
Wartet	NN	1	Wartet
Thebais	NN	1	Thebais
Druck	NN	1	Druck
weissem	NN	1	weißem
Beschreib	VB	1	Beschreiben
Erzähl	NN	1	Erzähl
küsst	NN	1	küßt
Innersten	NN	1	Innersten
Tribut	NN	1	Tribut
Falt	NN	1	Falt
trage	NN	1	trage
Fahret	NN	1	Fahret
doppeltes	NN	1	doppeltes
Larve	NN	1	Larve
entbehren	VB	1	entbehren
entscheiden	VB	1	entscheiden
Bestand	NN	1	Bestand
Häuser	NN	1	Häuser
gebracht	JJ	1	gebracht
wohinen	RB	1	wohin
Geistlichen	VB	1	Geistlichen
überkoch	VB	1	überkochen
unterrichtet	NN	1	unterrichtet
quält	NN	1	quält
itzo	NN	1	itzo
bunt	JJ	1	bunten
versunknen	NN	1	versunknen
durchschlängeln	NN	1	durchschlängeln
Schwäch	NN	1	Schwäche
Schweizern	VB	1	Schweizer
beih	DT	1	beiher
nahten	NN	1	nahten
Erkläre	NN	1	Erkläre
halb	CD	1	halb
verliess	NN	1	verließ
Nähern	JJ	1	Näher
Innern	NN	1	Innern
Schlimmer	NN	1	Schlimmer
vorgespreiztem	NN	1	vorgespreiztem
Stärk	NN	1	Stärk
Sag	NN	1	Sag
Erteilet	NN	1	Erteilet
Milz	NN	1	Milz
Nuss	NN	1	Nuß
stolze	NN	1	stolze
Feu	NN	1	Feuer
Lecker	NN	1	Lecker
drob	NN	1	drob
besorglich	VB	1	besorglichen
Parsi	NNP	1	Parsi
bedienen	VB	1	bedienen
Verstosst	NN	1	Verstoßt
entschossen	NN	1	entschossen
Vorhang	NN	1	Vorhang
Zuckung	NN	1	Zuckung
Beruf	JJ	1	Beruf
Wucher	NN	1	Wucher
Morgens	NN	1	Morgens
Ordnung	NN	1	Ordnung
spür	NN	1	spür
Verlorst	NN	1	Verlorst
Verräter	NN	1	Verräter
Spezereien	NN	1	Spezereien
Sachen	NN	1	Sachen
tadeln	VB	1	tadeln
gewissern	VB	1	gewisser
Theater	NN	1	Theater
Magst	NN	1	Magst
schri	VB	1	schrie
Kaiserlich	JJ	1	Kaiserlichen
Schmeichler	NN	1	Schmeichler
Stand	NN	1	Stand
Rinde	JJ	1	Rinde
Bösen	NN	1	Bösen
Hafis	NN	1	Hafis
wandle	NN	1	wandle
Fuss	NN	1	Fuß
dürf	NN	1	dürf
Abenteuer	NN	1	Abenteuer
desgleichen	JJ	1	desgleichen
Würd	NNP	1	Würd
Schlug	NN	1	Schlug
ausgepackt	NN	1	ausgepackt
siehst	NN	1	siehst
schweift	NN	1	schweift
Stricke	NN	1	Stricke
unternehmet	NN	1	unternehmet
hilft	VB	1	hilft
widerspricht	NN	1	widerspricht
Entgegen	IN	1	Entgegen
wirds	NN	1	wirds
Eurigen	NN	1	Eurigen
Anstalt	NN	1	Anstalt
Pöbels	NN	1	Pöbels
Standes	NN	1	Standes
Trocknen	NN	1	Trocknen
Kanäle	NN	1	Kanäle
Pfort	NN	1	Pfort
Entwürf	JJ	1	Entwürfe
behalten	VB	1	behält
geizigen	NN	1	geizigen
entblösst	NN	1	entblößt
zürn	JJ	1	zürn
Glaubenshelden	NN	1	Glaubenshelden
verflattern	NN	1	verflattern
Hingehn	NN	1	Hingehn
Flügeln	NN	1	Flügeln
dachtet	RB	1	dachtet
Stammbaum	NN	1	Stammbaum
Post	NN	1	Post
gefund	VBN	1	gefunden
Sparung	NN	1	Sparung
erblasse	NNP	1	erblasse
stolzen	NN	1	stolzen
unterlassen	VB	1	unterlassen
schlängeln	VB	1	schlängeln
scheuchte	NN	1	scheuchte
unrein	NN	1	unrein
gesprächiger	NNP	1	gesprächiger
besondr	JJ	1	besondre
holdes	NN	1	holdes
wers	NN	1	wers
bauen	VBN	1	gebaut
Erweislich	JJ	1	Erweislich
verwirrt	JJ	1	verwirrt
einzeln	JJ	1	einzeln
schärfen	VB	1	schärft
geht	VB	1	geht
nachgegeben	NN	1	nachgegeben
ermordet	NN	1	ermordet
stärk	JJ	1	stärker
Sait	NN	1	Sait
pro	IN	1	pro
spenden	VB	1	spenden
ausgeweinet	NNP	1	ausgeweinet
Beinah	NN	1	Beinah
vertrauet	NN	1	vertrauet
gehe	NN	1	gehe
ausschlug	NN	1	ausschlug
abzulohn	VBN	1	abzulohnen
Gelesen	NN	1	Gelesen
sprach	NN	1	sprach
betrög	NN	1	betrög
wachse	NN	1	wachse
beizukomm	DT	1	beizukommen
Kern	NN	1	Kern
beschön	NN	1	beschönen
leiht	NN	1	leiht
stracks	NN	1	stracks
wartst	NN	1	wartst
gewirkt	NN	1	gewirkt
Hätts	NN	1	Hätts
entkömmst	NN	1	entkömmst
hingeworfen	NN	1	hingeworfen
Naschwerk	NN	1	Naschwerk
berg	VB	1	bergen
Hochehrwürden	NN	1	Hochehrwürden
Gipfelchen	NN	1	Gipfelchen
Wochen	NN	1	Wochen
Tulban	NN	1	Tulban
Stillstands	NN	1	Stillstands
bezaubert	NN	1	bezaubert
Tretet	NN	1	Tretet
höhern	NN	1	höhern
Setzt	NN	1	Setzt
befand	NN	1	befand
gewann	NN	1	gewann
abzuwägen	VB	1	abzuwägen
Kenn	NN	1	Kenn
vermache	NN	1	vermache
laben	NN	1	laben
Wes	NN	1	Wes
ausüben	VBN	1	ausgeübt
Gath	NN	1	Gath
eingeleuchtet	NN	1	eingeleuchtet
Bezeichnen	NN	1	Bezeichnen
daselbst	RB	1	daselbst
Heiliger	VB	1	Heiliger
schassen	VB	1	schießt
dazuen	VB	1	dazu
bekümmert	NN	1	bekümmert
nunmehr	RB	1	nunmehr
Lektion	NN	1	Lektion
erleichtern	VB	1	erleichtern
Verwehen	VB	1	Verweht
Alters	NN	1	Alters
Silberstoff	NN	1	Silberstoff
Darunter	RB	1	Darunter
auszuschlagen	NN	1	auszuschlagen
bittern	JJ	1	bittern
edeln	NN	1	edeln
Erbarmte	NN	1	Erbarmte
süsse	NN	1	süße
Beteuern	NN	1	Beteuern
gen	IN	1	gen
wiederfodert	NN	1	wiederfodert
mindern	NN	1	mindern
schwer	JJ	1	schwerer
Kindesstatt	NN	1	Kindesstatt
Fragst	NN	1	Fragst
rauscht	NN	1	rauscht
sagest	RB	1	sagest
wiederfodern	NN	1	wiederfodern
Sünd	NN	1	Sünd
Weigerung	NNS	1	Weigerungen
Kundschafterei	NN	1	Kundschafterei
Gesehn	NN	1	Gesehn
brennts	NN	1	brennts
behutsam	JJ	1	behutsam
erkundigen	VB	1	erkundigen
vertrauter	NN	1	vertrauter
vorhabt	NN	1	vorhabt
frommte	NN	1	frommte
vermeinte	NN	1	vermeinte
schreien	VB	1	schreit
Frucht	NN	1	Frucht
dachte	RB	1	dachte
Ehrenkleid	NN	1	Ehrenkleid
lässest	NN	1	lässest
Bewundern	NN	1	Bewundern
vorgetragne	NN	1	vorgetragne
worunter	WRB	1	worunter
denselb	WDT	1	denselben
entkam	JJ	1	entkam
übereilen	NN	1	übereilen
Frommen	NN	1	Frommen
Anspruch	NN	1	Anspruch
versichert	NN	1	versichert
Begnadigen	VBN	1	Begnadigt
Tapferkeit	NN	1	Tapferkeit
auferziehen	NN	1	auferziehen
tue	NN	1	tue
Erlauben	NN	1	Erlauben
mans	NN	1	mans
Dinar	NN	1	Dinar
eröffnen	VB	1	eröffne
wach	JJ	1	wachen
Wofür	NN	1	Wofür
Wehen	NN	1	Wehen
Partei	NN	1	Partei
Samen	NN	1	Samen
Sprach	NN	1	Sprach
erweichen	VB	1	erweichen
Glücks	NN	1	Glücks
vertraue	NN	1	vertraue
unhold	NN	1	unhold
Wirbel	NN	1	Wirbel
gespannt	NN	1	gespannt
Verspracht	NN	1	Verspracht
scherzt	NN	1	scherzt
Befunden	NN	1	Befunden
Darum	RB	1	Darum
Eremit	NN	1	Eremit
Armut	NN	1	Armut
Frevels	NN	1	Frevels
Kreatur	NN	1	Kreatur
Stärkste	NN	1	Stärkste
kümmert	NN	1	kümmert
Christenkinder	NN	1	Christenkinder
Bug	NN	1	Bug
überdenke	NN	1	überdenke
Beliebt	NN	1	Beliebt
Bedürf	NN	1	Bedürf
Warnen	NN	1	Warnen
trockene	NN	1	trockene
ungeheuern	NN	1	ungeheuern
Haram	JJ	1	Haram
Ordens	NN	1	Ordens
Sogar	NNP	1	Sogar
geiziger	NNP	1	geiziger
hernach	NN	1	hernach
Ferne	NN	1	Ferne
herum	IN	1	herum
grösserm	NN	1	größerm
winkt	VB	1	winkt
Beständig	JJ	1	Beständig
eig	JJ	1	eigen
Vergisst	NN	1	Vergißt
glaubt	JJ	1	glaubt
kniet	NN	1	kniet
ergriff	NN	1	ergriff
Busse	NN	1	Buße
Bestes	NN	1	Bestes
achtzehn	CD	1	achtzehn
Herrlichkeit	NN	1	Herrlichkeit
floh	NN	1	floh
Unwürdig	JJ	1	Unwürdig
besitze	NN	1	besitze
Richters	NN	1	Richters
Deinen	NN	1	Deinen
anzuhalten	VB	1	anzuhalten
Plane	NN	1	Plane
Grösse	NN	1	Größe
spätre	NN	1	spätre
besitzt	NN	1	besitzt
mustert	NN	1	mustert
Fluge	NN	1	Fluge
Wusst	NN	1	Wußt
beklemmt	NN	1	beklemmt
ausgesucht	NN	1	ausgesucht
würdger	NN	1	würdger
Sklaven	NN	1	Sklaven
enthalten	VB	1	enthalten
Soldat	NN	1	Soldat
geniessen	VB	1	genossen
Edelmut	NN	1	Edelmut
seufzen	VB	1	seufzen
Geschichtch	VB	1	Geschichtchen
Gesteckt	NN	1	Gesteckt
fühl	NN	1	fühl
Schwärmern	NN	1	Schwärmern
Muselmanne	NN	1	Muselmanne
Busen	NN	1	Busen
Verfahren	NN	1	Verfahren
Ankunft	NN	1	Ankunft
Wüsst	NN	1	Wüßt
nähmst	NN	1	nähmst
keimt	NN	1	keimt
Menschenmäkelei	NN	1	Menschenmäkelei
Stillestand	NN	1	Stillestand
eingetrieben	NN	1	eingetrieben
Kapitulation	NN	1	Kapitulation
Seufzen	NN	1	Seufzen
geziemt	NN	1	geziemt
Erzöge	NN	1	Erzöge
Selbsteigner	NN	1	Selbsteigner
damals	IN	1	damals
erschallt	NN	1	erschallt
martre	NN	1	martre
Erwünschte	NN	1	Erwünschte
bereden	NN	1	bereden
Verkenn	NN	1	Verkenn
Stuhl	NN	1	Stuhl
gewölbt	NN	1	gewölbt
bemüh	NN	1	bemüh
schickt	NN	1	schickt
Bedient	NN	1	Bedient
Erkundete	NN	1	Erkundete
unverrückt	NN	1	unverrückt
vorgeschossen	NN	1	vorgeschossen
verfehlt	NN	1	verfehlt
Nennt	NN	1	Nennt
Mag	NN	1	Mag
Weibern	NN	1	Weibern
gnügt	VB	1	gnügt
Geschäfte	NN	1	Geschäfte
verkennt	NN	1	verkennt
Nils	NNP	1	Nils
blutet	NN	1	blutet
Sperre	NN	1	Sperre
unglaublich	JJ	1	unglaublich
Getroffen	NN	1	Getroffen
Ebb	NN	1	Ebb
genügen	VB	1	genügt
Erbittert	NN	1	Erbittert
Erstaunen	NN	1	Erstaunen
Verrichtet	NN	1	Verrichtet
vergelten	VB	1	vergelten
liessen	NNP	1	ließen
Herab	NN	1	Herab
süssern	NN	1	süßern
eingedenk	JJ	1	eingedenk
schlüg	NN	1	schlüg
schonet	NN	1	schonet
versteht	VB	1	versteht
Menschenhass	NN	1	Menschenhaß
gebe	NN	1	gebe
Güt	NN	1	Güt
Waffenstillestandes	NN	1	Waffenstillestandes
erzeigen	VBN	1	erzeigt
Gotteslästerung	NN	1	Gotteslästerung
Führe	NN	1	Führe
Schutz	NNS	1	Schutze
tiefern	VB	1	tiefer
bedenkt	NN	1	bedenkt
bemühen	VB	1	bemüht
Brevier	NN	1	Brevier
hielten	VB	1	hielten
Sprichwort	NN	1	Sprichwort
suche	NN	1	suche
Christentempel	NN	1	Christentempel
vergeben	VBN	1	vergeben
Eurem	NN	1	Eurem
zerriss	JJ	1	zerrissen
Forschers	NN	1	Forschers
Anlass	NN	1	Anlaß
sprudelnd	NN	1	sprudelnd
Ausdrucks	NN	1	Ausdrucks
Schwest	NN	1	Schwester
gutherzgen	NN	1	gutherzgen
rauh	JJ	1	rauh
Spruchesen	VB	1	Spruches
herrschend	JJ	1	herrschenden
entfuhr	NN	1	entfuhr
Überspannt	JJ	1	Überspanntes
nachzugrübeln	NN	1	nachzugrübeln
oh	NN	1	oh
Augenblicks	NN	1	Augenblicks
plauderst	NN	1	plauderst
obbesagte	NN	1	obbesagte
tanze	NN	1	tanze
wurdet	NN	1	wurdet
spornt	NN	1	spornt
Ermuntrung	NN	1	Ermuntrung
Königinnen	NN	1	Königinnen
achte	CD	1	achte
Verlusts	NN	1	Verlusts
Getrost	NN	1	Getrost
dabeien	VB	1	dabei
Taugen	VBN	1	Taugt
Exempel	NN	1	Exempel
beschworen	NN	1	beschworen
empfinden	VB	1	empfinden
verschränkten	NN	1	verschränkten
verbeisst	NN	1	verbeißt
allzuhäufig	JJ	1	allzuhäufig
zürnen	VB	1	zürnen
Erforscht	NN	1	Erforscht
Gefiel	NN	1	Gefiel
Geschwätz	NN	1	Geschwätz
abziehn	NN	1	abziehn
Judentum	NNP	1	Judentum
Muselmannes	NN	1	Muselmannes
täglich	IN	1	täglich
fodern	NN	1	fodern
Feuren	VB	1	Feur
Musst	WRB	1	Mußt
dächten	NN	1	dächten
abgeschreckt	NN	1	abgeschreckt
Kleine	NN	1	Kleine
entkäme	NN	1	entkäme
Vollends	NN	1	Vollends
Unstreitig	JJ	1	Unstreitig
nutzt	NN	1	nutzt
erschrecke	NN	1	erschrecke
Musse	NN	1	Muße
Verlaufen	NN	1	Verlaufen
unvermuteten	NN	1	unvermuteten
belehren	NN	1	belehren
Jamerlonk	NN	1	Jamerlonk
neuesen	VB	1	neues
Kranken	NN	1	Kranken
unerhört	JJ	1	unerhört
vererbte	NNP	1	vererbte
weigerte	NN	1	weigerte
Belohnet	NN	1	Belohnet
Absein	NN	1	Absein
grössre	NN	1	größre
Kriegs	JJ	1	Kriegs
Erfahren	NN	1	Erfahren
hinweg	IN	1	hinweg
Tropfen	NN	1	Tropfen
Würmchen	VB	1	Würmchen
Hof	NN	1	Hof
aufgehalten	NN	1	aufgehalten
Schöne	NN	1	Schöne
vors	NN	1	vors
Hinweg	NN	1	Hinweg
Entzögest	NN	1	Entzögest
vorn	NNP	1	vorn
behüte	NN	1	behüte
Röhren	NN	1	Röhren
Vermögend	JJ	1	Vermögend
erteilen	VB	1	erteilen
Summ	NN	1	Summ
Ehre	NN	1	Ehre
andres	NN	1	andres
ekelt	NN	1	ekelt
straucheln	NN	1	straucheln
schätzen	VB	1	schätzen
hetzt	NN	1	hetzt
schluchzt	NN	1	schluchzte
lästig	JJ	1	lästig
wackern	NN	1	wackern
witzelst	NN	1	witzelst
reichst	JJ	1	reichsten
Meint	NN	1	Meint
Vermählt	NN	1	Vermählt
schleppte	NN	1	schleppte
anzuhören	VB	1	anzuhören
Nimms	NN	1	Nimms
Fernen	NN	1	Fernen
vergib	NN	1	vergib
Ström	NN	1	Ström
Leiden	NN	1	Leiden
beizuspringen	NN	1	beizuspringen
Fesseln	NN	1	Fesseln
Biedermann	NN	1	Biedermann
Schicken	VB	1	Schickt
Stille	NN	1	Stille
missen	NN	1	missen
Vat	JJ	1	Vater
müsste	VB	1	müßte
Herausschmiss	NN	1	Herausschmiß
vorschiessen	JJ	1	vorschießen
Misslaut	NN	1	Mißlaut
empfindlich	JJ	1	empfindlich
bedächtig	JJ	1	bedächtig
Verachtet	NN	1	Verachtet
Mädchenseele	NN	1	Mädchenseele
weckt	NN	1	weckt
siebenjährigem	NN	1	siebenjährigem
schwur	NN	1	schwur
Sobalden	VB	1	Sobald
zugelernte	NN	1	zugelernte
Schlimme	NN	1	Schlimme
Betragens	NN	1	Betragens
Wachens	JJ	1	Wachens
schadt	NNP	1	schadt
faselnd	NN	1	faselnd
nehmts	NN	1	nehmts
fall	NN	1	fall
Sucht	NN	1	Sucht
verstummen	VB	1	verstummen
Prälat	NN	1	Prälat
unbändigsten	NN	1	unbändigsten
Woll	NN	1	Woll
Silber	NN	1	Silber
Verzeihen	VB	1	Verzieht
Söhn	NN	1	Söhn
gewahr	NN	1	gewahr
Ranken	NN	1	Ranken
lauf	NN	1	lauf
heiss	JJ	1	heiß
begnadiget	NN	1	begnadiget
hoffentlich	RB	1	hoffentlich
erschrak	NN	1	erschrak
Schwermut	NN	1	Schwermut
begleiten	RP	1	begleitet
Rücken	NN	1	Rücken
durchzudenken	NN	1	durchzudenken
fördersamst	NN	1	fördersamst
Fäden	JJ	1	Fäden
Verachten	NN	1	Verachten
Zählens	NN	1	Zählens
versengt	RP	1	versengt
aufgelesen	NN	1	aufgelesen
hervor	RP	1	hervor
verschmitzter	NN	1	verschmitzter
Mangels	NN	1	Mangels
Missdeut	NN	1	Mißdeut
vorzutragen	VB	1	vorzutragen
Gefällt	NN	1	Gefällt
Lehrt	NN	1	Lehrt
Aussicht	NN	1	Aussicht
unbesorgen	VB	1	unbesorgt
verstosst	NN	1	verstoßt
warteten	NN	1	warteten
Unendlich	JJ	1	Unendlich
ahndte	NN	1	ahndte
besass	NN	1	besaß
hinaus	IN	1	hinaus
Plunder	NN	1	Plunder
Gabel	NN	1	Gabel
Lehre	NN	1	Lehre
Gemeine	NN	1	Gemeine
grausam	JJ	1	grausam
Gift	NN	1	Gift
allerheiligsten	NN	1	allerheiligsten
hasste	NN	1	haßte
irrte	NN	1	irrte
Briefchens	NN	1	Briefchens
weggestossen	NN	1	weggestoßen
Abglanz	NN	1	Abglanz
betäubt	NN	1	betäubt
plündern	VB	1	plündern
pocht	NN	1	pocht
spartest	NN	1	spartest
glaubs	NN	1	glaubs
Begraben	NN	1	Begraben
tust	NN	1	tust
eilen	VB	1	eilen
wichtger	JJ	1	wichtgere
übern	JJ	1	übern
lenken	VB	1	lenken
Hoffnung	NN	1	Hoffnung
Pfui	NN	1	Pfui
Umher	NN	1	Umher
bessre	JJ	1	beßre
Gesellen	NN	1	Gesellen
fernern	NN	1	fernern
steht	VB	1	steht
Vergeben	NN	1	Vergeben
heilen	VB	1	geheilt
geheissen	NN	1	geheißen
aufzuwiegen	NN	1	aufzuwiegen
Dawider	RB	1	Dawider
gehässig	JJ	1	gehässig
Friedrichs	NN	1	Friedrichs
Schlimmstes	NN	1	Schlimmstes
entrissen	NN	1	entrissen
Block	NN	1	Block
kühn	JJ	1	kühn
erheben	VB	1	erheben
Lässen	VB	1	Läßt
leugnet	NN	1	leugnet
Ebenbild	NN	1	Ebenbild
beschwör	JJ	1	beschwör
Augenblicken	NN	1	Augenblicken
gewogen	NN	1	gewogen
Mass	NN	1	Maß
ledern	NN	1	ledern
taub	JJ	1	taub
besen	VB	1	beste
edel	JJ	1	edel
klagen	RP	1	klagt
malt	NN	1	malt
Gecken	NN	1	Gecken
Laffe	NN	1	Laffe
Erquickung	NN	1	Erquickung
halts	NN	1	halts
gedient	NN	1	gedient
Gefährlich	JJ	1	Gefährlich
reichre	NN	1	reichre
Christeneltern	NN	1	Christeneltern
Ratschluss	NN	1	Ratschluß
frühern	VB	1	frühere
herab	NN	1	herab
gebührt	NN	1	gebührt
anbringen	VBN	1	angebracht
Vogels	NN	1	Vogels
hie	JJ	1	hier
ruf	NN	1	ruf
anzuschlagen	VB	1	anzuschlagen
entreissen	NN	1	entreißen
Genauer	NN	1	Genauer
trösten	VB	1	trösten
geringres	NN	1	geringres
Laun	NN	1	Laun
Blieb	NN	1	Blieb
Bankert	NN	1	Bankert
Kälte	NN	1	Kälte
List	NN	1	List
zehnmal	RB	1	zehnmal
Selbzwanzigster	NN	1	Selbzwanzigster
Et	NN	1	Et
abscheulich	JJ	1	abscheulich
dreimal	RB	1	dreimal
Laut	NN	1	Laut
Kehle	NN	1	Kehle
Europäers	NN	1	Europäers
Schwierigkeiten	NN	1	Schwierigkeiten
Los	NN	1	Los
ausgehalten	NN	1	ausgehalten
Dazwischen	RB	1	Dazwischen
beschönen	NN	1	beschönen
Ekel	NN	1	Ekel
verrieten	NN	1	verrieten
Tausch	NN	1	Tausch
Persien	NNP	1	Persien
fertigen	VBN	1	fertig
vorsichtger	NN	1	vorsichtger
Danks	NN	1	Danks
angezogen	NN	1	angezogen
Schleusen	NN	1	Schleusen
munt	JJ	1	munter
sogaren	RB	1	sogar
lenkt	NN	1	lenkt
Vorbei	NN	1	Vorbei
zeugte	NN	1	zeugte
Alter	NN	1	Alter
Anblick	NN	1	Anblick
Muskel	NNS	1	Muskeln
bedürftig	JJ	1	bedürftig
abgewinnen	NN	1	abgewinnen
dichtet	NN	1	dichtet
Holzstoss	NN	1	Holzstoß
Tyrannei	NN	1	Tyrannei
Deiner	NN	1	Deiner
besitzen	VB	1	besitzen
Schauer	NN	1	Schauer
löblich	JJ	1	löblich
kürzlich	RB	1	kürzlich
vertraute	NN	1	vertraute
Bös	NN	1	Bös
ungerührt	JJ	1	ungerührt
verdiente	NN	1	verdiente
malet	NN	1	malet
geschwärmt	NN	1	geschwärmt
gelog	VBN	1	gelogen
Vorbeien	VB	1	Vorbei
theatralsch	JJ	1	theatralschen
Treffen	NN	1	Treffen
entfernt	JJ	1	entfernt
Witzes	NN	1	Witzes
unversöhnlichsten	NN	1	unversöhnlichsten
verehret	NN	1	verehret
gewartet	NN	1	gewartet
Bessern	NN	1	Bessern
niederwirft	NN	1	niederwirft
Pfleg	NN	1	Pfleg
gespielt	NN	1	gespielt
Bessers	NN	1	Bessers
Sichern	VBN	1	Sicher
Lippe	NNS	1	Lippen
verschieden	RP	1	verschieden
unverdient	JJ	1	unverdient
kleinsen	VB	1	kleinste
Christenpilger	NN	1	Christenpilger
abzuhelfen	VB	1	abzuhelfen
Tempel	NN	1	Tempel
Unentschlossenheit	NN	1	Unentschlossenheit
fischen	VB	1	fischen
neugierge	NN	1	neugierge
zittert	NN	1	zittert
unbewusst	JJ	1	unbewußt
Dus	NN	1	Dus
borgt	VBN	1	borgt
Berichtigen	NN	1	Berichtigen
Geliebt	NN	1	Geliebt
fehlt	JJ	1	fehlte
Ritterschaft	NN	1	Ritterschaft
Bewundrung	NN	1	Bewundrung
gefiel	NN	1	gefiel
Muster	NN	1	Muster
Naserinchen	VB	1	Naserinchen
Vielleichen	VBN	1	Vielleicht
Nachts	NN	1	Nachts
Versprich	NNP	1	Versprich
selben	NN	1	selben
aufgetragen	NN	1	aufgetragen
Schritt	NN	1	Schritt
vertrieben	NN	1	vertrieben
Entschuldigen	NN	1	Entschuldigen
Bereite	NN	1	Bereite
Auswahl	NN	1	Auswahl
Haar	NNS	1	Haare
gottergebn	JJ	1	gottergebne
sassen	VB	1	saß
Ändern	NN	1	Ändern
behaupten	VB	1	behaupten
koste	NN	1	koste
Endlich	RB	1	Endlich
Fangen	VB	1	Fangt
Handel	NN	1	Handel
Alltäglich	TO	1	Alltäglich
verstrickt	NN	1	verstrickt
streute	NN	1	streute
klingt	VB	1	klingt
wehren	VB	1	wehren
schaudere	NN	1	schaudere
Dinare	NN	1	Dinare
abzubangen	VB	1	abzubangen
gewöhne	NN	1	gewöhne
Erbieten	NN	1	Erbieten
unterwegens	NN	1	unterwegens
verscharrten	NN	1	verscharrten
finde	NN	1	finde
Raum	NN	1	Raum
Äste	NN	1	Äste
Eröffne	NN	1	Eröffne
vernehmlich	JJ	1	vernehmlich
Erröten	NN	1	Erröten
staunt	NN	1	staunt
Abtritt	NN	1	Abtritt
Geschichtchen	VB	1	Geschichtchen
sehnen	VB	1	sehn
Rechten	NN	1	Rechten
Bedienen	NN	1	Bedienen
Brief	NN	1	Brief
ritterlich	JJ	1	ritterlich
Darfst	NN	1	Darfst
Fürsprach	NN	1	Fürsprach
dreiden	VB	1	dritte
ohnedemen	VB	1	ohnedem
freun	NN	1	freun
passen	VB	1	passen
Abbrech	VB	1	Abbrechen
folg	NN	1	folg
nachzuäffen	NN	1	nachzuäffen
Gauch	NN	1	Gauch
lässst	NN	1	läßst
Tisch	JJ	1	Tische
werter	NN	1	werter
Ursache	NN	1	Ursache
Küssen	NN	1	Küssen
heisst	JJ	1	heißt
unentschlossen	NN	1	unentschlossen
Gestehn	NN	1	Gestehn
bequemeres	NN	1	bequemeres
anderwärts	NN	1	anderwärts
verdanket	NN	1	verdanket
Ballen	NN	1	Ballen
preise	NN	1	preise
Erwähnte	NN	1	Erwähnte
kleidet	NN	1	kleidet
Christennamen	NN	1	Christennamen
besann	NN	1	besann
schlafen	VB	1	schlafen
aufgelöset	NN	1	aufgelöset
Würdigen	VB	1	Gewürdigt
strebe	NN	1	strebe
wägst	NN	1	wägst
brach	IN	1	brach
verschiednen	NN	1	verschiednen
Floht	NN	1	Floht
Zeigen	VB	1	Gezeigt
Prunk	NN	1	Prunk
schläft	NN	1	schläft
anverwandt	NN	1	anverwandt
Sonnenuntergang	NN	1	Sonnenuntergang
Abendland	NNS	1	Abendländer
unterdrücken	VB	1	unterdrücken
Gründen	NN	1	Gründen
empfinde	NN	1	empfinde
Findt	VB	1	Findt
Knoten	NN	1	Knoten
Kapital	NN	1	Kapital
wiest	RP	1	wiest
vertragen	VB	1	vertragen
schwatz	NN	1	schwatz
verdien	NN	1	verdien
geringst	JJ	1	geringsten
platterdings	NN	1	platterdings
freiwillig	JJ	1	freiwillig
Gesproch	JJ	1	Gesprochen
klänge	NN	1	klänge
meint	VB	1	meint
Lumpen	NN	1	Lumpen
Tebnin	NN	1	Tebnin
trüg	NN	1	trüg
Schachern	NN	1	Schachern
Schöpfer	NN	1	Schöpfer
reuen	VB	1	reuen
ausgemacht	NN	1	ausgemacht
Monden	NN	1	Monden
ermüden	VB	1	ermüden
Seltene	NN	1	Seltene
Verhasst	NN	1	Verhaßt
Klumpen	NN	1	Klumpen
küssen	VB	1	küssen
Schätzen	NN	1	Schätzen
hinten	RP	1	hinten
Traut	NN	1	Traut
schwindelnd	NN	1	schwindelnd
Schwäche	NN	1	Schwäche
Bliebst	NN	1	Bliebst
Dienstfertigkeit	NN	1	Dienstfertigkeit
schlimmern	VB	1	schlimmer
Lage	NN	1	Lage
anzunehmen	VB	1	anzunehmen
traue	NN	1	traue
entkräftet	NN	1	entkräftet
schlimmster	NN	1	schlimmster
zeitlich	RB	1	zeitlich
gleicht	NN	1	gleicht
Bestritten	NN	1	Bestritten
bedurfte	NN	1	bedurfte
Stift	JJ	1	Stifter
wirzt	NN	1	wirzt
Geflohn	NN	1	Geflohn
musst	VB	1	mußt
Tigris	NNP	1	Tigris
Verfolgen	NN	1	Verfolgen
unbekümmert	JJ	1	unbekümmert
denke	VB	1	denke
lachen	VB	1	gelacht
befragen	VB	1	befragen
Verliert	NN	1	Verliert
unrechtmässigen	NN	1	unrechtmäßigen
Trug	NN	1	Trug
Leicht	NN	1	Leicht
Klage	NNS	1	Klagen
Zeitung	NN	1	Zeitung
Beschwatzen	NN	1	Beschwatzen
überreden	VB	1	überreden
Kaufe	NN	1	Kaufe
Schuppen	NN	1	Schuppen
Inhalt	JJ	1	Inhalt
Nehmts	NN	1	Nehmts
einzuernten	NN	1	einzuernten
eigner	JJ	1	eigner
immerdar	NN	1	immerdar
stumm	JJ	1	stumm
nichten	NN	1	nichten
Unsers	NN	1	Unsers
aufgesprungen	NN	1	aufgesprungen
fähig	JJ	1	fähig
leg	NN	1	leg
Sünden	NN	1	Sünden
Auftrag	NN	1	Auftrag
tausendfach	NN	1	tausendfach
Abscheulich	VB	1	Abscheuliche
nützlich	JJ	1	nützlich
erhaltnen	NN	1	erhaltnen
Zwei	CD	1	Zwei
Erkundigte	NN	1	Erkundigte
verreden	NN	1	verreden
verführte	NN	1	verführte
Sand	NN	1	Sand
Pilgermahl	NN	1	Pilgermahl
erriet	NN	1	erriet
verlohnt	NN	1	verlohnt
errat	JJ	1	errat
milden	VBN	1	mild
freudig	JJ	1	freudig
einziehn	NN	1	einziehn
Erregen	VB	1	Erregt
Fehlen	VB	1	Fehlt
gebahnet	NN	1	gebahnet
Begnügen	VB	1	Begnügt
Streitern	NN	1	Streitern
Treue	NN	1	Treue
litte	NN	1	litte
Letzt	NN	1	Letzt
kürzste	NN	1	kürzste
drängen	VB	1	drängt
verführt	NN	1	verführt
Fehler	NN	1	Fehler
wuchern	NN	1	wuchern
dadurch	RB	1	dadurch
Männin	NN	1	Männin
Eidam	JJ	1	Eidam
Sehren	RB	1	Sehr
wiegte	NN	1	wiegte
Versuchts	NN	1	Versuchts
Besondern	NN	1	Besondern
neinen	RP	1	nein
gaffend	JJ	1	gaffend
dauern	VB	1	dauern
Zang	JJ	1	Zange
Getan	NN	1	Getan
bedientest	NN	1	bedientest
Mäuschen	NN	1	Mäuschen
ganzem	NNP	1	ganzem
eilig	JJ	1	eilig
verwandeln	VB	1	verwandeln
walten	VB	1	waltet
Schlafe	NN	1	Schlafe
Hofe	NN	1	Hofe
Kalte	NN	1	Kalte
Abgeschmackters	NN	1	Abgeschmackters
schenke	NN	1	schenke
Schönes	NN	1	Schönes
Äser	NN	1	Äser
Erlaubst	NN	1	Erlaubst
Neidisch	JJ	1	Neidisch
taube	JJ	1	taube
schlimmsten	NN	1	schlimmsten
verschafft	NN	1	verschafft
bliebs	NN	1	bliebs
Amme	NN	1	Amme
glüht	NN	1	glüht
blöde	NN	1	blöde
nähern	PRP$	1	nähern
Spieles	NN	1	Spieles
unterbleiben	VB	1	unterbleiben
spracht	NN	1	spracht
Waffenstillestand	NN	1	Waffenstillestand
Plackerei	NN	1	Plackerei
Erfodert	NN	1	Erfodert
verteidgen	NN	1	verteidgen
Gottsfürchtge	NN	1	Gottsfürchtge
ungut	NN	1	ungut
vorgeplaudert	NN	1	vorgeplaudert
einkassieren	NN	1	einkassieren
Gelehrten	NN	1	Gelehrten
wittern	VB	1	wittern
Mittel	NN	1	Mittel
eingebracht	JJ	1	eingebracht
dannen	VB	1	dann
Geflattre	NN	1	Geflattre
leugnen	VBN	1	geleugnet
Bastard	NN	1	Bastard
werben	VB	1	werben
säumen	VB	1	säumen
junger	JJ	1	junger
erstiegen	NN	1	erstiegen
philosophsch	JJ	1	philosophschen
Betriegen	NN	1	Betriegen
Arbeit	NN	1	Arbeit
Kummers	NN	1	Kummers
Tuch	NN	1	Tuch
Raserei	NN	1	Raserei
ehren	VBN	1	geehrt
ungelegen	NN	1	ungelegen
tauschten	NN	1	tauschten
gach	NN	1	gach
Sonnenschein	NN	1	Sonnenschein
Weizen	NN	1	Weizen
sah	VB	1	sah
verhöhnen	NN	1	verhöhnen
kleinern	NN	1	kleinern
Vorwand	NN	1	Vorwand
geschwinden	VB	1	geschwind
Wüstenei	NN	1	Wüstenei
Worin	NN	1	Worin
scheinet	NN	1	scheinet
rächt	NN	1	rächt
eure	NN	1	eure
geschwinder	NN	1	geschwinder
Wüsten	NN	1	Wüsten
geschlaf	VB	1	geschlafen
stören	VB	1	stören
begünstigen	VB	1	begünstigen
Löwe	NN	1	Löwe
Künstlers	NN	1	Künstlers
allererst	NN	1	allererst
Gazza	NN	1	Gazza
verklagen	VBN	1	verklagt
Ablauf	NN	1	Ablauf
Manns	NN	1	Manns
erfuhr	JJ	1	erfuhr
Gewundert	NN	1	Gewundert
Ghebern	NN	1	Ghebern
gelingen	VB	1	gelingen
Traums	NN	1	Traums
vollziehen	VB	1	vollziehen
Traume	NN	1	Traume
rechte	RB	1	rechte
habts	NN	1	habts
Mummerei	NN	1	Mummerei
frommt	NN	1	frommt
päpstlich	JJ	1	päpstliches
hellern	NN	1	hellern
wage	NN	1	wage
tapfre	NN	1	tapfre
Bemerkt	NN	1	Bemerkt
Argwohnt	NN	1	Argwohnt
zausen	NN	1	zausen
Sodann	IN	1	Sodann
Versprach	NN	1	Versprach
lieblich	JJ	1	liebliche
schlechterdings	RB	1	schlechterdings
Armseligkeiten	NN	1	Armseligkeiten
fesselt	NN	1	fesselt
Last	NN	1	Last
erhellen	VB	1	erhellen
Ritters	NN	1	Ritters
fürchte	NN	1	fürchte
Diözes	NN	1	Diözes
verweilst	NN	1	verweilst
Fasten	NN	1	Fasten
Div	NN	1	Div
entbot	NN	1	entbot
säete	NN	1	säete
Jugend	NN	1	Jugend
Vernünftge	NN	1	Vernünftge
vermeiden	PRP$	1	vermeiden
Acca	NN	1	Acca
teil	DT	1	teile
Pferde	NN	1	Pferde
angelegner	NN	1	angelegner
umfassen	VB	1	umfassen
unterhaltendste	NN	1	unterhaltendste
Kameln	VB	1	Kamelen
höchsen	VB	1	höchsten
beschwören	VB	1	beschwören
Erkaufen	NN	1	Erkaufen
folglich	RB	1	folglich
Vorrat	NN	1	Vorrat
traft	NN	1	traft
auserwählte	NN	1	auserwählte
Herrlich	RB	1	Herrlich
unrecht	JJ	1	unrecht
zerreisset	NN	1	zerreißet
auszufinden	NN	1	auszufinden
geborner	NN	1	geborner
vergehn	NN	1	vergehn
allzu	RB	1	allzu
Nehmen	VB	1	Nehm
Gotteshäuschen	RB	1	Gotteshäuschen
Botenbrod	NN	1	Botenbrod
Frank	NNP	1	Frank
rief	VB	1	rief
Beichte	NN	1	Beichte
ausgestatten	VBN	1	ausgestattet
unparteiisch	JJ	1	unparteiisch
ablegen	RP	1	abgelegt
Fund	NN	1	Fund
Schade	NN	1	Schade
Menschheit	NN	1	Menschheit
Löschen	VB	1	Löschen
ungestüm	JJ	1	ungestüm
Bewahr	NN	1	Bewahre
unermesslich	JJ	1	unermeßlichen
hinwieder	NN	1	hinwieder
geschienen	NN	1	geschienen
Ungebührlich	JJ	1	Ungebührliches
streiten	VB	1	streiten
Edler	NN	1	Edler
Freigebigkeit	NN	1	Freigebigkeit
verfällst	NN	1	verfällst
Bilder	NN	1	Bilder
anzureden	VB	1	anzureden
Stockjude	NN	1	Stockjude
Einander	NN	1	Einander
unterstehn	NN	1	unterstehn
dulden	VB	1	dulden
zerstreuet	NN	1	zerstreuet
wanns	NN	1	wanns
Erhob	NN	1	Erhob
eiteln	JJ	1	eiteln
Sipp	NN	1	Sipp
erwartend	JJ	1	erwartend
schiene	NN	1	schiene
Gesteuert	NN	1	Gesteuert
würdge	NN	1	würdge
geschäftig	JJ	1	geschäftig
Menschenfreund	NN	1	Menschenfreund
meinetwegen	RB	1	meinetwegen
klüger	NN	1	klüger
Lüg	NN	1	Lügen
kamst	RB	1	kamst
Scheiterhaufen	NN	1	Scheiterhaufen
Rute	NN	1	Rute
Bemächtigen	NN	1	Bemächtigen
gehorsam	JJ	1	gehorsam
Siebensachen	RB	1	Siebensachen
schlich	JJ	1	schlich
gewähren	VB	1	gewähren
besondern	NN	1	besondern
leugst	NN	1	leugst
Lügnerin	NN	1	Lügnerin
treigen	RP	1	triegt
Wirkt	NN	1	Wirkt
Christentöchterch	JJ	1	Christentöchterchen
verloschen	VB	1	verloschen
Querkopf	NN	1	Querkopf
Quarantana	NN	1	Quarantana
Seil	NN	1	Seil
glaubst	VB	1	glaubst
Empfänger	NN	1	Empfänger
Ziemte	NN	1	Ziemte
erinnerst	NN	1	erinnerst
besorgen	VB	1	besorgen
gieriger	NNP	1	gieriger
Näschen	RB	1	Näschen
dringlichste	NN	1	dringlichste
Unmittelbar	JJ	1	Unmittelbar
Hunderttausenden	NN	1	Hunderttausenden
Sonnenscheine	NN	1	Sonnenscheine
Grunde	NN	1	Grunde
schwierig	JJ	1	schwierig
verlässt	NN	1	verläßt
schmelzen	VB	1	schmelzen
Verstärkung	NN	1	Verstärkung
spiessen	NN	1	spießen
frömmsten	NN	1	frömmsten
willen	IN	1	willen
Kellner	NN	1	Kellner
zerschlagen	VB	1	zerschlagen
Träne	NN	1	Träne
Fehls	NN	1	Fehls
speist	NN	1	speist
angingst	NN	1	angingst
Vorderste	NN	1	Vorderste
Schonen	RB	1	Schon
Geiz	NN	1	Geiz
teilten	NN	1	teilten
sichern	VB	1	sicher
Erzählen	NN	1	Erzählen
glorreicher	NN	1	glorreicher
entliess	NN	1	entließ
bedacht	NN	1	bedacht
Banden	NN	1	Banden
nimmer	NNP	1	nimmer
klemmen	VB	1	klemmt
Kass	NN	1	Kaß
Klosterleute	NN	1	Klosterleute
schmeichelts	NN	1	schmeichelts
verlorn	JJ	1	verlornen
Ersticken	NN	1	Ersticken
Listen	NN	1	Listen
Schlechen	VB	1	Schlechten
vergnügter	NN	1	vergnügter
hintergehst	NN	1	hintergehst
Itzo	NN	1	Itzo
Verlassen	NN	1	Verlassen
floht	NN	1	floht
unverloren	NN	1	unverloren
Töchterchens	JJ	1	Töchterchens
Flur	NN	1	Flur
Flut	NN	1	Flut
Verdienet	NN	1	Verdienet
nass	JJ	1	nassen
wackre	NN	1	wackre
Vereinigen	NNP	1	Vereinigen
Schläft	NN	1	Schläft
wards	NN	1	wards
unverzüglich	FW	1	unverzüglich
Werken	NN	1	Werken
verwirren	VB	1	verwirren
Bedeuten	NN	1	Bedeuten
Weissen	NN	1	Weißen
verlenken	NN	1	verlenken
Gesetzes	NN	1	Gesetzes
aufzufinden	NN	1	aufzufinden
Nase	NN	1	Nase
Speis	NN	1	Speis
Verdenkt	NN	1	Verdenkt
Halse	NN	1	Halse
höflicher	NN	1	höflicher
Verbesserer	NN	1	Verbesserer
Schilt	NN	1	Schilt
launisch	JJ	1	launisch
Fühlt	NN	1	Fühlt
geschehen	RP	1	geschehen
Tropf	NN	1	Tropf
verhunzen	NN	1	verhunzen
entzog	NN	1	entzog
übrigens	RP	1	übrigens
Ruhe	NN	1	Ruhe
Erbe	NN	1	Erbe
dicker	NN	1	dicker
Eitelkeit	NN	1	Eitelkeit
ging	VB	1	ging
Schwach	JJ	1	Schwachen
früh	JJ	1	früh
bleibet	NN	1	bleibet
Fällt	VB	1	Fällt
müsse	RB	1	müsse
Mache	NN	1	Mache
Befällt	NN	1	Befällt
Tand	NN	1	Tand
Erwachsen	NN	1	Erwachsen
redten	NN	1	redten
Herbst	NN	1	Herbst
Bösewichter	NN	1	Bösewichter
Kunst	NN	1	Kunst
übe	NN	1	übe
umgeworfen	NN	1	umgeworfen
dämpfen	VB	1	dämpfen
Machtspruch	NN	1	Machtspruch
Ungewöhnlichste	NN	1	Ungewöhnlichste
Angelegenheit	NN	1	Angelegenheit
Verstopfen	NN	1	Verstopfen
sonderbaren	NN	1	sonderbaren
ausgenomm	RB	1	ausgenommen
aufgedunsnen	NN	1	aufgedunsnen
Narr	NN	1	Narr
wechselt	NN	1	wechselt
Schatten	NN	1	Schatten
sagt	VB	1	sagt
Bedenken	NN	1	Bedenken
Ausmergeln	NN	1	Ausmergeln
befehlt	NN	1	befehlt
unverkünstelt	NN	1	unverkünstelt
tadle	NN	1	tadle
erzeige	NN	1	erzeige
Wichtigers	JJ	1	Wichtigers
Jauchzen	NN	1	Jauchzen
Unsrer	NN	1	Unsrer
kannst	JJ	1	kannst
wünscht	VB	1	wünscht
Täte	NN	1	Täte
Verständig	NN	1	Verständigen
Benehmen	NN	1	Benehmen
bedürfen	RP	1	bedurft
Erscheinen	NN	1	Erscheinen
Karawan	NN	1	Karawan
Graus	NN	1	Graus
draufen	RP	1	drauf
plumper	JJ	1	plumper
Gekauft	NN	1	Gekauft
ruhigern	VB	1	ruhiger
wenigste	NN	1	wenigste
Lügen	VB	1	Lügt
überallen	VB	1	überall
Geschweige	NN	1	Geschweige
getrennt	JJ	1	getrennt
spreche	NN	1	spreche
Hungerns	NN	1	Hungerns
Wahrheitstag	NN	1	Wahrheitstag
übeln	VBN	1	übel
Beginnt	NN	1	Beginnt
fortfährt	NN	1	fortfährt
Quelle	NN	1	Quelle
anwende	NN	1	anwende
Lenk	NN	1	Lenk
Verrückt	NN	1	Verrückt
trefft	NN	1	trefft
Schnurre	NN	1	Schnurre
besteh	NN	1	besteh
Tust	NN	1	Tust
göttlich	JJ	1	göttliche
befehlen	VB	1	befehlen
Betrogene	NN	1	Betrogene
Hiermit	NN	1	Hiermit
Gestern	NN	1	Gestern
begierig	JJ	1	begierig
Gebauet	NN	1	Gebauet
heit	JJ	1	heiter
kehrt	JJ	1	kehrt
ausritt	NN	1	ausritt
anliess	NN	1	anließ
Gemeinen	NN	1	Gemeinen
heim	RB	1	heim
Schonet	NN	1	Schonet
Grosses	NN	1	Großes
Lehren	NN	1	Lehren
Wenns	NN	1	Wenns
Weiber	NN	1	Weiber
Opfertier	NN	1	Opfertier
Geiern	NN	1	Geiern
winkte	NN	1	winkte
grünen	VB	1	grünen
Klimas	NN	1	Klimas
abgetan	NN	1	abgetan
grader	NN	1	grader
vorgespreizte	NN	1	vorgespreizte
Fürsten	NN	1	Fürsten
Sagtest	NN	1	Sagtest
Adlerblick	NN	1	Adlerblick
allerdingsen	VB	1	allerdings
unerschöpflicher	NNP	1	unerschöpflicher
Zahn	NN	1	Zahn
Ausbund	NN	1	Ausbund
Gesund	NN	1	Gesund
Sanftmut	NN	1	Sanftmut
schmeichelt	NN	1	schmeichelt
wiederumen	VB	1	wiederum
Beschäm	NN	1	Beschäm
Grossen	NN	1	Großen
verlass	NN	1	verlaß
Schlag	NN	1	Schlag
erbarmen	VB	1	erbarmen
Dieselbe	NN	1	Dieselbe
liebenswürdig	JJ	1	liebenswürdig
Verbrennen	NN	1	Verbrennen
hochzuschätzen	NN	1	hochzuschätzen
Patriarche	NN	1	Patriarche
alltäglich	JJ	1	alltäglich
Lebendigen	NN	1	Lebendigen
eingehüllt	NN	1	eingehüllt
Geschwinder	NN	1	Geschwinder
hindern	VB	1	hindern
Messer	NN	1	Messer
Zurüstungen	NN	1	Zurüstungen
wagte	NN	1	wagte
Ordensregeln	NN	1	Ordensregeln
Wovor	NN	1	Wovor
fett	JJ	1	fett
Stachel	NN	1	Stachel
Geworden	NN	1	Geworden
merklich	IN	1	merklich
schwärzesten	NN	1	schwärzesten
gezollt	NN	1	gezollt
dreifach	NN	1	dreifach
Vorausgeschickt	NN	1	Vorausgeschickt
Sinnbilderst	NN	1	Sinnbilderst
abzujagen	VB	1	abzujagen
Unglück	NN	1	Unglück
gereuen	NN	1	gereuen
Erfüllung	NN	1	Erfüllung
Verfügung	NN	1	Verfügung
Kaiser	NN	1	Kaiser
Meiner	JJ	1	Meiner
Gebieten	NN	1	Gebieten
täuschen	VB	1	getäuscht
ausgezehrt	JJ	1	ausgezehrt
Laienbruders	NN	1	Laienbruders
ältern	NN	1	ältern
wundern	VB	1	gewundert
vertilgen	NN	1	vertilgen
Bewegungsgründe	NN	1	Bewegungsgründe
zweitenmale	NN	1	zweitenmale
Furchtsamen	NN	1	Furchtsamen
glatt	JJ	1	glatten
Sinn	NN	1	Sinn
Zehen	NN	1	Zehen
Fragen	NN	1	Fragen
verreist	NNP	1	verreist
Erriet	NN	1	Erriet
Vaterland	NN	1	Vaterland
wundert	NN	1	wundert
Sina	NNP	1	Sina
Almosens	NN	1	Almosens
überreichtet	NN	1	überreichtet
Verzweifeln	NN	1	Verzweifeln
Mitleids	NN	1	Mitleids
wuchert	NN	1	wuchert
Verschwendung	NN	1	Verschwendung
verschwand	JJ	1	verschwand
schändlich	JJ	1	schändlich
Hineingeschrieben	NN	1	Hineingeschrieben
ausredt	NNP	1	ausredt
Pfiff	NN	1	Pfiff
Misstraun	NN	1	Mißtraun
niemands	NN	1	niemands
Deutschen	VB	1	Deutschen
deutlichsten	NN	1	deutlichsten
Flecken	NN	1	Flecken
Beiher	NN	1	Beiher
Höhle	NN	1	Höhle
Gehirn	NN	1	Gehirn
Meinst	NN	1	Meinst
Summen	NN	1	Summen
Dazuen	RB	1	Dazu
Gehorcht	NN	1	Gehorcht
Knorr	NN	1	Knorr
Stiel	NN	1	Stiel
winken	VB	1	winken
wiss	VB	1	wissen
Unterricht	NN	1	Unterricht
doren	RB	1	dort
Steinen	NN	1	Steinen
eifersüchtig	JJ	1	eifersüchtig
Borgen	NN	1	Borgen
solchem	NN	1	solchem
wems	NN	1	wems
Lastertat	NN	1	Lastertat
eintritt	NN	1	eintritt
Eren	RB	1	Erst
werdet	NN	1	werdet
Nu	NN	1	Nu
Heil	NN	1	Heil
Zurückgezogen	NN	1	Zurückgezogen
schönern	NN	1	schönern
Möcht	NN	1	Möcht
bekennen	RP	1	bekannt
Segen	NN	1	Segen
hinterbringen	NN	1	hinterbringen
Bilde	NN	1	Bilde
Silbe	NN	1	Silbe
blutge	NN	1	blutge
unverhohlen	NN	1	unverhohlen
ofen	VB	1	oft
tief	JJ	1	tiefer
trete	NN	1	trete
rauhe	NN	1	rauhe
überrascht	VB	1	überrascht
Träumst	NN	1	Träumst
ginge	NN	1	ginge
Willkommnen	NN	1	Willkommnen
gekostet	NN	1	gekostet
heilig	JJ	1	heiligen
Ginnistan	NNP	1	Ginnistan
Vätern	NN	1	Vätern
erfinden	VBN	1	erfunden
Mütterchen	JJ	1	Mütterchen
Kannst	NN	1	Kannst
verübeln	NN	1	verübeln
Linie	NN	1	Linie
Skrupel	NN	1	Skrupel
befestigen	VB	1	befestigen
Verfälschen	JJ	1	Verfälschen
Erschien	NN	1	Erschien
starken	NN	1	starken
Entreissen	NN	1	Entreißen
Propheten	NN	1	Propheten
Geschlechte	NN	1	Geschlechte
erwähnen	VB	1	erwähnen
Häfen	NN	1	Häfen
Rührung	NN	1	Rührung
wunderlich	JJ	1	wunderlich
abzuleugnen	VB	1	abzuleugnen
Geweint	NN	1	Geweint
gedenken	VB	1	gedacht
Warnung	NN	1	Warnung
Frag	NN	1	Frag
flüchtet	NN	1	flüchtet
Richte	NN	1	Richte
unbestochnen	NN	1	unbestochnen
Schönheit	NN	1	Schönheit
dieserwegen	NN	1	dieserwegen
Mammon	NN	1	Mammon
Tier	NN	1	Tier
Aufwand	NN	1	Aufwand
dünken	VB	1	dünken
bettelarm	NN	1	bettelarm
Stange	NN	1	Stange
seiden	VB	1	sieden
feind	NN	1	feind
Lager	NN	1	Lager
beladenen	JJ	1	beladenen
Ruhig	RB	1	Ruhig
kaiserlich	JJ	1	kaiserliches
hingeworfnen	NN	1	hingeworfnen
gehofft	NN	1	gehofft
Empor	NN	1	Empor
entfesselt	NN	1	entfesselt
Ehren	NN	1	Ehren
aufrichtig	JJ	1	aufrichtig
rechnet	NN	1	rechnet
weises	NN	1	weises
Probe	NN	1	Probe
Richard	NNP	1	Richard
arg	RB	1	arg
rachbegierig	JJ	1	rachbegierig
schreiben	RP	1	geschrieben
verdanken	VB	1	verdanken
Pah	NN	1	Pah
Kreuz	NN	1	Kreuz
beten	VB	1	beten
Lächelt	NN	1	Lächelt
betreffen	VB	1	betrifft
abzudingen	VB	1	abzudingen
Schönres	NN	1	Schönres
Gedächtnis	NN	1	Gedächtnis
Kinde	NN	1	Kinde
leidige	NN	1	leidige
melden	VB	1	melden
vermessen	VB	1	vermessen
silbern	JJ	1	silbern
Überlegen	NN	1	Überlegen
Trag	NN	1	Trag
könn	VB	1	könne
Pilger	NN	1	Pilger
Trau	NN	1	Trau
finst	JJ	1	finster
Gunst	JJ	1	Gunst
Syrien	NN	1	Syrien
Heldenmässigste	NN	1	Heldenmäßigste
beziehen	VBN	1	bezogen
erwünschen	VBN	1	erwünscht
abgejagt	VBN	1	abgejagt
fiel	VB	1	fiel
Steins	NN	1	Steins
straf	NN	1	straf
Sträflich	JJ	1	Sträfliches
abzuzwacken	VB	1	abzuzwacken
Worts	NN	1	Worts
passt	NN	1	paßt
schein	VB	1	scheinen
nien	VBN	1	nie
Rande	NN	1	Rande
blühen	VB	1	blühen
Höhnerei	NN	1	Höhnerei
stündlich	JJ	1	stündlich
Flamm	NN	1	Flamm
Quell	JJ	1	Quell
Labsal	NN	1	Labsal
Sängerin	NN	1	Sängerin
Buche	NN	1	Buche
Siedelei	NN	1	Siedelei
lebet	VB	1	lebet
Stellt	NN	1	Stellt
Geistlich	JJ	1	Geistlicher
Eröffnen	NN	1	Eröffnen
Prüfung	NN	1	Prüfung
vergisst	VB	1	vergißt
genugen	VB	1	genug
hörst	VB	1	hörst
obendreinen	RP	1	obendrein
ersaufen	NN	1	ersaufen
Saite	NN	1	Saite
Scheuern	NN	1	Scheuern
gewürdiget	NN	1	gewürdiget
Mute	NN	1	Mute
Geber	NN	1	Geber
stürmen	VB	1	stürmen
Wiederkunft	NN	1	Wiederkunft
ganzes	NN	1	ganzes
heilgen	NN	1	heilgen
eifre	NN	1	eifre
ertrunken	NN	1	ertrunken
Diener	NN	1	Diener
spotten	VB	1	spotten
spielst	NN	1	spielst
schärfer	NN	1	schärfer
spottet	NN	1	spottet
neben	IN	1	neben
gelobten	NN	1	gelobten
verbrannt	JJ	1	verbrannt
Hervorgetreten	NN	1	Hervorgetreten
Maronien	VB	1	Maroniten
schleichen	RP	1	geschlichen
Händchen	RB	1	Händchen
erträglichern	NN	1	erträglichern
zeichnen	VB	1	zeichnet
verhindern	VB	1	verhindert
presst	NN	1	preßt
schicke	NN	1	schicke
nennst	VB	1	nennst
Palästina	NNP	1	Palästina
melde	NN	1	melde
Reichtümer	NN	1	Reichtümer
Ersehn	NN	1	Ersehn
hergebracht	NN	1	hergebracht
Vertrauet	NN	1	Vertrauet
Geckereien	NN	1	Geckereien
Stütze	NN	1	Stütze
überlegen	VB	1	überlegen
lebe	VB	1	lebe
vernehmlicher	NN	1	vernehmlicher
Plätzchen	NN	1	Plätzchen
Gottloben	NN	1	Gottlob
Indien	NNP	1	Indien
lebt	VB	1	lebt
vergebt	NN	1	vergebt
klang	NN	1	klang
Stund	NN	1	Stund
Knecht	NN	1	Knecht
Anteil	NN	1	Anteil
Spion	NN	1	Spion
fester	NN	1	fester
eingestimmt	NN	1	eingestimmt
Raubgesindel	NN	1	Raubgesindel
Drohen	NN	1	Drohen
Müss	NN	1	Müß
gönnst	NN	1	gönnst
Heh	NN	1	Heh
Krieg	NN	1	Krieg
gebrech	VB	1	gebrechen
Schale	NN	1	Schale
schaff	NN	1	schaff
Waffe	NNS	1	Waffen
besorg	NN	1	besorg
Kirche	NN	1	Kirche
vielmal	IN	1	vielmal
Zung	NN	1	Zung
Scheidebrief	NN	1	Scheidebrief
Büchelchen	VB	1	Büchelchen
allerlei	JJ	1	allerlei
Rechenschaft	NN	1	Rechenschaft
geführet	NN	1	geführet
geflösst	NN	1	geflößt
Fiel	NN	1	Fiel
innerhalb	RP	1	innerhalb
geängstet	NN	1	geängstet
Zutrauns	NN	1	Zutrauns
Klemme	NN	1	Klemme
abhängen	RP	1	abhängt
verbreitet	JJ	1	verbreitet
Wilder	NN	1	Wilder
hattest	RP	1	hattest
Besinnen	NN	1	Besinnen
mühsam	JJ	1	mühsam
Geschrieben	NN	1	Geschrieben
Ans	NN	1	Ans
Träumerei	NN	1	Träumerei
verbreiten	VBN	1	verbreitet
Brautschatz	NN	1	Brautschatz
Beute	NN	1	Beute
sagte	VB	1	sagte
reifen	VB	1	reifen
Geizigsten	NN	1	Geizigsten
achten	VB	1	achtet
Pracht	NN	1	Pracht
neugiergem	NN	1	neugiergem
Winseln	NN	1	Winseln
Vorfahren	NN	1	Vorfahren
undenkbar	JJ	1	undenkbar
entdecken	VB	1	entdecken
Knuppen	NN	1	Knuppen
Trotzkopf	NN	1	Trotzkopf
kränken	VB	1	kränken
Bring	FW	1	Bring
zuteilen	RP	1	zugeteilt
weisere	NN	1	weisere
greifen	VB	1	greifen
belauschen	JJ	1	belauschen
barfuss	RB	1	barfuß
Vergnügsam	JJ	1	Vergnügsam
begreiflich	JJ	1	begreiflich
Posten	NN	1	Posten
Allerdingsen	RB	1	Allerdings
Herze	NN	1	Herze
Reit	NN	1	Reit
Mörder	NN	1	Mörder
immern	VB	1	immer
Reis	NN	1	Reis
Reiz	NN	1	Reizes
siebenmal	RB	1	siebenmal
Wein	NN	1	Wein
Geistlichkeit	NN	1	Geistlichkeit
schleppt	NN	1	schleppt
bewundern	PRP$	1	bewundern
Landes	NN	1	Landes
off	JJ	1	offen
Schaudert	NN	1	Schaudert
Wiege	NN	1	Wiege
Ziehen	VB	1	Zieht
Grausame	NN	1	Grausame
heitern	JJ	1	heitern
Gold	NN	1	Gold
Zersprengen	NN	1	Zersprengen
Bekenn	NN	1	Bekenn
setz	NN	1	setz
schi	JJ	1	schier
gewärtigen	VB	1	gewärtigen
Gerufen	NN	1	Gerufen
Mien	NN	1	Mien
Entscheiden	NN	1	Entscheiden
lese	NN	1	lese
Richterstuhl	NN	1	Richterstuhl
Bescheidne	JJ	1	Bescheidne
ruhen	VB	1	ruhen
Flusse	NN	1	Flusse
Aufschluss	NN	1	Aufschluß
letzen	VB	1	letzte
Wähnen	NN	1	Wähnen
martern	NN	1	martern
Bekümmert	NN	1	Bekümmert
mäkeln	NN	1	mäkeln
Vergesslichen	RB	1	Vergeßlichen
weh	RB	1	weh
zög	NN	1	zög
stehts	NN	1	stehts
schmutzgen	NN	1	schmutzgen
Esse	NNS	1	Essen
Ärmern	NN	1	Ärmern
vorzuspiegeln	VB	1	vorzuspiegeln
Bluts	NN	1	Bluts
fliehn	NN	1	fliehn
verhüllt	NN	1	verhüllt
geholfen	NN	1	geholfen
Hässlichen	VB	1	Häßlichen
Eis	NN	1	Eis
strafst	NN	1	strafst
Musterring	FW	1	Musterring
Horcherin	NN	1	Horcherin
Entschliessen	NN	1	Entschließen
Gelehrt	NN	1	Gelehrt
Fallen	NN	1	Fallen
Feuerkohlen	NN	1	Feuerkohlen
Original	NN	1	Original
taugts	NN	1	taugts
vermutlich	JJ	1	vermutlich
Erheb	NN	1	Erheben
unterbrechen	VB	1	unterbrechen
höflich	JJ	1	höflich
Gewaltig	JJ	1	Gewaltig
Beteurte	NN	1	Beteurte
körnen	MD	1	körnt
verkennen	VBN	1	verkannt
warmen	VB	1	warmen
Verleitet	NN	1	Verleitet
billigsten	NN	1	billigsten
Bekannt	IN	1	Bekannt
reift	NN	1	reift
erpicht	NN	1	erpicht
Obern	NN	1	Obern
hadern	NN	1	hadern
Schlimmes	NN	1	Schlimmes
stutzest	NN	1	stutzest
Umarmen	NN	1	Umarmen
Arznei	NN	1	Arznei
Allerliebst	NN	1	Allerliebst
rücken	VB	1	rücken
erkund	NN	1	erkund
eilst	NN	1	eilst
Schwab	NN	1	Schwab
Vertraun	NN	1	Vertraun
Vertraut	NN	1	Vertraut
Ort	NN	1	Ort
Strand	NN	1	Strand
Subtilitäten	NN	1	Subtilitäten
Gnüge	NN	1	Gnüge
betäuben	NN	1	betäuben
erziehn	NN	1	erziehn
plumpen	NN	1	plumpen
beflissen	NN	1	beflissen
Verwiesen	NN	1	Verwiesen
Proben	NN	1	Proben
ermüdet	NN	1	ermüdet
ungeformten	NN	1	ungeformten
Ptolemais	NN	1	Ptolemais
Schweinefleisch	NN	1	Schweinefleisch
erblickt	NN	1	erblickt
Tags	NN	1	Tags
Mamelucken	NN	1	Mamelucken
Altars	NN	1	Altars
Glatteis	NN	1	Glatteis
Almosen	NN	1	Almosen
auszuweichen	VB	1	auszuweichen
heisch	JJ	1	heische
Froh	NN	1	Froh
morsch	JJ	1	morschen
Nannte	NN	1	Nannte
drein	NN	1	drein
Gefangenen	NN	1	Gefangenen
wurdest	RB	1	wurdest
bestreitet	NN	1	bestreitet
strengsten	NN	1	strengsten
verwandt	JJ	1	verwandt
Amm	NN	1	Amm
Gewinn	NN	1	Gewinn
Gewünscht	NN	1	Gewünscht
Blocke	NN	1	Blocke
aufgeführten	NN	1	aufgeführten
Handelsleute	NN	1	Handelsleute
trocknen	VB	1	trocknen
rühr	NN	1	rühr
Paket	NN	1	Paket
Meilen	NN	1	Meilen
Amt	NN	1	Amt
hoffnungsvollen	NN	1	hoffnungsvollen
Sorgfalt	NN	1	Sorgfalt
blühn	NN	1	blühn
schielt	NN	1	schielt
unsertwillen	PRP$	1	unsertwillen
Vorauszusetzen	NN	1	Vorauszusetzen
Hypothesen	NN	1	Hypothes
Bezeihen	NN	1	Bezeihen
hängen	VB	1	hängt
hastig	JJ	1	hastig
hm	NN	1	hm
Nötigen	VBN	1	Genötigt
zweifelt	NN	1	zweifelt
Erlassen	NN	1	Erlassen
Vertrauen	NN	1	Vertrauen
Gleisnereien	VB	1	Gleisnerei
Wolltet	NN	1	Wolltet
opfern	VB	1	opfern
Stöber	NN	1	Stöber
Neffen	NN	1	Neffen
Damaskus	NNP	1	Damaskus
Wahrhaftig	JJ	1	Wahrhaftig
überliefert	NN	1	überliefert
auftragen	VBN	1	aufträgt
braucht	JJ	1	braucht
bürgerlich	JJ	1	bürgerliche
ärgerlich	JJ	1	ärgerlich
vergelt	NN	1	vergelt
Pfaffe	NN	1	Pfaffe
Wunderkraft	NN	1	Wunderkraft
anzuraten	VB	1	anzuraten
Spangen	NN	1	Spangen
verschlossnem	NN	1	verschloßnem
manchmal	RB	1	manchmal
erbot	NN	1	erbot
Iman	NN	1	Iman
Haut	NN	1	Haut
warens	NN	1	warens
trotzgen	NN	1	trotzgen
einzger	NN	1	einzger
vermeine	NN	1	vermeine
Antrag	NNP	1	Antrag
Geschmack	NN	1	Geschmack
jüdsch	JJ	1	jüdschen
Nachher	NN	1	Nachher
freundlich	JJ	1	freundlicher
Sieben	NN	1	Sieben
Damien	RB	1	Damit
erfährt	NN	1	erfährt
klar	JJ	1	klar
Erklär	NN	1	Erklär
Hirns	NN	1	Hirns
Regeln	NN	1	Regeln
öden	NN	1	öden
folge	NN	1	folge
Konntest	NN	1	Konntest
verstopften	NN	1	verstopften
Schwätzer	NN	1	Schwätzer
Verschweig	JJ	1	Verschweig
würgen	VB	1	würgen
Gebar	JJ	1	Gebar
vortrefflich	JJ	1	vortrefflich
irgendwoen	VB	1	irgendwo
schadets	NN	1	schadets
erblicken	VB	1	erblicken
